,word,count,cum_freq,cum_perc,percentile,length,volume
0,the,1852821,1852821,5.3380857354,10,3,>1M
1,and,1084236,2937057,8.46183310518,10,3,>1M
2,to,1065690,4002747,11.5321483636,20,2,>1M
3,a,897374,4900121,14.1175353754,20,1,>100K
4,i,896556,5796677,16.7005656814,20,1,>100K
5,of,874409,6671086,19.2197891843,20,2,>100K
6,in,592759,7263845,20.9275625539,30,2,>100K
7,that,481759,7745604,22.3155384273,30,4,>100K
8,it,481229,8226833,23.7019873398,30,2,>100K
9,is,431773,8658606,24.9459506218,30,2,>100K
10,for,361826,9020432,25.9883925033,30,3,>100K
11,you,325252,9345684,26.9254625503,30,3,>100K
12,with,285182,9630866,27.7470885823,30,4,>100K
13,was,278025,9908891,28.5480948784,30,3,>100K
14,on,273807,10182698,29.3369488697,30,2,>100K
15,my,269494,10452192,30.1133768556,40,2,>100K
16,this,257388,10709580,30.8549267469,40,4,>100K
17,we,256707,10966287,31.5945146374,40,2,>100K
18,as,221677,11187964,32.2331790478,40,2,>100K
19,have,218391,11406355,32.8623763,40,4,>100K
20,be,208032,11614387,33.4617286668,40,2,>100K
21,but,205086,11819473,34.0525934352,40,3,>100K
22,are,193560,12013033,34.6102511231,40,3,>100K
23,s,174551,12187584,35.1131427696,40,1,>100K
24,not,172084,12359668,35.6089268446,40,3,>100K
25,at,170666,12530334,36.1006255786,40,2,>100K
26,so,165410,12695744,36.5771814691,40,2,>100K
27,he,158248,12853992,37.0331032184,40,2,>100K
28,they,151427,13005419,37.4693732675,40,4,>100K
29,from,147473,13152892,37.8942516112,40,4,>100K
30,all,143996,13296888,38.3091125144,40,3,>100K
31,me,138686,13435574,38.7086749969,40,2,>100K
32,or,137658,13573232,39.1052757512,40,2,>100K
33,one,125165,13698397,39.4658834413,40,3,>100K
34,by,122054,13820451,39.8175281584,40,2,>100K
35,can,118375,13938826,40.1585734612,50,3,>100K
36,about,114648,14053474,40.4888810588,50,5,>100K
37,what,114591,14168065,40.8190244361,50,4,>100K
38,will,112495,14280560,41.1431291148,50,4,>100K
39,his,109662,14390222,41.4590717546,50,3,>100K
40,an,109496,14499718,41.7745361388,50,2,>100K
41,out,108438,14608156,42.086952363,50,3,>100K
42,there,107102,14715258,42.395519493,50,5,>100K
43,if,107060,14822318,42.7039656186,50,2,>100K
44,had,106896,14929214,43.0119392506,50,3,>100K
45,up,105963,15035177,43.3172248549,50,2,>100K
46,her,105448,15140625,43.6210267142,50,3,>100K
47,when,103648,15244273,43.9196426681,50,4,>100K
48,just,100040,15344313,44.2078637628,50,4,>100K
49,your,99277,15443590,44.4938866099,50,4,>10K
50,she,98948,15542538,44.7789615887,50,3,>10K
51,like,97554,15640092,45.060020372,50,4,>10K
52,t,97132,15737224,45.3398633485,50,1,>10K
53,has,92978,15830202,45.607738408,50,3,>10K
54,more,91894,15922096,45.8724904,50,4,>10K
55,do,91055,16013151,46.1348251839,50,2,>10K
56,their,89552,16102703,46.3928297368,50,5,>10K
57,some,88295,16190998,46.6472127992,50,4,>10K
58,time,87746,16278744,46.9000141604,50,4,>10K
59,who,86005,16364749,47.1477995988,50,3,>10K
60,our,84741,16449490,47.3919433791,50,3,>10K
61,would,82164,16531654,47.6286626717,50,5,>10K
62,them,79924,16611578,47.8589283932,50,4,>10K
63,been,77834,16689412,48.0831727023,50,4,>10K
64,were,77443,16766855,48.3062905176,50,4,>10K
65,get,70529,16837384,48.5094886942,50,3,>10K
66,which,68408,16905792,48.7065761457,50,5,>10K
67,no,67312,16973104,48.9005059571,50,2,>10K
68,how,65942,17039046,49.0904887183,50,3,>10K
69,into,62722,17101768,49.271194471,50,4,>10K
70,then,61457,17163225,49.4482556847,50,4,>10K
71,people,60498,17223723,49.6225539633,50,6,>10K
72,know,60002,17283725,49.7954232369,50,4,>10K
73,now,59383,17343108,49.9665091352,50,3,>10K
74,because,57223,17400331,50.1313719471,60,7,>10K
75,don,56074,17456405,50.2929244228,60,3,>10K
76,other,55888,17512293,50.4539410216,60,5,>10K
77,also,54817,17567110,50.6118720067,60,4,>10K
78,new,53911,17621021,50.7671927528,60,3,>10K
79,only,52047,17673068,50.9171432058,60,4,>10K
80,even,51295,17724363,51.0649271027,60,4,>10K
81,make,50775,17775138,51.2112128493,60,4,>10K
82,over,50717,17825855,51.3573314944,60,4,>10K
83,first,50598,17876453,51.5031072936,60,5,>10K
84,day,50461,17926914,51.6484883878,60,3,>10K
85,back,50257,17977171,51.7932817461,60,4,>10K
86,than,50256,18027427,51.9380722232,60,4,>10K
87,us,49653,18077080,52.0811254221,60,2,>10K
88,really,49623,18126703,52.2240921893,60,6,>10K
89,him,49446,18176149,52.366549009,60,3,>10K
90,much,48637,18224786,52.5066750525,60,4,>10K
91,see,48560,18273346,52.6465792544,60,3,>10K
92,am,48458,18321804,52.7861895883,60,2,>10K
93,good,48180,18369984,52.924998988,60,4,>10K
94,very,47922,18417906,53.0630650746,60,4,>10K
95,here,47898,18465804,53.2010620158,60,4,>10K
96,well,47737,18513541,53.3385951066,60,4,>10K
97,these,47729,18561270,53.4761051488,60,5,>10K
98,think,47229,18608499,53.6121746619,60,5,>10K
99,way,46724,18655223,53.7467892403,60,3,>10K
100,after,46026,18701249,53.87939284,60,5,>10K
101,little,45372,18746621,54.0101122273,60,6,>10K
102,could,45010,18791631,54.1397886715,60,5,>10K
103,love,44447,18836078,54.2678430797,60,4,>10K
104,go,42608,18878686,54.3905992213,60,2,>10K
105,any,41128,18919814,54.5090913963,60,3,>10K
106,two,40456,18960270,54.6256474999,60,3,>10K
107,life,40097,19000367,54.7411693035,60,4,>10K
108,many,39766,19040133,54.8557374768,60,4,>10K
109,going,39403,19079536,54.9692598258,60,5,>10K
110,most,39360,19118896,55.0826582893,60,4,>10K
111,did,38716,19157612,55.1942013511,60,3,>10K
112,being,38542,19196154,55.3052431088,60,5,>10K
113,where,38398,19234552,55.415869994,60,5,>10K
114,things,38302,19272854,55.5262202975,60,6,>10K
115,still,37677,19310531,55.6347699396,60,5,>10K
116,want,37436,19347967,55.7426252465,60,4,>10K
117,those,37427,19385394,55.8504546238,60,5,>10K
118,too,36857,19422251,55.9566417978,60,3,>10K
119,work,36723,19458974,56.06244291,60,4,>10K
120,before,36549,19495523,56.167742718,60,6,>10K
121,said,36541,19532064,56.2730194775,60,4,>10K
122,made,36417,19568481,56.3779389858,60,4,>10K
123,last,35656,19604137,56.4806660085,60,4,>10K
124,through,35002,19639139,56.581508819,60,7,>10K
125,while,34766,19673905,56.6816716996,60,5,>10K
126,down,34196,19708101,56.7801923769,60,4,>10K
127,something,34010,19742111,56.8781771773,60,9,>10K
128,right,33724,19775835,56.975337995,60,5,>10K
129,m,33599,19809434,57.0721386803,60,1,>10K
130,year,33593,19843027,57.1689220793,60,4,>10K
131,its,33494,19876521,57.2654202535,60,3,>10K
132,off,33367,19909888,57.3615525333,60,3,>10K
133,take,32995,19942883,57.4566130593,60,4,>10K
134,years,32672,19975555,57.5507430034,60,5,>10K
135,around,32395,20007950,57.6440748943,60,6,>10K
136,may,32024,20039974,57.7363379124,60,3,>10K
137,few,31668,20071642,57.8275752738,60,3,>10K
138,got,31455,20103097,57.9181989696,60,3,>10K
139,never,31119,20134216,58.0078546299,60,5,>10K
140,say,30882,20165098,58.0968274792,60,3,>10K
141,point,30870,20195968,58.1857657558,60,5,>10K
142,great,30736,20226704,58.2743179706,60,5,>10K
143,world,29663,20256367,58.3597788096,60,5,>10K
144,need,29580,20285947,58.4450005208,60,4,>10K
145,should,27936,20313883,58.5254857717,60,6,>10K
146,every,27850,20341733,58.6057232516,60,5,>10K
147,own,27694,20369427,58.6855112863,60,3,>10K
148,another,27580,20397007,58.7649708804,60,7,>10K
149,book,27347,20424354,58.8437591879,60,4,>10K
150,didn,27305,20451659,58.9224264909,60,4,>10K
151,home,26911,20478570,58.9999586568,60,4,>10K
152,week,26733,20505303,59.0769779943,60,4,>10K
153,always,26504,20531807,59.1533375694,60,6,>10K
154,find,25938,20557745,59.2280664654,60,4,>10K
155,again,25829,20583574,59.3024813261,60,5,>10K
156,look,25818,20609392,59.376864495,60,4,>10K
157,why,25688,20635080,59.4508731264,60,3,>10K
158,long,25490,20660570,59.5243113082,60,4,>10K
159,each,25449,20686019,59.5976313665,60,4,>10K
160,come,25384,20711403,59.6707641561,60,4,>10K
161,today,24971,20736374,59.7427070685,60,5,>10K
162,god,24838,20761212,59.8142668001,60,3,>10K
163,next,24795,20786007,59.8857026462,60,4,>10K
164,feel,24252,20810259,59.9555740776,60,4,>10K
165,use,24249,20834508,60.0254368657,70,3,>10K
166,such,24206,20858714,60.0951757683,70,4,>10K
167,since,24010,20882724,60.1643499835,70,5,>10K
168,let,23960,20906684,60.2333801457,70,3,>10K
169,thing,23640,20930324,60.3014883692,70,5,>10K
170,same,23613,20953937,60.3695188042,70,4,>10K
171,used,23027,20976964,60.4358609388,70,4,>10K
172,place,22734,20999698,60.5013589233,70,5,>10K
173,best,22332,21022030,60.5656987222,70,4,>10K
174,sure,22244,21044274,60.629784988,70,4,>10K
175,ve,21837,21066111,60.692698663,70,2,>10K
176,until,21780,21087891,60.7554481177,70,5,>10K
177,lot,21453,21109344,60.8172554662,70,3,>10K
178,thought,21120,21130464,60.8781034222,70,7,>10K
179,put,21103,21151567,60.9389024003,70,3,>10K
180,part,20969,21172536,60.9993153164,70,4,>10K
181,old,20764,21193300,61.0591376156,70,3,>10K
182,both,20572,21213872,61.1184067516,70,4,>10K
183,read,20560,21234432,61.1776413148,70,4,>10K
184,though,20508,21254940,61.236726063,70,6,>10K
185,away,20487,21275427,61.295750309,70,4,>10K
186,better,20397,21295824,61.3545152597,70,6,>10K
187,does,20146,21315970,61.4125570648,70,4,>10K
188,family,19944,21335914,61.470016896,70,6,>10K
189,days,19757,21355671,61.5269379692,70,4,>10K
190,went,19709,21375380,61.5837207517,70,4,>10K
191,end,19479,21394859,61.6398408907,70,3,>10K
192,bit,19402,21414261,61.6957391881,70,3,>10K
193,might,19282,21433543,61.7512917586,70,5,>10K
194,found,19221,21452764,61.8066685845,70,5,>10K
195,ever,19187,21471951,61.8619474544,70,4,>10K
196,blog,19113,21491064,61.917013126,70,4,>10K
197,give,18994,21510058,61.9717359516,70,4,>10K
198,man,18902,21528960,62.0261937198,70,3,>10K
199,night,18892,21547852,62.0806226774,70,5,>10K
200,story,18670,21566522,62.1344120401,70,5,>10K
201,different,18633,21585155,62.1880948035,70,9,>10K
202,big,18589,21603744,62.2416508004,70,3,>10K
203,enough,18571,21622315,62.2951549383,70,6,>10K
204,without,18569,21640884,62.348653314,70,7,>10K
205,house,18332,21659216,62.4014688789,70,5,>10K
206,help,18249,21677465,62.4540453159,70,4,>10K
207,having,17809,21695274,62.5053540871,70,6,>10K
208,actually,17787,21713061,62.5565994751,70,8,>10K
209,once,17770,21730831,62.6077958851,70,4,>10K
210,keep,17718,21748549,62.65884248,70,4,>10K
211,myself,17692,21766241,62.7098141674,70,6,>10K
212,came,17569,21783810,62.7604314846,70,4,>10K
213,school,17395,21801205,62.8105474976,70,6,>10K
214,re,17395,21818600,62.8606635107,70,2,>10K
215,post,17330,21835930,62.9105922549,70,4,>10K
216,three,17321,21853251,62.9604950696,70,5,>10K
217,doing,17293,21870544,63.0103172146,70,5,>10K
218,between,16873,21887417,63.0589293151,70,7,>10K
219,getting,16678,21904095,63.1069796092,70,7,>10K
220,done,16510,21920605,63.1545458854,70,4,>10K
221,times,16501,21937106,63.2020862321,70,5,>10K
222,show,16290,21953396,63.2490186755,70,4,>10K
223,set,16282,21969678,63.2959280703,70,3,>10K
224,children,16241,21985919,63.3427193418,70,8,>10K
225,friends,16177,22002096,63.3893262256,70,7,>10K
226,left,16050,22018146,63.4355672149,70,4,>10K
227,yet,16028,22034174,63.4817448209,70,3,>10K
228,pretty,15822,22049996,63.5273289289,70,6,>10K
229,started,15784,22065780,63.5728035566,70,7,>10K
230,together,15765,22081545,63.6182234442,70,8,>10K
231,took,15698,22097243,63.6634503009,70,4,>10K
232,doesn,15691,22112934,63.7086569902,70,5,>10K
233,course,15689,22128623,63.7538579174,70,6,>10K
234,must,15665,22144288,63.7989896992,70,4,>10K
235,d,15652,22159940,63.8440840272,70,1,>10K
236,wanted,15551,22175491,63.8888873683,70,6,>10K
237,making,15446,22190937,63.9333881983,70,6,>10K
238,however,15234,22206171,63.9772782438,70,7,>10K
239,tell,15214,22221385,64.0211106682,70,4,>10K
240,someone,15034,22236419,64.0644245021,70,7,>10K
241,hope,15021,22251440,64.1077008822,70,4,>10K
242,anything,14964,22266404,64.1508130419,70,8,>10K
243,start,14939,22281343,64.1938531752,70,5,>10K
244,try,14933,22296276,64.2368760221,70,3,>10K
245,everything,14924,22311200,64.2798729396,70,10,>10K
246,looking,14874,22326074,64.322725804,70,7,>10K
247,fun,14639,22340713,64.3649016198,70,3,>10K
248,able,14502,22355215,64.4066827305,70,4,>10K
249,fact,14490,22369705,64.4484292685,70,4,>10K
250,everyone,14416,22384121,64.4899626082,70,8,>10K
251,during,14415,22398536,64.5314930668,70,6,>10K
252,quite,14414,22412950,64.5730206444,70,5,>10K
253,small,14340,22427290,64.6143350236,70,5,>10K
254,hard,14224,22441514,64.6553152,70,4,>10K
255,told,14193,22455707,64.6962060637,70,4,>10K
256,kids,14103,22469810,64.736837632,70,4,>10K
257,makes,14057,22483867,64.7773366717,70,5,>10K
258,far,14002,22497869,64.8176772532,70,3,>10K
259,nothing,13923,22511792,64.857790231,70,7,>10K
260,room,13870,22525662,64.8977505127,70,4,>10K
261,person,13676,22539338,64.9371518691,70,6,>10K
262,top,13634,22552972,64.976432221,70,3,>10K
263,maybe,13607,22566579,65.0156347843,70,5,>10K
264,real,13603,22580182,65.0548258234,70,4,>10K
265,ll,13548,22593730,65.0938584043,70,2,>10K
266,called,13541,22607271,65.1328708178,70,6,>10K
267,least,13533,22620804,65.1718601828,70,5,>10K
268,already,13509,22634313,65.2107804024,70,7,>10K
269,food,13475,22647788,65.249602666,70,4,>10K
270,water,13383,22661171,65.2881598722,70,5,>10K
271,kind,13356,22674527,65.3266392899,70,4,>10K
272,head,13258,22687785,65.3648363638,70,4,>10K
273,white,13167,22700952,65.4027712614,70,5,>10K
274,trying,13146,22714098,65.4406456567,70,6,>10K
275,happy,13123,22727221,65.4784537877,70,5,>10K
276,believe,13024,22740245,65.515976694,70,7,>10K
277,whole,12956,22753201,65.5533036882,70,5,>10K
278,mind,12864,22766065,65.5903656251,70,4,>10K
279,often,12805,22778870,65.6272575795,70,5,>10K
280,books,12758,22791628,65.6640141241,70,5,>10K
281,high,12735,22804363,65.7007044044,70,4,>10K
282,using,12718,22817081,65.7373457067,70,5,>10K
283,live,12705,22829786,65.7739495553,70,4,>10K
284,past,12600,22842386,65.8102508927,70,4,>10K
285,under,12589,22854975,65.8465205384,70,5,>10K
286,side,12568,22867543,65.8827296819,70,4,>10K
287,full,12556,22880099,65.9189042528,70,4,>10K
288,name,12539,22892638,65.9550298456,70,4,>10K
289,writing,12452,22905090,65.9909047863,70,7,>10K
290,along,12381,22917471,66.0265751719,70,5,>10K
291,friend,12373,22929844,66.062222509,70,6,>10K
292,working,12371,22942215,66.097864084,70,7,>10K
293,probably,12330,22954545,66.1333875356,70,8,>10K
294,guy,12321,22966866,66.1688850577,70,3,>10K
295,bad,12304,22979170,66.2043336018,70,3,>10K
296,add,12251,22991421,66.2396294498,70,3,>10K
297,later,12222,23003643,66.2748417471,70,5,>10K
298,others,12189,23015832,66.3099589694,70,6,>10K
299,against,12136,23027968,66.3449234957,70,7,>10K
300,idea,12127,23040095,66.3798620924,70,4,>10K
301,ago,12083,23052178,66.4146739225,70,3,>10K
302,remember,12022,23064200,66.4493100081,70,8,>10K
303,minutes,12012,23076212,66.4839172831,70,7,>10K
304,free,11968,23088180,66.5183977915,70,4,>10K
305,almost,11963,23100143,66.5528638946,70,6,>10K
306,wasn,11825,23111968,66.5869324117,70,4,>10K
307,heart,11825,23123793,66.6210009287,70,5,>10K
308,morning,11775,23135568,66.6549253928,70,7,>10K
309,money,11720,23147288,66.6886913987,70,5,>10K
310,decided,11716,23159004,66.7224458804,70,7,>10K
311,black,11709,23170713,66.7561801947,70,5,>10K
312,second,11691,23182404,66.7898626499,70,6,>10K
313,less,11625,23194029,66.8233549552,70,4,>10K
314,change,11606,23205635,66.8567925204,70,6,>10K
315,comes,11448,23217083,66.8897748784,70,5,>10K
316,words,11398,23228481,66.9226131835,70,5,>10K
317,couple,11352,23239833,66.9553189598,70,6,>10K
318,become,11276,23251109,66.9878057757,70,6,>10K
319,rather,11207,23262316,67.0200937986,70,6,>10K
320,isn,11181,23273497,67.052306914,70,3,>10K
321,women,11163,23284660,67.0844681703,70,5,>10K
322,city,11160,23295820,67.1166207834,70,4,>10K
323,hand,11150,23306970,67.148744586,70,4,>10K
324,seems,11028,23317998,67.1805168994,70,5,>10K
325,yes,11023,23329021,67.2122748075,70,3,>10K
326,seen,11017,23340038,67.2440154292,70,4,>10K
327,asked,10944,23350982,67.2755457337,70,5,>10K
328,reading,10902,23361884,67.3069550337,70,7,>10K
329,felt,10902,23372786,67.3383643338,70,4,>10K
330,else,10898,23383684,67.3697621096,70,4,>10K
331,won,10809,23394493,67.4009034711,70,3,>10K
332,nice,10693,23405186,67.4317106299,70,4,>10K
333,call,10689,23415875,67.4625062645,70,4,>10K
334,play,10649,23426524,67.4931866567,70,4,>10K
335,case,10648,23437172,67.5238641679,70,4,>10K
336,weeks,10577,23447749,67.5543371239,70,5,>10K
337,music,10576,23458325,67.5848071988,70,5,>10K
338,finally,10559,23468884,67.6152282958,70,7,>10K
339,run,10537,23479421,67.6455860095,70,3,>10K
340,state,10514,23489935,67.6758774588,70,5,>10K
341,sometimes,10478,23500413,67.70606519,70,9,>10K
342,face,10460,23510873,67.7362010622,70,4,>10K
343,mother,10432,23521305,67.7662562647,70,6,>10K
344,light,10422,23531727,67.7962826566,70,5,>10K
345,means,10376,23542103,67.8261765199,70,5,>10K
346,instead,10281,23552384,67.8557966825,70,7,>10K
347,job,10271,23562655,67.8853880346,70,3,>10K
348,says,10242,23572897,67.914895836,70,4,>10K
349,card,10239,23583136,67.9443949943,70,4,>10K
350,beer,10211,23593347,67.9738134829,70,4,>10K
351,write,10188,23603535,68.0031657071,70,5,>10K
352,young,10156,23613691,68.0324257375,70,5,>10K
353,oh,10090,23623781,68.061495618,70,2,>10K
354,share,10044,23633825,68.0904329698,70,5,>10K
355,given,10031,23643856,68.1193328679,70,5,>10K
356,months,10027,23653883,68.1482212417,70,6,>10K
357,knew,10007,23663890,68.1770519943,70,4,>10K
358,important,9998,23673888,68.2058568174,70,9,>1K
359,hours,9978,23683866,68.2346040194,70,5,>1K
360,leave,9939,23693805,68.2632388601,70,5,>1K
361,beautiful,9906,23703711,68.2917786258,70,9,>1K
362,saw,9894,23713605,68.3202838188,70,3,>1K
363,mean,9833,23723438,68.3486132673,70,4,>1K
364,please,9813,23733251,68.3768850946,70,6,>1K
365,several,9778,23743029,68.4050560848,70,7,>1K
366,coming,9765,23752794,68.4331896213,70,6,>1K
367,taking,9755,23762549,68.4612943472,70,6,>1K
368,anyone,9734,23772283,68.4893385709,70,6,>1K
369,thinking,9702,23781985,68.5172906007,70,8,>1K
370,experience,9694,23791679,68.545219582,70,10,>1K
371,group,9662,23801341,68.5730563695,70,5,>1K
372,word,9614,23810955,68.6007548661,70,4,>1K
373,month,9599,23820554,68.6284101469,70,5,>1K
374,stop,9579,23830133,68.6560078065,70,4,>1K
375,open,9559,23839692,68.6835478449,70,4,>1K
376,easy,9557,23849249,68.7110821213,70,4,>1K
377,paper,9548,23858797,68.738590468,70,5,>1K
378,child,9538,23868335,68.7660700042,70,5,>1K
379,body,9491,23877826,68.7934141307,70,4,>1K
380,film,9471,23887297,68.820700636,70,4,>1K
381,girl,9392,23896689,68.8477595376,70,4,>1K
382,order,9360,23906049,68.8747262454,70,5,>1K
383,cut,9358,23915407,68.9016871911,70,3,>1K
384,soon,9356,23924763,68.9286423746,70,4,>1K
385,care,9316,23934079,68.9554823158,70,4,>1K
386,number,9310,23943389,68.9823049707,70,6,>1K
387,men,9310,23952699,69.0091276256,70,3,>1K
388,either,9310,23962009,69.0359502804,70,6,>1K
389,country,9302,23971311,69.0627498868,70,7,>1K
390,true,9208,23980519,69.0892786737,70,4,>1K
391,favorite,9171,23989690,69.1157008614,70,8,>1K
392,power,9155,23998845,69.1420769522,70,5,>1K
393,living,9104,24007949,69.168306109,70,6,>1K
394,half,9103,24017052,69.1945323848,70,4,>1K
395,reason,9075,24026127,69.2206779909,70,6,>1K
396,business,9018,24035145,69.2466593766,70,8,>1K
397,line,9001,24044146,69.2725917844,70,4,>1K
398,game,8924,24053070,69.2983023507,70,4,>1K
399,public,8904,24061974,69.3239552958,70,6,>1K
400,woman,8876,24070850,69.3495275712,70,5,>1K
401,baby,8848,24079698,69.375019177,70,4,>1K
402,stuff,8827,24088525,69.4004502806,70,5,>1K
403,early,8822,24097347,69.4258669789,70,5,>1K
404,party,8806,24106153,69.4512375803,70,5,>1K
405,list,8795,24114948,69.47657649,70,4,>1K
406,perfect,8791,24123739,69.5019038755,70,7,>1K
407,eyes,8772,24132511,69.5271765209,70,4,>1K
408,government,8749,24141260,69.5523829019,70,10,>1K
409,large,8727,24149987,69.5775258996,70,5,>1K
410,ask,8720,24158707,69.60264873,70,3,>1K
411,moment,8714,24167421,69.6277542739,70,6,>1K
412,feeling,8696,24176117,69.6528079589,70,7,>1K
413,talk,8691,24184808,69.6778472385,70,4,>1K
414,turn,8674,24193482,69.7028375401,70,4,>1K
415,within,8598,24202080,69.7276088813,70,6,>1K
416,movie,8554,24210634,69.7522534559,70,5,>1K
417,weekend,8510,24219144,69.776771264,70,7,>1K
418,rest,8510,24227654,69.801289072,70,4,>1K
419,especially,8497,24236151,69.8257694263,70,10,>1K
420,local,8495,24244646,69.8502440185,70,5,>1K
421,four,8463,24253109,69.8746264167,70,4,>1K
422,short,8462,24261571,69.899005934,70,5,>1K
423,challenge,8440,24270011,69.9233220679,70,9,>1K
424,couldn,8431,24278442,69.9476122723,70,6,>1K
425,behind,8423,24286865,69.9718794283,70,6,>1K
426,needed,8408,24295273,69.9961033683,80,6,>1K
427,although,8382,24303655,70.0202524009,80,8,>1K
428,looked,8350,24312005,70.0443092396,80,6,>1K
429,above,8327,24320332,70.0682998139,80,5,>1K
430,taken,8320,24328652,70.0922702208,80,5,>1K
431,enjoy,8308,24336960,70.116206055,80,5,>1K
432,across,8291,24345251,70.1400929113,80,6,>1K
433,lives,8237,24353488,70.1638241903,80,5,>1K
434,car,8231,24361719,70.187538183,80,3,>1K
435,land,8221,24369940,70.2112233652,80,4,>1K
436,matter,8221,24378161,70.2349085473,80,6,>1K
437,jesus,8178,24386339,70.2584698439,80,5,>1K
438,simply,8167,24394506,70.2819994489,80,6,>1K
439,sense,8109,24402615,70.3053619524,80,5,>1K
440,front,8109,24410724,70.328724456,80,5,>1K
441,red,8102,24418826,70.3520667922,80,3,>1K
442,bring,8079,24426905,70.375342864,80,5,>1K
443,lost,8078,24434983,70.3986160547,80,4,>1K
444,team,7998,24442981,70.4216587608,80,4,>1K
445,hear,7962,24450943,70.4445977488,80,4,>1K
446,art,7945,24458888,70.4674877587,80,3,>1K
447,wonderful,7933,24466821,70.490343196,80,9,>1K
448,close,7930,24474751,70.5131899901,80,5,>1K
449,goes,7914,24482665,70.5359906873,80,4,>1K
450,problem,7892,24490557,70.5587280011,80,7,>1K
451,wrong,7864,24498421,70.5813846454,80,5,>1K
452,gave,7851,24506272,70.6040038358,80,4,>1K
453,mom,7842,24514114,70.6265970968,80,3,>1K
454,picture,7821,24521935,70.6491298555,80,7,>1K
455,outside,7797,24529732,70.6715934688,80,7,>1K
456,perhaps,7783,24537515,70.6940167473,80,7,>1K
457,check,7759,24545274,70.7163708804,80,5,>1K
458,wait,7744,24553018,70.7386817976,80,4,>1K
459,whether,7730,24560748,70.76095238,80,7,>1K
460,parents,7726,24568474,70.7832114381,80,7,>1K
461,question,7707,24576181,70.8054157562,80,8,>1K
462,project,7703,24583884,70.82760855,80,7,>1K
463,saying,7700,24591584,70.8497927006,80,6,>1K
464,heard,7694,24599278,70.8719595649,80,5,>1K
465,human,7667,24606945,70.8940486406,80,5,>1K
466,turned,7666,24614611,70.9161348353,80,6,>1K
467,understand,7653,24622264,70.9381835762,80,10,>1K
468,information,7646,24629910,70.9602121496,80,11,>1K
469,series,7633,24637543,70.9822032693,80,6,>1K
470,american,7633,24645176,71.0041943891,80,8,>1K
471,ready,7624,24652800,71.0261595792,80,5,>1K
472,move,7598,24660398,71.0480498619,80,4,>1K
473,news,7594,24667992,71.0699286203,80,4,>1K
474,special,7591,24675583,71.0917987356,80,7,>1K
475,father,7588,24683171,71.1136602077,80,6,>1K
476,needs,7551,24690722,71.1354150806,80,5,>1K
477,loved,7545,24698267,71.1571526671,80,5,>1K
478,seem,7538,24705805,71.1788700863,80,4,>1K
479,amazing,7485,24713290,71.2004348094,80,7,>1K
480,christmas,7474,24720764,71.2219678408,80,9,>1K
481,thank,7429,24728193,71.2433712245,80,5,>1K
482,death,7415,24735608,71.2647342735,80,5,>1K
483,buy,7414,24743022,71.2860944414,80,3,>1K
484,tried,7404,24750426,71.3074257987,80,5,>1K
485,simple,7390,24757816,71.3287168212,80,6,>1K
486,watch,7383,24765199,71.3499876763,80,5,>1K
487,running,7381,24772580,71.3712527692,80,7,>1K
488,eat,7364,24779944,71.3924688842,80,3,>1K
489,inside,7361,24787305,71.413676356,80,6,>1K
490,ones,7358,24794663,71.4348751846,80,4,>1K
491,summer,7335,24801998,71.4560077489,80,6,>1K
492,interesting,7333,24809331,71.4771345511,80,11,>1K
493,area,7332,24816663,71.4982584721,80,4,>1K
494,haven,7326,24823989,71.5193651069,80,5,>1K
495,support,7311,24831300,71.5404285258,80,7,>1K
496,plan,7284,24838584,71.5614141561,80,4,>1K
497,future,7281,24845865,71.5823911432,80,6,>1K
498,church,7277,24853142,71.603356606,80,6,>1K
499,process,7256,24860398,71.6242615667,80,7,>1K
500,history,7233,24867631,71.645100263,80,7,>1K
501,looks,7222,24874853,71.6659072677,80,5,>1K
502,possible,7210,24882063,71.6866796996,80,8,>1K
503,company,7209,24889272,71.7074492505,80,7,>1K
504,usually,7137,24896409,71.7280113652,80,7,>1K
505,known,7128,24903537,71.7485475504,80,5,>1K
506,including,7112,24910649,71.7690376386,80,9,>1K
507,system,7060,24917709,71.7893779118,80,6,>1K
508,gets,7059,24924768,71.8097153039,80,4,>1K
509,stay,7058,24931826,71.8300498149,80,4,>1K
510,husband,7045,24938871,71.8503468722,80,7,>1K
511,sweet,7037,24945908,71.8706208811,80,5,>1K
512,store,7010,24952918,71.8908171013,80,5,>1K
513,walk,6975,24959893,71.9109124845,80,4,>1K
514,piece,6973,24966866,71.9310021056,80,5,>1K
515,yourself,6967,24973833,71.9510744404,80,8,>1K
516,upon,6963,24980796,71.9711352509,80,4,>1K
517,social,6955,24987751,71.9911730129,80,6,>1K
518,learn,6938,24994689,72.0111617969,80,5,>1K
519,following,6909,25001598,72.0310670303,80,9,>1K
520,green,6870,25008468,72.0508599023,80,5,>1K
521,five,6845,25015313,72.0705807479,80,4,>1K
522,longer,6836,25022149,72.090275664,80,6,>1K
523,character,6825,25028974,72.1099388884,80,9,>1K
524,mr,6822,25035796,72.1295934697,80,2,>1K
525,talking,6809,25042605,72.1492105972,80,7,>1K
526,himself,6806,25049411,72.1688190815,80,7,>1K
527,spent,6805,25056216,72.1884246847,80,5,>1K
528,themselves,6764,25062980,72.2079121646,80,10,>1K
529,son,6738,25069718,72.2273247369,80,3,>1K
530,create,6684,25076402,72.2465817321,80,6,>1K
531,pictures,6659,25083061,72.2657667008,80,8,>1K
532,stories,6655,25089716,72.2849401453,80,7,>1K
533,ways,6647,25096363,72.3040905413,80,4,>1K
534,space,6633,25102996,72.3232006025,80,5,>1K
535,happened,6604,25109600,72.342227113,80,8,>1K
536,added,6600,25116200,72.3612420992,80,5,>1K
537,completely,6589,25122789,72.3802253939,80,10,>1K
538,thanks,6589,25129378,72.3992086885,80,6,>1K
539,late,6586,25135964,72.4181833399,80,4,>1K
540,takes,6576,25142540,72.4371291808,80,5,>1K
541,door,6560,25149100,72.4560289247,80,4,>1K
542,lots,6535,25155635,72.4748566421,80,4,>1K
543,form,6533,25162168,72.4936785975,80,4,>1K
544,works,6530,25168698,72.5124919096,80,5,>1K
545,cannot,6522,25175220,72.5312821733,80,6,>1K
546,guess,6491,25181711,72.5499831242,80,5,>1K
547,anyway,6471,25188182,72.5686264539,80,6,>1K
548,hands,6463,25194645,72.5872467351,80,5,>1K
549,gone,6458,25201103,72.6058526111,80,4,>1K
550,wouldn,6457,25207560,72.624455606,80,6,>1K
551,clear,6454,25214014,72.6430499577,80,5,>1K
552,law,6454,25220468,72.6616443094,80,3,>1K
553,cool,6453,25226921,72.6802357801,80,4,>1K
554,visit,6444,25233365,72.6988013212,80,5,>1K
555,dark,6423,25239788,72.7173063601,80,4,>1K
556,community,6414,25246202,72.7357854695,80,9,>1K
557,town,6412,25252614,72.7542588167,80,4,>1K
558,recently,6410,25259024,72.7727264019,80,8,>1K
559,age,6398,25265422,72.7911594143,80,3,>1K
560,season,6397,25271819,72.8095895457,80,6,>1K
561,john,6385,25278204,72.8279851044,80,4,>1K
562,war,6379,25284583,72.8463633767,80,3,>1K
563,example,6366,25290949,72.8647041952,80,7,>1K
564,hot,6343,25297292,72.8829787495,80,3,>1K
565,girls,6335,25303627,72.9012302552,80,5,>1K
566,playing,6327,25309954,72.9194587125,80,7,>1K
567,huge,6302,25316256,72.9376151433,80,4,>1K
568,lord,6287,25322543,72.9557283582,80,4,>1K
569,bed,6278,25328821,72.9738156437,80,3,>1K
570,forward,6262,25335083,72.9918568321,80,7,>1K
571,single,6234,25341317,73.009817351,80,6,>1K
572,written,6228,25347545,73.0277605835,80,7,>1K
573,boy,6227,25353772,73.0457009349,80,3,>1K
574,hair,6212,25359984,73.0635980704,80,4,>1K
575,street,6196,25366180,73.0814491091,80,6,>1K
576,happen,6194,25372374,73.0992943856,80,6,>1K
577,deal,6175,25378549,73.1170849219,80,4,>1K
578,song,6165,25384714,73.1348466477,80,4,>1K
579,yesterday,6163,25390877,73.1526026114,80,9,>1K
580,personal,6150,25397027,73.1703211213,80,8,>1K
581,available,6150,25403177,73.1880396313,80,9,>1K
582,media,6108,25409285,73.2056371367,80,5,>1K
583,fall,6074,25415359,73.2231366862,80,4,>1K
584,whatever,6043,25421402,73.2405469229,80,8,>1K
585,national,6041,25427443,73.2579513974,80,8,>1K
586,itself,6040,25433483,73.2753529909,80,6,>1K
587,students,6028,25439511,73.2927200117,80,8,>1K
588,pay,6011,25445522,73.3100380545,80,3,>1K
589,chance,6002,25451524,73.3273301677,80,6,>1K
590,level,6002,25457526,73.344622281,80,5,>1K
591,color,5979,25463505,73.3618481299,80,5,>1K
592,design,5965,25469470,73.379033644,80,6,>1K
593,certain,5941,25475411,73.3961500127,80,7,>1K
594,due,5898,25481309,73.4131424959,80,3,>1K
595,control,5879,25487188,73.4300802389,80,7,>1K
596,health,5873,25493061,73.4470006956,80,6,>1K
597,cover,5872,25498933,73.4639182713,80,5,>1K
598,based,5872,25504805,73.4808358469,80,5,>1K
599,hit,5854,25510659,73.4977015635,80,3,>1K
600,hold,5853,25516512,73.5145643991,80,4,>1K
601,began,5845,25522357,73.5314041861,80,5,>1K
602,worth,5840,25528197,73.5482295679,80,5,>1K
603,hour,5840,25534037,73.5650549497,80,4,>1K
604,sort,5836,25539873,73.5818688073,80,4,>1K
605,south,5824,25545697,73.5986480921,80,5,>1K
606,police,5818,25551515,73.6154100906,80,6,>1K
607,characters,5795,25557310,73.6321058247,80,10,>1K
608,road,5785,25563095,73.6487727483,80,4,>1K
609,wish,5780,25568875,73.6654252666,80,4,>1K
610,etc,5777,25574652,73.6820691417,80,3,>1K
611,watching,5763,25580415,73.6986726819,80,8,>1K
612,trip,5759,25586174,73.715264698,80,4,>1K
613,entire,5753,25591927,73.7318394277,80,6,>1K
614,worked,5744,25597671,73.7483882278,80,6,>1K
615,sound,5744,25603415,73.764937028,80,5,>1K
616,definitely,5733,25609148,73.7814541365,80,10,>1K
617,middle,5727,25614875,73.7979539587,80,6,>1K
618,blue,5716,25620591,73.8144220892,80,4,>1K
619,page,5714,25626305,73.8308844576,80,4,>1K
620,questions,5709,25632014,73.8473324207,80,9,>1K
621,giving,5706,25637720,73.8637717406,80,6,>1K
622,office,5699,25643419,73.8801908932,80,6,>1K
623,strong,5699,25649118,73.8966100457,80,6,>1K
624,dinner,5692,25654810,73.9130090308,80,6,>1K
625,online,5689,25660499,73.9293993728,80,6,>1K
626,below,5678,25666177,73.9457580231,80,5,>1K
627,brought,5655,25671832,73.962050409,80,7,>1K
628,continue,5645,25677477,73.9783139844,80,8,>1K
629,lovely,5631,25683108,73.9945372249,80,6,>1K
630,alone,5615,25688723,74.0107143685,80,5,>1K
631,follow,5610,25694333,74.0268771069,80,6,>1K
632,standing,5601,25699934,74.0430139157,80,8,>1K
633,phone,5581,25705515,74.0590931033,80,5,>1K
634,exactly,5570,25711085,74.0751405993,80,7,>1K
635,seeing,5548,25716633,74.0911247119,80,6,>1K
636,further,5538,25722171,74.1070800141,80,7,>1K
637,wants,5531,25727702,74.1230151487,80,5,>1K
638,spend,5508,25733210,74.1388840191,80,5,>1K
639,became,5489,25738699,74.1546981493,80,6,>1K
640,states,5486,25744185,74.1705036364,80,6,>1K
641,style,5486,25749671,74.1863091235,80,5,>1K
642,market,5479,25755150,74.2020944431,80,6,>1K
643,seemed,5477,25760627,74.2178740007,80,6,>1K
644,table,5476,25766103,74.2336506771,80,5,>1K
645,recipe,5470,25771573,74.2494100673,80,6,>1K
646,ideas,5466,25777039,74.2651579331,80,5,>1K
647,image,5455,25782494,74.2808741074,80,5,>1K
648,waiting,5449,25787943,74.2965729953,80,7,>1K
649,truth,5448,25793391,74.3122690021,80,5,>1K
650,event,5448,25798839,74.327965009,80,5,>1K
651,answer,5445,25804284,74.3436523726,80,6,>1K
652,service,5441,25809725,74.3593282121,80,7,>1K
653,meet,5416,25815141,74.374932025,80,4,>1K
654,break,5416,25820557,74.390535838,80,5,>1K
655,according,5399,25825956,74.406090673,80,9,>1K
656,earth,5398,25831354,74.4216426269,80,5,>1K
657,knows,5388,25836742,74.4371657702,80,5,>1K
658,cold,5382,25842124,74.4526716272,80,4,>1K
659,fine,5370,25847494,74.4681429115,80,4,>1K
660,main,5346,25852840,74.4835450503,80,4,>1K
661,oil,5345,25858185,74.4989443081,80,3,>1K
662,act,5345,25863530,74.5143435659,80,3,>1K
663,quickly,5343,25868873,74.5297370616,80,7,>1K
664,certainly,5317,25874190,74.5450556498,80,9,>1K
665,difficult,5302,25879492,74.5603310221,80,9,>1K
666,air,5301,25884793,74.5756035133,80,3,>1K
667,daughter,5295,25890088,74.5908587182,80,8,>1K
668,friday,5278,25895366,74.6060649451,80,6,>1K
669,issue,5273,25900639,74.6212567667,80,5,>1K
670,excited,5270,25905909,74.6364399451,80,7,>1K
671,created,5267,25911176,74.6516144804,80,7,>1K
672,members,5267,25916443,74.6667890156,80,7,>1K
673,photos,5264,25921707,74.6819549077,80,6,>1K
674,note,5248,25926955,74.6970747028,80,4,>1K
675,pick,5230,25932185,74.7121426389,80,4,>1K
676,view,5224,25937409,74.7271932886,80,4,>1K
677,cup,5212,25942621,74.7422093657,80,3,>1K
678,truly,5212,25947833,74.7572254427,80,5,>1K
679,kept,5198,25953031,74.7722011849,80,4,>1K
680,building,5189,25958220,74.7871509976,80,8,>1K
681,attention,5188,25963408,74.8020979292,80,9,>1K
682,birthday,5182,25968590,74.8170275745,80,8,>1K
683,step,5178,25973768,74.8319456955,80,4,>1K
684,met,5170,25978938,74.8468407681,80,3,>1K
685,bought,5161,25984099,74.8617099111,80,6,>1K
686,york,5152,25989251,74.8765531246,80,4,>1K
687,general,5139,25994390,74.8913588844,80,7,>1K
688,photo,5135,25999525,74.9061531199,80,5,>1K
689,learned,5131,26004656,74.9209358312,80,7,>1K
690,stand,5131,26009787,74.9357185425,80,5,>1K
691,political,5124,26014911,74.9504810864,80,9,>1K
692,spring,5114,26020025,74.9652148196,80,6,>1K
693,among,5108,26025133,74.9799312666,80,5,>1K
694,voice,5099,26030232,74.994621784,80,5,>1K
695,e,5090,26035322,75.0092863719,80,1,>1K
696,sit,5075,26040397,75.0239077439,80,3,>1K
697,christ,5074,26045471,75.0385262348,80,6,>1K
698,shows,5065,26050536,75.0531187963,80,5,>1K
699,sunday,5060,26055596,75.0676969524,80,6,>1K
700,video,5060,26060656,75.0822751085,80,5,>1K
701,energy,5050,26065706,75.0968244541,80,6,>1K
702,complete,5044,26070750,75.1113565133,80,8,>1K
703,choice,5031,26075781,75.1258511187,80,6,>1K
704,original,5026,26080807,75.1403313188,80,8,>1K
705,wonder,5021,26085828,75.1547971137,80,6,>1K
706,5000,5000,26090828,75.1692024063,80,4,>1K
707,near,4991,26095819,75.1835817694,80,4,>1K
708,chocolate,4973,26100792,75.1979092735,80,9,>1K
709,dead,4970,26105762,75.2122281343,80,4,>1K
710,box,4966,26110728,75.2265354709,80,3,>1K
711,action,4965,26115693,75.2408399265,80,6,>1K
712,choose,4964,26120657,75.255141501,80,6,>1K
713,sleep,4943,26125600,75.2693825733,80,5,>1K
714,type,4937,26130537,75.2836063592,80,4,>1K
715,particular,4928,26135465,75.2978042157,80,10,>1K
716,u,4924,26140389,75.3119905478,80,1,>1K
717,likely,4921,26145310,75.3261682368,80,6,>1K
718,final,4908,26150218,75.3403084721,80,5,>1K
719,novel,4904,26155122,75.3544371831,80,5,>1K
720,onto,4887,26160009,75.3685169161,80,4,>1K
721,wife,4882,26164891,75.3825822438,80,4,>1K
722,issues,4881,26169772,75.3966446904,80,6,>1K
723,cake,4875,26174647,75.4106898507,80,4,>1K
724,america,4869,26179516,75.4247177247,80,7,>1K
725,aren,4868,26184384,75.4387427176,80,4,>1K
726,finished,4865,26189249,75.4527590673,80,8,>1K
727,beginning,4865,26194114,75.466775417,80,9,>1K
728,park,4863,26198977,75.4807860046,80,4,>1K
729,deep,4862,26203839,75.4947937112,80,4,>1K
730,starting,4862,26208701,75.5088014177,80,8,>1K
731,president,4855,26213556,75.5227889568,80,9,>1K
732,sugar,4854,26218410,75.5367736149,80,5,>1K
733,fresh,4835,26223245,75.5507035329,80,5,>1K
734,wrote,4827,26228072,75.5646104024,80,5,>1K
735,mine,4825,26232897,75.5785115098,80,4,>1K
736,present,4806,26237703,75.592357877,80,7,>1K
737,miss,4801,26242504,75.606189839,80,4,>1K
738,third,4799,26247303,75.6200160389,80,5,>1K
739,major,4798,26252101,75.6338393577,80,5,>1K
740,relationship,4795,26256896,75.6476540333,80,12,>1K
741,sitting,4789,26261685,75.6614514225,80,7,>1K
742,author,4781,26266466,75.6752257633,80,6,>1K
743,pain,4777,26271243,75.6889885799,80,4,>1K
744,busy,4776,26276019,75.7027485154,80,4,>1K
745,places,4774,26280793,75.7165026888,80,6,>1K
746,nature,4758,26285551,75.7302107653,80,6,>1K
747,site,4742,26290293,75.7438727448,80,4,>1K
748,fear,4738,26295031,75.7575232001,80,4,>1K
749,cream,4737,26299768,75.7711707743,80,5,>1K
750,society,4731,26304499,75.7848010622,80,7,>1K
751,ground,4731,26309230,75.7984313501,80,6,>1K
752,despite,4726,26313956,75.8120472326,80,7,>1K
753,pieces,4726,26318682,75.8256631152,80,6,>1K
754,tomorrow,4713,26323395,75.8392415441,80,8,>1K
755,eye,4713,26328108,75.8528199729,80,3,>1K
756,heat,4705,26332813,75.8663753532,80,4,>1K
757,band,4702,26337515,75.8799220904,80,4,>1K
758,crazy,4692,26342207,75.893440017,80,5,>1K
759,tv,4683,26346890,75.9069320141,80,2,>1K
760,amount,4682,26351572,75.9204211301,80,6,>1K
761,saturday,4680,26356252,75.933904484,80,8,>1K
762,win,4660,26360912,75.9473302167,80,3,>1K
763,april,4659,26365571,75.9607530684,80,5,>1K
764,college,4658,26370229,75.974173039,80,7,>1K
765,sun,4651,26374880,75.9875728422,80,3,>1K
766,cards,4648,26379528,76.0009640022,80,5,>1K
767,moving,4648,26384176,76.0143551622,80,6,>1K
768,dad,4634,26388810,76.0277059874,80,3,>1K
769,university,4628,26393438,76.0410395263,80,10,>1K
770,held,4624,26398062,76.0543615409,80,4,>1K
771,awesome,4623,26402685,76.0676806744,80,7,>1K
772,sent,4601,26407286,76.0809364247,80,4,>1K
773,towards,4577,26411863,76.0941230296,80,7,>1K
774,moved,4576,26416439,76.1073067534,80,5,>1K
775,gift,4575,26421014,76.1204875961,80,4,>1K
776,ok,4575,26425589,76.1336684389,80,2,>1K
777,sister,4574,26430163,76.1468464005,80,6,>1K
778,imagine,4572,26434735,76.1600186001,80,7,>1K
779,offer,4570,26439305,76.1731850376,80,5,>1K
780,extra,4567,26443872,76.1863428318,80,5,>1K
781,article,4565,26448437,76.199494864,80,7,>1K
782,return,4557,26452994,76.2126238477,80,6,>1K
783,taste,4547,26457541,76.2257240208,80,5,>1K
784,dog,4529,26462070,76.2387723349,80,3,>1K
785,center,4509,26466579,76.2517630278,80,6,>1K
786,learning,4508,26471087,76.2647508396,80,8,>1K
787,mix,4505,26475592,76.2777300082,80,3,>1K
788,low,4502,26480094,76.2907005337,80,3,>1K
789,guys,4502,26484596,76.3036710592,80,4,>1K
790,thoughts,4501,26489097,76.3166387036,80,8,>1K
791,result,4501,26493598,76.329606348,80,6,>1K
792,various,4500,26498098,76.3425711114,80,7,>1K
793,likes,4494,26502592,76.3555185884,80,5,>1K
794,brown,4490,26507082,76.3684545411,80,5,>1K
795,research,4483,26511565,76.3813703265,80,8,>1K
796,eating,4480,26516045,76.3942774687,80,6,>1K
797,recent,4472,26520517,76.4071615624,80,6,>1K
798,current,4466,26524983,76.4200283698,80,7,>1K
799,per,4450,26529433,76.4328490802,80,3,>1K
800,blood,4438,26533871,76.4456352179,80,5,>1K
801,six,4435,26538306,76.4584127125,80,3,>1K
802,program,4435,26542741,76.4711902071,80,7,>1K
803,million,4424,26547165,76.48393601,80,7,>1K
804,lead,4422,26551587,76.4966760508,80,4,>1K
805,cause,4418,26556005,76.5094045673,80,5,>1K
806,events,4408,26560413,76.5221042733,80,6,>1K
807,changed,4404,26564817,76.534792455,80,7,>1K
808,size,4398,26569215,76.5474633504,80,4,>1K
809,fit,4396,26573611,76.5601284837,80,3,>1K
810,problems,4385,26577996,76.5727619253,80,8,>1K
811,feet,4384,26582380,76.5853924859,80,4,>1K
812,website,4381,26586761,76.5980144033,80,7,>1K
813,price,4375,26591136,76.6106190343,80,5,>1K
814,okay,4369,26595505,76.623206379,80,4,>1K
815,evening,4364,26599869,76.6357793184,80,7,>1K
816,games,4363,26604232,76.6483493767,80,5,>1K
817,gives,4361,26608593,76.660913673,80,5,>1K
818,played,4352,26612945,76.6734520397,80,6,>1K
819,received,4348,26617293,76.6859788821,80,8,>1K
820,quick,4344,26621637,76.6984942004,80,5,>1K
821,focus,4343,26625980,76.7110066375,80,5,>1K
822,daily,4339,26630319,76.7235075505,80,5,>1K
823,race,4332,26634651,76.735988296,80,4,>1K
824,boys,4331,26638982,76.7484661605,80,4,>1K
825,chicken,4325,26643307,76.7609267386,80,7,>1K
826,provide,4325,26647632,76.7733873167,80,7,>1K
827,wall,4318,26651950,76.7858277274,80,4,>1K
828,kitchen,4313,26656263,76.7982537328,80,7,>1K
829,situation,4312,26660575,76.8106768572,80,9,>1K
830,opportunity,4311,26664886,76.8230971005,80,11,>1K
831,common,4300,26669186,76.8354856521,80,6,>1K
832,beyond,4291,26673477,76.8478482742,80,6,>1K
833,interest,4289,26677766,76.8602051342,80,8,>1K
834,super,4286,26682052,76.8725533511,80,5,>1K
835,drive,4278,26686330,76.8848785194,80,5,>1K
836,court,4277,26690607,76.8972008068,80,5,>1K
837,allow,4277,26694884,76.9095230941,80,5,>1K
838,scene,4274,26699158,76.9218367382,80,5,>1K
839,north,4273,26703431,76.9341475013,80,5,>1K
840,similar,4266,26707697,76.9464380969,80,7,>1K
841,faith,4265,26711962,76.9587258115,80,5,>1K
842,spirit,4261,26716223,76.9710020019,80,6,>1K
843,natural,4260,26720483,76.9832753112,80,7,>1K
844,walking,4260,26724743,76.9955486205,80,7,>1K
845,clean,4258,26729001,77.0078161677,80,5,>1K
846,wear,4250,26733251,77.0200606664,80,4,>1K
847,figure,4243,26737494,77.0322849978,80,6,>1K
848,forget,4240,26741734,77.0445006859,80,6,>1K
849,shop,4235,26745969,77.0567019688,80,4,>1K
850,warm,4232,26750201,77.0688946084,80,4,>1K
851,bottom,4215,26754416,77.0810382701,80,6,>1K
852,finish,4213,26758629,77.0931761697,80,6,>1K
853,totally,4213,26762842,77.1053140692,80,7,>1K
854,version,4212,26767054,77.1174490877,80,7,>1K
855,poor,4211,26771265,77.1295812252,80,4,>1K
856,fast,4208,26775473,77.1417047194,80,4,>1K
857,reality,4207,26779680,77.1538253327,80,7,>1K
858,save,4191,26783871,77.1658998489,80,4,>1K
859,brother,4191,26788062,77.1779743652,80,7,>1K
860,born,4186,26792248,77.1900344762,80,4,>1K
861,hate,4183,26796431,77.202085944,80,4,>1K
862,begin,4181,26800612,77.2141316497,80,5,>1K
863,funny,4180,26804792,77.2261744743,80,5,>1K
864,die,4180,26808972,77.2382172989,80,3,>1K
865,include,4175,26813147,77.2502457183,80,7,>1K
866,com,4157,26817304,77.2622222786,80,3,>1K
867,fire,4150,26821454,77.2741786714,80,4,>1K
868,throughout,4144,26825598,77.286117778,80,10,>1K
869,involved,4137,26829735,77.2980367171,80,8,>1K
870,weather,4137,26833872,77.3099556562,80,7,>1K
871,date,4127,26837999,77.3218457847,80,4,>1K
872,coffee,4118,26842117,77.3337099837,80,6,>1K
873,happens,4101,26846218,77.3455252047,80,7,>1K
874,march,4099,26850317,77.3573346636,80,5,>1K
875,round,4097,26854414,77.3691383604,80,5,>1K
876,english,4093,26858507,77.3809305329,80,7,>1K
877,ended,4093,26862600,77.3927227055,80,5,>1K
878,quality,4087,26866687,77.4044975917,80,7,>1K
879,weight,4073,26870760,77.416232143,80,6,>1K
880,growing,4069,26874829,77.4279551702,80,7,>1K
881,speak,4059,26878888,77.4396493867,80,5,>1K
882,comment,4059,26882947,77.4513436033,80,7,>1K
883,consider,4049,26886996,77.4630090092,80,8,>1K
884,plus,4043,26891039,77.4746571288,80,4,>1K
885,readers,4036,26895075,77.486285081,80,7,>1K
886,nearly,4036,26899111,77.4979130332,80,6,>1K
887,floor,4036,26903147,77.5095409854,80,5,>1K
888,cost,4030,26907177,77.5211516513,80,4,>1K
889,enjoyed,4028,26911205,77.532756555,80,7,>1K
890,link,4026,26915231,77.5443556966,80,4,>1K
891,garden,4023,26919254,77.5559461951,80,6,>1K
892,dream,3994,26923248,77.5674531428,80,5,>1K
893,doctor,3993,26927241,77.5789572095,80,6,>1K
894,cute,3989,26931230,77.590449752,80,4,>1K
895,review,3988,26935218,77.6019394134,80,6,>1K
896,rock,3986,26939204,77.6134233126,80,4,>1K
897,comments,3982,26943186,77.6248956877,80,8,>1K
898,tree,3968,26947154,77.6363277279,80,4,>1K
899,united,3968,26951122,77.6477597681,80,6,>1K
900,send,3967,26955089,77.6591889273,80,4,>1K
901,easily,3965,26959054,77.6706123243,80,6,>1K
902,meeting,3965,26963019,77.6820357214,80,7,>1K
903,absolutely,3953,26966972,77.6934245457,80,10,>1K
904,interested,3947,26970919,77.7047960837,80,10,>1K
905,cheese,3931,26974850,77.7161215248,80,6,>1K
906,monday,3916,26978766,77.72740375,80,6,>1K
907,email,3916,26982682,77.7386859751,80,5,>1K
908,collection,3911,26986593,77.749953795,80,10,>1K
909,self,3906,26990499,77.7612072096,80,4,>1K
910,meant,3889,26994388,77.7724116462,80,5,>1K
911,sounds,3880,26998268,77.7835901533,80,6,>1K
912,drink,3874,27002142,77.794751374,80,5,>1K
913,telling,3870,27006012,77.8059010705,80,7,>1K
914,whose,3869,27009881,77.8170478859,80,5,>1K
915,decision,3863,27013744,77.828177415,80,8,>1K
916,bar,3857,27017601,77.8392896577,80,3,>1K
917,earlier,3855,27021456,77.8503961383,80,7,>1K
918,expect,3854,27025310,77.8614997379,80,6,>1K
919,internet,3852,27029162,77.8725975753,80,8,>1K
920,record,3850,27033012,77.8836896506,80,6,>1K
921,normal,3849,27036861,77.8947788449,80,6,>1K
922,details,3848,27040709,77.9058651581,80,7,>1K
923,album,3846,27044555,77.9169457092,80,5,>1K
924,lunch,3843,27048398,77.9280176171,80,5,>1K
925,fight,3829,27052227,77.9390491902,80,5,>1K
926,report,3824,27056051,77.950066358,80,6,>1K
927,mostly,3823,27059874,77.9610806447,80,6,>1K
928,shot,3822,27063696,77.9720920504,80,4,>1K
929,changes,3820,27067516,77.983097694,80,7,>1K
930,shall,3819,27071335,77.9941004565,80,5,>1K
931,obama,3817,27075152,78.0050974568,80,5,>1K
932,feels,3816,27078968,78.0160915762,80,5,>1K
933,rights,3814,27082782,78.0270799334,80,6,>1K
934,products,3810,27086592,78.0380567664,80,8,>1K
935,seriously,3810,27090402,78.0490335993,80,9,>1K
936,sign,3808,27094210,78.0600046702,80,4,>1K
937,filled,3803,27098013,78.0709613358,80,6,>1K
938,eventually,3794,27101807,78.0818920718,80,10,>1K
939,bag,3784,27105591,78.0927939973,80,3,>1K
940,study,3782,27109373,78.1036901606,80,5,>1K
941,creative,3778,27113151,78.1145747997,80,8,>1K
942,ten,3777,27116928,78.1254565577,80,3,>1K
943,except,3765,27120693,78.1363037431,80,6,>1K
944,success,3764,27124457,78.1471480474,80,7,>1K
945,bowl,3756,27128213,78.1579693032,80,4,>1K
946,points,3750,27131963,78.1687732727,80,6,>1K
947,leaving,3749,27135712,78.1795743611,80,7,>1K
948,sorry,3745,27139457,78.1903639252,80,5,>1K
949,walked,3745,27143202,78.2011534894,80,6,>1K
950,dress,3742,27146944,78.2119344104,80,5,>1K
951,skin,3741,27150685,78.2227124503,80,4,>1K
952,flowers,3739,27154424,78.2334847282,80,7,>1K
953,supposed,3734,27158158,78.2442426007,80,8,>1K
954,trust,3732,27161890,78.2549947111,80,5,>1K
955,paul,3727,27165617,78.2657324162,80,4,>1K
956,apparently,3726,27169343,78.2764672403,80,10,>1K
957,winter,3725,27173068,78.2871991833,80,6,>1K
958,education,3719,27176787,78.2979138399,80,9,>1K
959,language,3718,27180505,78.3086256155,80,8,>1K
960,minute,3714,27184219,78.3193258669,80,6,>1K
961,dry,3714,27187933,78.3300261182,80,3,>1K
962,services,3712,27191645,78.3407206075,80,8,>1K
963,peace,3710,27195355,78.3514093346,80,5,>1K
964,realize,3709,27199064,78.3620951807,80,7,>1K
965,amazon,3707,27202771,78.3727752646,80,6,>1K
966,board,3701,27206472,78.3834380622,80,5,>1K
967,leaves,3696,27210168,78.3940864545,80,6,>1K
968,cook,3691,27213859,78.4047204415,80,4,>1K
969,kid,3688,27217547,78.4153457854,80,3,>1K
970,immediately,3684,27221231,78.425959605,80,11,>1K
971,modern,3679,27224910,78.4365590193,80,6,>1K
972,projects,3675,27228585,78.4471469094,80,8,>1K
973,clearly,3663,27232248,78.4577002267,80,7,>1K
974,touch,3639,27235887,78.4681843987,80,5,>1K
975,lack,3634,27239521,78.4786541654,80,4,>1K
976,facebook,3632,27243153,78.4891181699,80,8,>1K
977,french,3631,27246784,78.4995792934,80,6,>1K
978,c,3631,27250415,78.5100404169,80,1,>1K
979,reasons,3630,27254045,78.5204986594,80,7,>1K
980,total,3626,27257671,78.5309453776,80,5,>1K
981,writer,3624,27261295,78.5413863337,80,6,>1K
982,p,3624,27264919,78.5518272898,80,1,>1K
983,posts,3623,27268542,78.5622653648,80,5,>1K
984,liked,3621,27272163,78.5726976777,80,5,>1K
985,former,3620,27275783,78.5831271096,80,6,>1K
986,mark,3619,27279402,78.5935536604,80,4,>1K
987,listen,3616,27283018,78.603971568,80,6,>1K
988,loves,3616,27286634,78.6143894756,80,5,>1K
989,training,3614,27290248,78.6248016211,80,8,>1K
990,culture,3613,27293861,78.6352108856,80,7,>1K
991,subject,3611,27297472,78.6456143879,80,7,>1K
992,items,3592,27301064,78.6559631501,80,5,>1K
993,grow,3586,27304650,78.666294626,80,4,>1K
994,stage,3586,27308236,78.6766261018,80,5,>1K
995,computer,3585,27311821,78.6869546967,80,8,>1K
996,joy,3580,27315401,78.6972688862,80,3,>1K
997,allowed,3578,27318979,78.7075773136,80,7,>1K
998,track,3575,27322554,78.7178770978,80,5,>1K
999,yeah,3574,27326128,78.728174001,80,4,>1K
1000,role,3572,27329700,78.738465142,80,4,>1K
1001,wedding,3572,27333272,78.748756283,80,7,>1K
1002,product,3569,27336841,78.7590387809,80,7,>1K
1003,difference,3568,27340409,78.7693183977,80,10,>1K
1004,release,3567,27343976,78.7795951335,80,7,>1K
1005,hell,3562,27347538,78.789857464,80,4,>1K
1006,indeed,3560,27351098,78.8001140323,80,6,>1K
1007,position,3555,27354653,78.8103561953,80,8,>1K
1008,key,3554,27358207,78.8205954773,80,3,>1K
1009,london,3553,27361760,78.8308318783,80,6,>1K
1010,wine,3549,27365309,78.841056755,80,4,>1K
1011,practice,3543,27368852,78.8512643453,80,8,>1K
1012,therefore,3540,27372392,78.8614632925,80,9,>1K
1013,sat,3540,27375932,78.8716622397,80,3,>1K
1014,putting,3538,27379470,78.8818554247,80,7,>1K
1015,picked,3536,27383006,78.8920428477,80,6,>1K
1016,join,3532,27386538,78.9022187464,80,4,>1K
1017,uk,3520,27390058,78.9123600724,80,2,>1K
1018,international,3516,27393574,78.9224898742,80,13,>1K
1019,stopped,3515,27397089,78.9326167949,80,7,>1K
1020,ice,3514,27400603,78.9427408345,80,3,>1K
1021,published,3511,27404114,78.952856231,80,9,>1K
1022,king,3497,27407611,78.9629312927,80,4,>1K
1023,salt,3493,27411104,78.9729948301,80,4,>1K
1024,sad,3489,27414593,78.9830468433,80,3,>1K
1025,afternoon,3487,27418080,78.9930930943,80,9,>1K
1026,died,3486,27421566,79.0031364644,80,4,>1K
1027,de,3485,27425051,79.0131769533,80,2,>1K
1028,realized,3477,27428528,79.0231943938,80,8,>1K
1029,force,3474,27432002,79.0332031911,80,5,>1K
1030,message,3471,27435473,79.0432033453,80,7,>1K
1031,knowledge,3470,27438943,79.0532006183,80,9,>1K
1032,thus,3468,27442411,79.0631921293,80,4,>1K
1033,pink,3463,27445874,79.073169235,80,4,>1K
1034,hospital,3456,27449330,79.0831261732,80,8,>1K
1035,mentioned,3453,27452783,79.0930744683,80,9,>1K
1036,knowing,3451,27456234,79.1030170013,80,7,>1K
1037,ahead,3451,27459685,79.1129595342,80,5,>1K
1038,mention,3451,27463136,79.1229020672,80,7,>1K
1039,st,3447,27466583,79.1328330759,80,2,>1K
1040,fair,3440,27470023,79.1427439173,80,4,>1K
1041,ourselves,3437,27473460,79.1526461154,80,9,>1K
1042,popular,3435,27476895,79.1625425514,80,7,>1K
1043,press,3434,27480329,79.1724361064,80,5,>1K
1044,asking,3431,27483760,79.1823210182,80,6,>1K
1045,healthy,3430,27487190,79.1922030489,80,7,>1K
1046,brain,3423,27490613,79.2020649123,80,5,>1K
1047,images,3416,27494029,79.2119066082,80,6,>1K
1048,serious,3415,27497444,79.221745423,80,7,>1K
1049,value,3415,27500859,79.2315842379,80,5,>1K
1050,slightly,3414,27504273,79.2414201717,80,8,>1K
1051,particularly,3414,27507687,79.2512561055,80,12,>1K
1052,field,3410,27511097,79.2610805151,80,5,>1K
1053,goal,3410,27514507,79.2709049246,80,4,>1K
1054,journey,3409,27517916,79.2807264531,80,7,>1K
1055,west,3407,27521323,79.2905422195,80,4,>1K
1056,terms,3407,27524730,79.3003579859,80,5,>1K
1057,star,3404,27528134,79.3101651091,80,4,>1K
1058,straight,3403,27531537,79.3199693513,80,8,>1K
1059,finding,3398,27534935,79.3297591882,80,7,>1K
1060,british,3397,27538332,79.339546144,80,7,>1K
1061,tea,3394,27541726,79.3493244566,80,3,>1K
1062,parts,3394,27545120,79.3591027692,80,5,>1K
1063,ran,3390,27548510,79.3688695576,80,3,>1K
1064,david,3386,27551896,79.3786248218,80,5,>1K
1065,previous,3385,27555281,79.3883772049,80,8,>1K
1066,ability,3381,27558662,79.3981180638,80,7,>1K
1067,camera,3377,27562039,79.4078473984,80,6,>1K
1068,serve,3368,27565407,79.4175508035,80,5,>1K
1069,regular,3367,27568774,79.4272513276,80,7,>1K
1070,lived,3365,27572139,79.4369460895,80,5,>1K
1071,lucky,3360,27575499,79.4466264461,80,5,>1K
1072,tells,3360,27578859,79.4563068028,80,5,>1K
1073,currently,3360,27582219,79.4659871594,80,9,>1K
1074,development,3347,27585566,79.4756300623,80,11,>1K
1075,miles,3346,27588912,79.4852700841,80,5,>1K
1076,clothes,3339,27592251,79.4948899385,80,7,>1K
1077,pages,3339,27595590,79.5045097929,80,5,>1K
1078,effect,3338,27598928,79.5141267663,80,6,>1K
1079,test,3335,27602263,79.5237350965,80,4,>1K
1080,soul,3335,27605598,79.5333434266,80,4,>1K
1081,rules,3333,27608931,79.5429459947,80,5,>1K
1082,period,3333,27612264,79.5525485628,80,6,>1K
1083,songs,3327,27615591,79.5621338445,80,5,>1K
1084,keeping,3323,27618914,79.5717076019,80,7,>1K
1085,safe,3312,27622226,79.5812496678,80,4,>1K
1086,fan,3299,27625525,79.5907542798,80,3,>1K
1087,older,3292,27628817,79.6002387245,80,5,>1K
1088,herself,3278,27632095,79.6096828344,80,7,>1K
1089,turns,3276,27635371,79.6191211821,80,5,>1K
1090,dr,3273,27638644,79.6285508866,80,2,>1K
1091,planning,3265,27641909,79.6379575427,80,8,>1K
1092,somewhere,3265,27645174,79.6473641988,80,9,>1K
1093,bill,3263,27648437,79.6567650927,80,4,>1K
1094,milk,3255,27651692,79.6661429382,80,4,>1K
1095,paid,3245,27654937,79.6754919732,80,4,>1K
1096,whenever,3242,27658179,79.6848323649,80,8,>1K
1097,unfortunately,3238,27661417,79.6941612324,80,13,>1K
1098,plans,3236,27664653,79.7034843378,80,5,>1K
1099,beauty,3233,27667886,79.7127988,80,6,>1K
1100,shopping,3229,27671115,79.722101738,80,8,>1K
1101,none,3224,27674339,79.7313902706,80,4,>1K
1102,results,3222,27677561,79.7406730412,80,7,>1K
1103,lady,3218,27680779,79.7499442875,80,4,>1K
1104,followed,3218,27683997,79.7592155339,80,8,>1K
1105,bread,3217,27687214,79.7684838991,80,5,>1K
1106,paint,3212,27690426,79.7777378591,80,5,>1K
1107,dance,3210,27693636,79.786986057,80,5,>1K
1108,secret,3210,27696846,79.7962342548,80,6,>1K
1109,smile,3209,27700055,79.8054795716,80,5,>1K
1110,tonight,3201,27703256,79.81470184,80,7,>1K
1111,lose,3198,27706454,79.8239154651,80,4,>1K
1112,caught,3196,27709650,79.8331233282,80,6,>1K
1113,helped,3187,27712837,79.8423052617,80,6,>1K
1114,industry,3187,27716024,79.8514871952,80,8,>1K
1115,easier,3184,27719208,79.8606604855,80,6,>1K
1116,worse,3181,27722389,79.8698251327,80,5,>1K
1117,shoes,3180,27725569,79.8789868988,80,5,>1K
1118,christian,3177,27728746,79.8881400217,80,9,>1K
1119,science,3174,27731920,79.8972845015,80,7,>1K
1120,club,3173,27735093,79.9064261002,80,4,>1K
1121,nor,3170,27738263,79.9155590557,80,3,>1K
1122,gold,3166,27741429,79.924680487,80,4,>1K
1123,member,3164,27744593,79.9337961562,80,6,>1K
1124,content,3163,27747756,79.9429089443,80,7,>1K
1125,colors,3153,27750909,79.9519929218,80,6,>1K
1126,lines,3141,27754050,79.9610423266,80,5,>1K
1127,notice,3135,27757185,79.9700744451,80,6,>1K
1128,tiny,3132,27760317,79.9790979204,80,4,>1K
1129,b,3128,27763445,79.9881098715,80,1,>1K
1130,doubt,3119,27766564,79.997095893,90,5,>1K
1131,wearing,3115,27769679,80.0060703903,90,7,>1K
1132,movies,3112,27772791,80.0150362444,90,6,>1K
1133,rich,3112,27775903,80.0240020986,90,4,>1K
1134,moments,3104,27779007,80.0329449042,90,7,>1K
1135,higher,3100,27782107,80.0418761856,90,6,>1K
1136,hoping,3095,27785202,80.0507930618,90,6,>1K
1137,obviously,3093,27788295,80.0597041758,90,9,>1K
1138,posted,3079,27791374,80.068574955,90,6,>1K
1139,career,3077,27794451,80.0774399721,90,6,>1K
1140,build,3075,27797526,80.086299227,90,5,>1K
1141,pan,3068,27800594,80.0951383146,90,3,>1K
1142,physical,3068,27803662,80.1039774021,90,8,>1K
1143,managed,3067,27806729,80.1128136086,90,7,>1K
1144,areas,3066,27809795,80.1216469341,90,5,>1K
1145,teacher,3065,27812860,80.1304773784,90,7,>1K
1146,noticed,3061,27815921,80.1392962986,90,7,>1K
1147,considered,3061,27818982,80.1481152187,90,10,>1K
1148,section,3059,27822041,80.1569283767,90,7,>1K
1149,theme,3058,27825099,80.1657386537,90,5,>1K
1150,window,3053,27828152,80.1745345254,90,6,>1K
1151,watched,3052,27831204,80.183327516,90,7,>1K
1152,somehow,3052,27834256,80.1921205066,90,7,>1K
1153,travel,3051,27837307,80.2009106162,90,6,>1K
1154,blogs,3050,27840357,80.2096978447,90,5,>1K
1155,reach,3046,27843403,80.2184735489,90,5,>1K
1156,spot,3041,27846444,80.2272348479,90,4,>1K
1157,security,3039,27849483,80.2359903848,90,8,>1K
1158,rain,3039,27852522,80.2447459216,90,4,>1K
1159,corner,3036,27855558,80.2534928153,90,6,>1K
1160,n,3034,27858592,80.2622339468,90,1,>1K
1161,arrived,3029,27861621,80.2709606731,90,7,>1K
1162,unique,3023,27864644,80.279670113,90,6,>1K
1163,positive,3022,27867666,80.2883766719,90,8,>1K
1164,led,3016,27870682,80.2970659444,90,3,>1K
1165,expected,3016,27873698,80.3057552169,90,8,>1K
1166,starts,3015,27876713,80.3144416084,90,6,>1K
1167,effort,3015,27879728,80.3231279998,90,6,>1K
1168,term,3008,27882736,80.3317942239,90,4,>1K
1169,becomes,3003,27885739,80.3404460426,90,7,>1K
1170,3000,3000,27888739,80.3490892182,90,4,>1K
1171,evidence,2998,27891737,80.3577266316,90,8,>1K
1172,private,2995,27894732,80.3663554019,90,7,>1K
1173,heavy,2995,27897727,80.3749841722,90,5,>1K
1174,unless,2994,27900721,80.3836100614,90,6,>1K
1175,released,2994,27903715,80.3922359506,90,8,>1K
1176,soft,2992,27906707,80.4008560777,90,4,>1K
1177,sauce,2990,27909697,80.4094704427,90,5,>1K
1178,groups,2988,27912685,80.4180790456,90,6,>1K
1179,holiday,2985,27915670,80.4266790053,90,7,>1K
1180,individual,2983,27918653,80.4352732029,90,10,>1K
1181,necessary,2979,27921632,80.4438558762,90,9,>1K
1182,conversation,2979,27924611,80.4524385495,90,12,>1K
1183,whom,2977,27927588,80.4610154608,90,4,>1K
1184,addition,2974,27930562,80.4695837288,90,8,>1K
1185,actual,2971,27933533,80.4781433537,90,6,>1K
1186,cooking,2970,27936503,80.4867000975,90,7,>1K
1187,traditional,2967,27939470,80.4952481981,90,11,>1K
1188,j,2964,27942434,80.5037876556,90,1,>1K
1189,basic,2963,27945397,80.512324232,90,5,>1K
1190,freedom,2960,27948357,80.5208521653,90,7,>1K
1191,covered,2960,27951317,80.5293800985,90,7,>1K
1192,o,2959,27954276,80.5379051507,90,1,>1K
1193,included,2949,27957225,80.5464013922,90,8,>1K
1194,search,2946,27960171,80.5548889907,90,6,>1K
1195,hopefully,2943,27963114,80.5633679459,90,9,>1K
1196,understanding,2940,27966054,80.571838258,90,13,>1K
1197,tired,2939,27968993,80.580305689,90,5,>1K
1198,opened,2934,27971927,80.5887587147,90,6,>1K
1199,slowly,2933,27974860,80.5972088593,90,6,>1K
1200,ride,2932,27977792,80.6056561229,90,4,>1K
1201,contact,2932,27980724,80.6141033865,90,7,>1K
1202,path,2931,27983655,80.622547769,90,4,>1K
1203,letter,2928,27986583,80.6309835084,90,6,>1K
1204,student,2921,27989504,80.6393990803,90,7,>1K
1205,welcome,2920,27992424,80.6478117712,90,7,>1K
1206,creating,2918,27995342,80.6562187,90,8,>1K
1207,built,2915,27998257,80.6646169856,90,5,>1K
1208,named,2910,28001167,80.6730008659,90,5,>1K
1209,purpose,2910,28004077,80.6813847462,90,7,>1K
1210,married,2909,28006986,80.6897657455,90,7,>1K
1211,speaking,2907,28009893,80.6981409826,90,8,>1K
1212,inspired,2905,28012798,80.7065104576,90,8,>1K
1213,opinion,2899,28015697,80.7148626463,90,7,>1K
1214,craft,2893,28018590,80.7231975486,90,5,>1K
1215,meaning,2891,28021481,80.7315266888,90,7,>1K
1216,train,2889,28024370,80.7398500668,90,5,>1K
1217,talent,2882,28027252,80.7481532775,90,6,>1K
1218,usual,2882,28030134,80.7564564882,90,5,>1K
1219,forever,2879,28033013,80.7647510557,90,7,>1K
1220,worry,2877,28035890,80.773039861,90,5,>1K
1221,possibly,2876,28038766,80.7813257853,90,8,>1K
1222,potential,2874,28041640,80.7896059475,90,9,>1K
1223,surprise,2872,28044512,80.7978803476,90,8,>1K
1224,loss,2870,28047382,80.8061489856,90,4,>1K
1225,companies,2865,28050247,80.8144032183,90,9,>1K
1226,admit,2865,28053112,80.8226574509,90,5,>1K
1227,holy,2865,28055977,80.8309116836,90,4,>1K
1228,fans,2860,28058837,80.839151511,90,4,>1K
1229,snow,2857,28061694,80.8473826952,90,4,>1K
1230,fashion,2857,28064551,80.8556138794,90,7,>1K
1231,pull,2856,28067407,80.8638421825,90,4,>1K
1232,decide,2856,28070263,80.8720704857,90,6,>1K
1233,hurt,2852,28073115,80.8802872646,90,4,>1K
1234,opening,2851,28075966,80.8885011624,90,7,>1K
1235,beat,2849,28078815,80.8967092982,90,4,>1K
1236,bright,2848,28081663,80.9049145528,90,6,>1K
1237,enter,2847,28084510,80.9131169265,90,5,>1K
1238,century,2839,28087349,80.9212962516,90,7,>1K
1239,hotel,2839,28090188,80.9294755768,90,5,>1K
1240,fell,2834,28093022,80.9376404966,90,4,>1K
1241,catch,2834,28095856,80.9458054165,90,5,>1K
1242,fish,2831,28098687,80.9539616932,90,4,>1K
1243,basically,2830,28101517,80.9621150888,90,9,>1K
1244,evil,2827,28104344,80.9702598412,90,4,>1K
1245,base,2827,28107171,80.9784045937,90,4,>1K
1246,writers,2824,28109995,80.9865407029,90,7,>1K
1247,holding,2821,28112816,80.994668169,90,7,>1K
1248,movement,2818,28115634,81.002786992,90,8,>1K
1249,james,2816,28118450,81.0109000528,90,5,>1K
1250,marriage,2813,28121263,81.0190044704,90,8,>1K
1251,strange,2812,28124075,81.027106007,90,7,>1K
1252,dear,2809,28126884,81.0351989004,90,4,>1K
1253,aside,2808,28129692,81.0432889127,90,5,>1K
1254,response,2807,28132499,81.051376044,90,8,>1K
1255,delicious,2806,28135305,81.0594602942,90,9,>1K
1256,countries,2800,28138105,81.0675272581,90,9,>1K
1257,winner,2800,28140905,81.0755942219,90,6,>1K
1258,range,2798,28143703,81.0836554237,90,5,>1K
1259,baking,2793,28146496,81.0917022201,90,6,>1K
1260,attempt,2792,28149288,81.0997461355,90,7,>1K
1261,ingredients,2789,28152077,81.1077814078,90,11,>1K
1262,memory,2788,28154865,81.1158137989,90,6,>1K
1263,pop,2785,28157650,81.1238375469,90,3,>1K
1264,explain,2785,28160435,81.1318612949,90,7,>1K
1265,fully,2785,28163220,81.1398850429,90,5,>1K
1266,river,2784,28166004,81.1479059098,90,5,>1K
1267,background,2783,28168787,81.1559238957,90,10,>1K
1268,suddenly,2783,28171570,81.1639418816,90,8,>1K
1269,receive,2780,28174350,81.1719512243,90,7,>1K
1270,sell,2774,28177124,81.1799432806,90,4,>1K
1271,glad,2774,28179898,81.1879353369,90,4,>1K
1272,families,2774,28182672,81.1959273933,90,8,>1K
1273,birth,2773,28185445,81.2039165686,90,5,>1K
1274,sick,2773,28188218,81.2119057439,90,4,>1K
1275,jobs,2772,28190990,81.2198920381,90,4,>1K
1276,fabric,2771,28193761,81.2278754513,90,6,>1K
1277,skills,2771,28196532,81.2358588644,90,6,>1K
1278,sea,2770,28199302,81.2438393965,90,3,>1K
1279,kill,2770,28202072,81.2518199287,90,4,>1K
1280,beach,2769,28204841,81.2597975797,90,5,>1K
1281,audience,2767,28207608,81.2677694686,90,8,>1K
1282,honest,2766,28210374,81.2757384765,90,6,>1K
1283,stamp,2762,28213136,81.2836959602,90,5,>1K
1284,becoming,2762,28215898,81.2916534438,90,8,>1K
1285,nation,2761,28218659,81.2996080464,90,6,>1K
1286,department,2755,28221414,81.3075453626,90,10,>1K
1287,broken,2755,28224169,81.3154826789,90,6,>1K
1288,sale,2753,28226922,81.323414233,90,4,>1K
1289,slow,2753,28229675,81.3313457871,90,4,>1K
1290,roll,2747,28232422,81.3392600549,90,4,>1K
1291,apart,2746,28235168,81.3471714416,90,5,>1K
1292,calls,2746,28237914,81.3550828283,90,5,>1K
1293,plenty,2746,28240660,81.362994215,90,6,>1K
1294,approach,2738,28243398,81.3708825532,90,8,>1K
1295,fruit,2738,28246136,81.3787708915,90,5,>1K
1296,pulled,2736,28248872,81.3866534676,90,6,>1K
1297,staff,2734,28251606,81.3945302816,90,5,>1K
1298,numbers,2733,28254339,81.4024042145,90,7,>1K
1299,highly,2733,28257072,81.4102781475,90,6,>1K
1300,economic,2726,28259798,81.418131913,90,8,>1K
1301,mouth,2725,28262523,81.4259827975,90,5,>1K
1302,names,2723,28265246,81.4338279198,90,5,>1K
1303,discovered,2717,28267963,81.4416557559,90,10,>1K
1304,cross,2716,28270679,81.4494807108,90,5,>1K
1305,oven,2716,28273395,81.4573056658,90,4,>1K
1306,driving,2715,28276110,81.4651277397,90,7,>1K
1307,attack,2705,28278815,81.472921003,90,6,>1K
1308,continued,2705,28281520,81.4807142663,90,9,>1K
1309,trees,2700,28284220,81.4884931243,90,5,>1K
1310,showed,2700,28286920,81.4962719823,90,6,>1K
1311,notes,2695,28289615,81.504036435,90,5,>1K
1312,blogging,2693,28292308,81.5117951256,90,8,>1K
1313,anymore,2691,28294999,81.5195480541,90,7,>1K
1314,account,2688,28297687,81.5272923394,90,7,>1K
1315,extremely,2686,28300373,81.5350308626,90,9,>1K
1316,reader,2685,28303058,81.5427665048,90,6,>1K
1317,quiet,2685,28305743,81.5505021469,90,5,>1K
1318,east,2681,28308424,81.5582262648,90,4,>1K
1319,island,2681,28311105,81.5659503827,90,6,>1K
1320,performance,2678,28313783,81.5736658574,90,11,>1K
1321,stick,2678,28316461,81.5813813322,90,5,>1K
1322,arms,2675,28319136,81.5890881637,90,4,>1K
1323,double,2674,28321810,81.5967921142,90,6,>1K
1324,surprised,2669,28324479,81.6044816594,90,9,>1K
1325,grace,2669,28327148,81.6121712046,90,5,>1K
1326,toward,2666,28329814,81.6198521066,90,6,>1K
1327,source,2664,28332478,81.6275272465,90,6,>1K
1328,latest,2663,28335141,81.6351995054,90,6,>1K
1329,throw,2654,28337795,81.6428458347,90,5,>1K
1330,otherwise,2654,28340449,81.650492164,90,9,>1K
1331,desire,2653,28343102,81.6581356123,90,6,>1K
1332,setting,2650,28345752,81.6657704174,90,7,>1K
1333,inspiration,2646,28348398,81.6733936982,90,11,>1K
1334,financial,2643,28351041,81.6810083359,90,9,>1K
1335,property,2643,28353684,81.6886229736,90,8,>1K
1336,thursday,2643,28356327,81.6962376113,90,8,>1K
1337,specific,2642,28358969,81.7038493679,90,8,>1K
1338,proud,2637,28361606,81.7114467192,90,5,>1K
1339,spending,2636,28364242,81.7190411895,90,8,>1K
1340,aware,2634,28366876,81.7266298976,90,5,>1K
1341,restaurant,2632,28369508,81.7342128437,90,10,>1K
1342,pattern,2632,28372140,81.7417957897,90,7,>1K
1343,shape,2630,28374770,81.7493729736,90,5,>1K
1344,dreams,2629,28377399,81.7569472765,90,6,>1K
1345,access,2624,28380023,81.7645071741,90,6,>1K
1346,films,2623,28382646,81.7720641906,90,5,>1K
1347,successful,2620,28385266,81.7796125639,90,10,>1K
1348,claim,2619,28387885,81.7871580562,90,5,>1K
1349,respect,2615,28390500,81.7946920242,90,7,>1K
1350,calling,2614,28393114,81.8022231112,90,7,>1K
1351,willing,2612,28395726,81.8097484361,90,7,>1K
1352,spread,2602,28398328,81.8172449503,90,6,>1K
1353,director,2600,28400928,81.8247357025,90,8,>1K
1354,sharing,2599,28403527,81.8322235736,90,7,>1K
1355,technology,2599,28406126,81.8397114447,90,10,>1K
1356,avoid,2595,28408721,81.8471877916,90,5,>1K
1357,michael,2593,28411314,81.8546583763,90,7,>1K
1358,brand,2590,28413904,81.8621203179,90,5,>1K
1359,lately,2589,28416493,81.8695793784,90,6,>1K
1360,copy,2588,28419081,81.8770355579,90,4,>1K
1361,lol,2585,28421666,81.8844830942,90,3,>1K
1362,bible,2585,28424251,81.8919306304,90,5,>1K
1363,sold,2581,28426832,81.8993666425,90,4,>1K
1364,text,2581,28429413,81.9068026545,90,4,>1K
1365,advice,2579,28431992,81.9142329045,90,6,>1K
1366,meal,2578,28434570,81.9216602734,90,4,>1K
1367,killed,2577,28437147,81.9290847612,90,6,>1K
1368,machine,2575,28439722,81.9365034869,90,7,>1K
1369,bottle,2575,28442297,81.9439222126,90,6,>1K
1370,ball,2574,28444871,81.9513380572,90,4,>1K
1371,showing,2572,28447443,81.9587481397,90,7,>1K
1372,stuck,2572,28450015,81.9661582223,90,5,>1K
1373,fiction,2571,28452586,81.9735654237,90,7,>1K
1374,talked,2569,28455155,81.9809668631,90,6,>1K
1375,lower,2568,28457723,81.9883654214,90,5,>1K
1376,military,2563,28460286,81.9957495744,90,8,>1K
1377,trouble,2563,28462849,82.0031337274,90,7,>1K
1378,january,2560,28465409,82.0105092372,90,7,>1K
1379,missed,2555,28467964,82.0178703417,90,6,>1K
1380,hadn,2555,28470519,82.0252314462,90,4,>1K
1381,provided,2553,28473072,82.0325867886,90,8,>1K
1382,fantastic,2552,28475624,82.03993925,90,9,>1K
1383,feelings,2551,28478175,82.0472888303,90,8,>1K
1384,wind,2550,28480725,82.0546355295,90,4,>1K
1385,carry,2547,28483272,82.0619735856,90,5,>1K
1386,x,2543,28485815,82.0693001174,90,1,>1K
1387,generally,2542,28488357,82.0766237682,90,9,>1K
1388,prepared,2539,28490896,82.0839387758,90,8,>1K
1389,wild,2539,28493435,82.0912537834,90,4,>1K
1390,yellow,2539,28495974,82.098568791,90,6,>1K
1391,required,2538,28498512,82.1058809175,90,8,>1K
1392,tuesday,2537,28501049,82.113190163,90,7,>1K
1393,wednesday,2537,28503586,82.1204994084,90,9,>1K
1394,breakfast,2533,28506119,82.1277971297,90,9,>1K
1395,accept,2533,28508652,82.1350948509,90,6,>1K
1396,plot,2531,28511183,82.1423868101,90,4,>1K
1397,helps,2530,28513713,82.1496758881,90,5,>1K
1398,offered,2528,28516241,82.1569592041,90,7,>1K
1399,overall,2527,28518768,82.164239639,90,7,>1K
1400,seven,2526,28521294,82.1715171928,90,5,>1K
1401,eggs,2526,28523820,82.1787947466,90,4,>1K
1402,teaching,2525,28526345,82.1860694194,90,8,>1K
1403,powerful,2524,28528869,82.1933412111,90,8,>1K
1404,shared,2523,28531392,82.2006101218,90,6,>1K
1405,ends,2522,28533914,82.2078761514,90,4,>1K
1406,missing,2516,28536430,82.2151248946,90,7,>1K
1407,wide,2515,28538945,82.2223707568,90,4,>1K
1408,obvious,2512,28541457,82.2296079758,90,7,>1K
1409,random,2510,28543967,82.2368394327,90,6,>1K
1410,medium,2509,28546476,82.2440680085,90,6,>1K
1411,drop,2507,28548983,82.2512908223,90,4,>1K
1412,excellent,2507,28551490,82.258513636,90,9,>1K
1413,battle,2505,28553995,82.2657306876,90,6,>1K
1414,chose,2504,28556499,82.2729448581,90,5,>1K
1415,click,2503,28559002,82.2801561476,90,5,>1K
1416,remove,2502,28561504,82.287364556,90,6,>1K
1417,meat,2502,28564006,82.2945729645,90,4,>1K
1418,rate,2501,28566507,82.3017784918,90,4,>1K
1419,bank,2501,28569008,82.3089840192,90,4,>1K
1420,fill,2499,28571507,82.3161837845,90,4,>1K
1421,library,2498,28574005,82.3233806686,90,7,>1K
1422,favourite,2496,28576501,82.3305717907,90,9,>1K
1423,strength,2493,28578994,82.3377542696,90,8,>1K
1424,pair,2488,28581482,82.3449223432,90,4,>1K
1425,exciting,2488,28583970,82.3520904168,90,8,>1K
1426,beers,2486,28586456,82.3592527283,90,5,>1K
1427,artist,2485,28588941,82.3664121588,90,6,>1K
1428,cases,2484,28591425,82.3735687081,90,5,>1K
1429,material,2484,28593909,82.3807252575,90,8,>1K
1430,mixture,2483,28596392,82.3878789258,90,7,>1K
1431,limited,2483,28598875,82.3950325941,90,7,>1K
1432,crime,2481,28601356,82.4021805003,90,5,>1K
1433,radio,2475,28603831,82.4093111202,90,5,>1K
1434,happening,2475,28606306,82.41644174,90,9,>1K
1435,variety,2474,28608780,82.4235694788,90,7,>1K
1436,campaign,2473,28611253,82.4306943365,90,8,>1K
1437,folks,2472,28613725,82.4378163132,90,5,>1K
1438,risk,2465,28616190,82.4449181225,90,4,>1K
1439,tour,2462,28618652,82.4520112886,90,4,>1K
1440,exercise,2461,28621113,82.4591015736,90,8,>1K
1441,famous,2458,28623571,82.4661832154,90,6,>1K
1442,june,2457,28626028,82.4732619762,90,4,>1K
1443,fat,2456,28628484,82.480337856,90,3,>1K
1444,weren,2453,28630937,82.4874050925,90,5,>1K
1445,station,2453,28633390,82.4944723291,90,7,>1K
1446,magic,2453,28635843,82.5015395656,90,5,>1K
1447,memories,2448,28638291,82.5085923969,90,8,>1K
1448,listening,2445,28640736,82.515636585,90,9,>1K
1449,data,2442,28643178,82.5226721299,90,4,>1K
1450,designed,2441,28645619,82.5297047938,90,8,>1K
1451,colour,2438,28648057,82.5367288145,90,6,>1K
1452,turning,2436,28650493,82.543747073,90,7,>1K
1453,appears,2434,28652927,82.5507595695,90,7,>1K
1454,served,2431,28655358,82.5577634227,90,6,>1K
1455,afraid,2430,28657788,82.564764395,90,6,>1K
1456,item,2430,28660218,82.5717653672,90,4,>1K
1457,drinking,2429,28662647,82.5787634583,90,8,>1K
1458,sky,2427,28665074,82.5857557874,90,3,>1K
1459,justice,2425,28667499,82.5927423543,90,7,>1K
1460,hey,2425,28669924,82.5997289212,90,3,>1K
1461,trade,2424,28672348,82.6067126071,90,5,>1K
1462,loving,2423,28674771,82.6136934119,90,6,>1K
1463,edge,2421,28677192,82.6206684546,90,4,>1K
1464,brings,2418,28679610,82.6276348541,90,6,>1K
1465,players,2418,28682028,82.6346012536,90,7,>1K
1466,draw,2417,28684445,82.641564772,90,4,>1K
1467,legal,2413,28686858,82.6485167662,90,5,>1K
1468,headed,2412,28689270,82.6554658794,90,6,>1K
1469,biggest,2410,28691680,82.6624092305,90,7,>1K
1470,africa,2410,28694090,82.6693525815,90,6,>1K
1471,dish,2404,28696494,82.6762786462,90,4,>1K
1472,professional,2402,28698896,82.6831989488,90,12,>1K
1473,match,2401,28701297,82.6901163703,90,5,>1K
1474,schools,2401,28703698,82.6970337918,90,7,>1K
1475,perfectly,2400,28706098,82.7039483322,90,9,>1K
1476,literally,2399,28708497,82.7108599916,90,9,>1K
1477,appear,2398,28710895,82.71776877,90,6,>1K
1478,dogs,2398,28713293,82.7246775483,90,4,>1K
1479,direction,2397,28715690,82.7315834456,90,9,>1K
1480,agree,2393,28718083,82.7384778187,90,5,>1K
1481,animals,2391,28720474,82.7453664296,90,7,>1K
1482,la,2385,28722859,82.7522377542,90,2,>1K
1483,gotten,2384,28725243,82.7591061977,90,6,>1K
1484,papers,2384,28727627,82.7659746412,90,6,>1K
1485,policy,2382,28730009,82.7728373226,90,6,>1K
1486,teach,2379,28732388,82.7796913608,90,5,>1K
1487,directly,2378,28734766,82.786542518,90,8,>1K
1488,pray,2378,28737144,82.7933936752,90,4,>1K
1489,via,2376,28739520,82.8002390702,90,3,>1K
1490,heaven,2369,28741889,82.8070642979,90,6,>1K
1491,buying,2366,28744255,82.8138808823,90,6,>1K
1492,spiritual,2365,28746620,82.8206945858,90,9,>1K
1493,tend,2364,28748984,82.8275054081,90,4,>1K
1494,model,2361,28751345,82.8343075873,90,5,>1K
1495,forced,2360,28753705,82.8411068854,90,6,>1K
1496,sales,2358,28756063,82.8479004214,90,5,>1K
1497,laugh,2357,28758420,82.8546910763,90,5,>1K
1498,address,2357,28760777,82.8614817313,90,7,>1K
1499,closer,2355,28763132,82.8682666241,90,6,>1K
1500,planned,2355,28765487,82.8750515169,90,7,>1K
1501,magazine,2354,28767841,82.8818335287,90,8,>1K
1502,taught,2353,28770194,82.8886126594,90,6,>1K
1503,weird,2352,28772546,82.895388909,90,5,>1K
1504,bunch,2351,28774897,82.9021622776,90,5,>1K
1505,egg,2348,28777245,82.9089270031,90,3,>1K
1506,adding,2348,28779593,82.9156917285,90,6,>1K
1507,female,2345,28781938,82.9224478107,90,6,>1K
1508,golden,2344,28784282,82.9292010119,90,6,>1K
1509,rule,2344,28786626,82.9359542131,90,4,>1K
1510,central,2340,28788966,82.94269589,90,7,>1K
1511,bigger,2340,28791306,82.949437567,90,6,>1K
1512,flour,2340,28793646,82.9561792439,90,5,>1K
1513,hearing,2339,28795985,82.9629180398,90,7,>1K
1514,authors,2338,28798323,82.9696539546,90,7,>1K
1515,medical,2335,28800658,82.9763812263,90,7,>1K
1516,experiences,2334,28802992,82.9831056169,90,11,>1K
1517,china,2332,28805324,82.9898242453,90,5,>1K
1518,cat,2332,28807656,82.9965428738,90,3,>1K
1519,jack,2329,28809985,83.0032528591,90,4,>1K
1520,award,2327,28812312,83.0099570823,90,5,>1K
1521,neither,2327,28814639,83.0166613055,90,7,>1K
1522,digital,2318,28816957,83.0233395992,90,7,>1K
1523,helping,2318,28819275,83.0300178928,90,7,>1K
1524,leading,2313,28821588,83.0366817812,90,7,>1K
1525,peter,2312,28823900,83.0433427885,90,5,>1K
1526,conference,2311,28826211,83.0500009147,90,10,>1K
1527,worst,2309,28828520,83.0566532789,90,5,>1K
1528,average,2301,28830821,83.0632825945,90,7,>1K
1529,credit,2300,28833121,83.0699090291,90,6,>1K
1530,increase,2299,28835420,83.0765325827,90,8,>1K
1531,stood,2297,28837717,83.0831503741,90,5,>1K
1532,flower,2293,28840010,83.0897566413,90,6,>1K
1533,screen,2292,28842302,83.0963600274,90,6,>1K
1534,promise,2292,28844594,83.1029634136,90,7,>1K
1535,fairly,2288,28846882,83.1095552755,90,6,>1K
1536,tears,2288,28849170,83.1161471374,90,5,>1K
1537,statement,2288,28851458,83.1227389993,90,9,>1K
1538,religious,2287,28853745,83.1293279801,90,9,>1K
1539,changing,2286,28856031,83.1359140799,90,8,>1K
1540,speed,2283,28858314,83.1424915365,90,5,>1K
1541,grand,2282,28860596,83.1490661121,90,5,>1K
1542,percent,2282,28862878,83.1556406876,90,7,>1K
1543,hop,2278,28865156,83.162203739,90,3,>1K
1544,episode,2276,28867432,83.1687610282,90,7,>1K
1545,placed,2276,28869708,83.1753183174,90,6,>1K
1546,december,2276,28871984,83.1818756066,90,8,>1K
1547,raised,2271,28874255,83.1884184905,90,6,>1K
1548,remain,2270,28876525,83.1949584933,90,6,>1K
1549,activities,2268,28878793,83.201492734,90,10,>1K
1550,tax,2267,28881060,83.2080240937,90,3,>1K
1551,sides,2263,28883323,83.2145439292,90,5,>1K
1552,moon,2263,28885586,83.2210637646,90,4,>1K
1553,interview,2260,28887846,83.2275749569,90,9,>1K
1554,print,2260,28890106,83.2340861491,90,5,>1K
1555,workers,2260,28892366,83.2405973414,90,7,>1K
1556,bus,2258,28894624,83.2471027715,90,3,>1K
1557,cast,2258,28896882,83.2536082017,90,4,>1K
1558,adult,2256,28899138,83.2601078697,90,5,>1K
1559,stock,2256,28901394,83.2666075377,90,5,>1K
1560,fellow,2254,28903648,83.2731014437,90,6,>1K
1561,chicago,2253,28905901,83.2795924685,90,7,>1K
1562,entirely,2252,28908153,83.2860806123,90,8,>1K
1563,california,2252,28910405,83.2925687561,90,10,>1K
1564,gorgeous,2250,28912655,83.2990511378,90,8,>1K
1565,apple,2244,28914899,83.3055162331,90,5,>1K
1566,fabulous,2242,28917141,83.3119755663,90,8,>1K
1567,orange,2241,28919382,83.3184320185,90,6,>1K
1568,honestly,2240,28921622,83.3248855896,90,8,>1K
1569,foot,2239,28923861,83.3313362796,90,4,>1K
1570,israel,2238,28926099,83.3377840886,90,6,>1K
1571,count,2235,28928334,83.3442232544,90,5,>1K
1572,judge,2232,28930566,83.350653777,90,5,>1K
1573,greater,2232,28932798,83.3570842996,90,7,>1K
1574,stamps,2231,28935029,83.3635119412,90,6,>1K
1575,push,2230,28937259,83.3699367017,90,4,>1K
1576,growth,2225,28939484,83.3763470569,90,6,>1K
1577,square,2224,28941708,83.3827545311,90,6,>1K
1578,production,2219,28943927,83.3891475999,90,10,>1K
1579,larger,2217,28946144,83.3955349067,90,6,>1K
1580,painting,2213,28948357,83.4019106892,90,8,>1K
1581,comfortable,2213,28950570,83.4082864717,90,11,>1K
1582,february,2212,28952782,83.4146593732,90,8,>1K
1583,familiar,2211,28954993,83.4210293936,90,8,>1K
1584,twitter,2210,28957203,83.4273965329,90,7,>1K
1585,foreign,2204,28959407,83.4337463859,90,7,>1K
1586,television,2203,28961610,83.4400933578,90,10,>1K
1587,bear,2199,28963809,83.4464288055,90,4,>1K
1588,purchase,2198,28966007,83.4527613722,90,8,>1K
1589,rice,2198,28968205,83.4590939388,90,4,>1K
1590,includes,2197,28970402,83.4654236244,90,8,>1K
1591,festival,2197,28972599,83.4717533099,90,8,>1K
1592,global,2196,28974795,83.4780801145,90,6,>1K
1593,environment,2196,28976991,83.484406919,90,11,>1K
1594,europe,2195,28979186,83.4907308424,90,6,>1K
1595,r,2194,28981380,83.4970518848,90,1,>1K
1596,challenges,2194,28983574,83.5033729272,90,10,>1K
1597,chinese,2191,28985765,83.5096853265,90,7,>1K
1598,related,2188,28987953,83.5159890825,90,7,>1K
1599,balance,2188,28990141,83.5222928386,90,7,>1K
1600,standard,2186,28992327,83.5285908325,90,8,>1K
1601,bake,2183,28994510,83.5348801833,90,4,>1K
1602,steps,2182,28996692,83.541166653,90,5,>1K
1603,george,2180,28998872,83.5474473605,90,6,>1K
1604,luck,2178,29001050,83.553722306,90,4,>1K
1605,stupid,2177,29003227,83.5599943704,90,6,>1K
1606,pressure,2176,29005403,83.5662635538,90,8,>1K
1607,july,2173,29007576,83.5725240939,90,4,>1K
1608,leaders,2167,29009743,83.5787673478,90,7,>1K
1609,prayer,2165,29011908,83.5850048395,90,6,>1K
1610,grew,2165,29014073,83.5912423312,90,4,>1K
1611,appreciate,2163,29016236,83.5974740607,90,10,>1K
1612,impact,2160,29018396,83.6036971472,90,6,>1K
1613,features,2157,29020553,83.6099115904,90,8,>1K
1614,ink,2156,29022709,83.6161231526,90,3,>1K
1615,legs,2155,29024864,83.6223318337,90,4,>1K
1616,significant,2152,29027016,83.6285318716,90,11,>1K
1617,pack,2151,29029167,83.6347290285,90,4,>1K
1618,leader,2151,29031318,83.6409261854,90,6,>1K
1619,basis,2149,29033467,83.6471175802,90,5,>1K
1620,somewhat,2148,29035615,83.6533060939,90,8,>1K
1621,pepper,2148,29037763,83.6594946076,90,6,>1K
1622,fighting,2143,29039906,83.665668716,90,8,>1K
1623,progress,2142,29042048,83.6718399434,90,8,>1K
1624,till,2141,29044189,83.6780082897,90,4,>1K
1625,cancer,2139,29046328,83.6841708739,90,6,>1K
1626,concept,2139,29048467,83.690333458,90,7,>1K
1627,hearts,2137,29050604,83.6964902801,90,6,>1K
1628,dough,2136,29052740,83.7026442211,90,5,>1K
1629,actions,2134,29054874,83.7087924,90,7,>1K
1630,stars,2133,29057007,83.7149376978,90,5,>1K
1631,returned,2132,29059139,83.7210801146,90,8,>1K
1632,recommend,2128,29061267,83.7272110071,90,9,>1K
1633,failed,2127,29063394,83.7333390186,90,6,>1K
1634,twice,2126,29065520,83.739464149,90,5,>1K
1635,everyday,2123,29067643,83.7455806363,90,8,>1K
1636,november,2122,29069765,83.7516942425,90,8,>1K
1637,council,2122,29071887,83.7578078487,90,7,>1K
1638,wanting,2119,29074006,83.7639128117,90,7,>1K
1639,levels,2118,29076124,83.7700148936,90,6,>1K
1640,tough,2117,29078241,83.7761140945,90,5,>1K
1641,reached,2117,29080358,83.7822132954,90,7,>1K
1642,everywhere,2112,29082470,83.788298091,90,10,>1K
1643,rose,2111,29084581,83.7943800056,90,4,>1K
1644,personally,2110,29086691,83.8004590391,90,10,>1K
1645,chosen,2109,29088800,83.8065351915,90,6,>1K
1646,october,2106,29090906,83.8126027007,90,7,>1K
1647,keeps,2105,29093011,83.8186673289,90,5,>1K
1648,budget,2103,29095114,83.824726195,90,6,>1K
1649,presence,2103,29097217,83.8307850611,90,8,>1K
1650,plastic,2103,29099320,83.8368439272,90,7,>1K
1651,choices,2102,29101422,83.8428999122,90,7,>1K
1652,player,2099,29103521,83.848947254,90,6,>1K
1653,option,2099,29105620,83.8549945959,90,6,>1K
1654,hall,2098,29107718,83.8610390566,90,4,>1K
1655,teachers,2096,29109814,83.8670777553,90,8,>1K
1656,thinks,2096,29111910,83.873116454,90,6,>1K
1657,closed,2096,29114006,83.8791551526,90,6,>1K
1658,smaller,2090,29116096,83.885176565,90,7,>1K
1659,offers,2089,29118185,83.8911950962,90,6,>1K
1660,treat,2089,29120274,83.8972136275,90,5,>1K
1661,begins,2089,29122363,83.9032321587,90,6,>1K
1662,recipes,2089,29124452,83.90925069,90,7,>1K
1663,england,2087,29126539,83.9152634591,90,7,>1K
1664,k,2087,29128626,83.9212762283,90,1,>1K
1665,concerned,2086,29130712,83.9272861163,90,9,>1K
1666,g,2086,29132798,83.9332960044,90,1,>1K
1667,hill,2085,29134883,83.9393030114,90,4,>1K
1668,official,2085,29136968,83.9453100185,90,8,>1K
1669,web,2083,29139051,83.9513112634,90,3,>1K
1670,easter,2083,29141134,83.9573125083,90,6,>1K
1671,feature,2082,29143216,83.9633108721,90,7,>1K
1672,stone,2081,29145297,83.9693063549,90,5,>1K
1673,uses,2081,29147378,83.9753018377,90,4,>1K
1674,lay,2078,29149456,83.9812886773,90,3,>1K
1675,runs,2078,29151534,83.9872755169,90,4,>1K
1676,emotional,2077,29153611,83.9932594755,90,9,>1K
1677,seat,2071,29155682,83.9992261477,90,4,>1K
1678,chapter,2069,29157751,84.0051870578,90,7,>1K
1679,wood,2069,29159820,84.0111479679,90,4,>1K
1680,shown,2068,29161888,84.0171059969,90,5,>1K
1681,alive,2065,29163953,84.0230553827,90,5,>1K
1682,economy,2064,29166017,84.0290018875,90,7,>1K
1683,hang,2062,29168079,84.0349426302,90,4,>1K
1684,rise,2062,29170141,84.0408833729,90,4,>1K
1685,majority,2058,29172199,84.0468125913,90,8,>1K
1686,hasn,2056,29174255,84.0527360476,90,4,>1K
1687,chair,2054,29176309,84.0586537419,90,5,>1K
1688,thousands,2049,29178358,84.0645570308,90,9,>1K
1689,grown,2048,29180406,84.0704574386,90,5,>1K
1690,master,2046,29182452,84.0763520844,90,6,>1K
1691,marketing,2046,29184498,84.0822467301,90,9,>1K
1692,produce,2046,29186544,84.0881413758,90,7,>1K
1693,seconds,2042,29188586,84.0940244974,90,7,>1K
1694,western,2042,29190628,84.0999076189,90,7,>1K
1695,posting,2039,29192667,84.1057820972,90,7,>1K
1696,india,2038,29194705,84.1116536945,90,5,>1K
1697,activity,2038,29196743,84.1175252917,90,8,>1K
1698,sets,2037,29198780,84.1233940079,90,4,>1K
1699,artists,2035,29200815,84.129256962,90,7,>1K
1700,fingers,2034,29202849,84.1351170351,90,7,>1K
1701,enjoying,2034,29204883,84.1409771081,90,8,>1K
1702,greatest,2032,29206915,84.146831419,90,8,>1K
1703,remains,2031,29208946,84.1526828489,90,7,>1K
1704,caused,2031,29210977,84.1585342788,90,6,>1K
1705,goals,2030,29213007,84.1643828276,90,5,>1K
1706,degree,2022,29215029,84.1702083279,90,6,>1K
1707,wondering,2021,29217050,84.1760309472,90,9,>1K
1708,impossible,2020,29219070,84.1818506854,90,10,>1K
1709,ale,2020,29221090,84.1876704236,90,3,>1K
1710,male,2019,29223109,84.1934872808,90,4,>1K
1711,stir,2015,29225124,84.1992926137,90,4,>1K
1712,2014,2014,29227138,84.2050950656,90,4,>1K
1713,resources,2013,29229151,84.2108946364,90,9,>1K
1714,2013,2013,29231164,84.2166942072,90,4,>1K
1715,2012,2012,29233176,84.2224908969,90,4,>1K
1716,2011,2011,29235187,84.2282847056,90,4,>1K
1717,2010,2010,29237197,84.2340756333,90,4,>1K
1718,2009,2009,29239206,84.2398636798,90,4,>1K
1719,2008,2008,29241214,84.2456488454,90,4,>1K
1720,2007,2007,29243221,84.2514311298,90,4,>1K
1721,2006,2006,29245227,84.2572105332,90,4,>1K
1722,2005,2005,29247232,84.2629870555,90,4,>1K
1723,2004,2004,29249236,84.2687606968,90,4,>1K
1724,2003,2003,29251239,84.2745314571,90,4,>1K
1725,2002,2002,29253241,84.2802993362,90,4,>1K
1726,hanging,2002,29255243,84.2860672154,90,7,>1K
1727,celebrate,2002,29257245,84.2918350945,90,9,>1K
1728,population,2002,29259247,84.2976029737,90,10,>1K
1729,finds,2002,29261249,84.3033708529,90,5,>1K
1730,animal,2001,29263250,84.309135851,90,6,>1K
1731,2001,2001,29265251,84.3149008491,90,4,>1K
1732,2000,2000,29267251,84.3206629661,90,4,>1K
1733,1999,1999,29269250,84.3264222021,90,4,>1K
1734,smell,1998,29271248,84.3321785571,90,5,>1K
1735,1998,1998,29273246,84.337934912,90,4,>1K
1736,guide,1997,29275243,84.3436883859,90,5,>1K
1737,1997,1997,29277240,84.3494418597,90,4,>1K
1738,1996,1996,29279236,84.3551924525,90,4,>1K
1739,crowd,1995,29281231,84.3609401643,90,5,>1K
1740,empty,1995,29283226,84.3666878761,90,5,>1K
1741,1995,1995,29285221,84.3724355878,90,4,>1K
1742,1994,1994,29287215,84.3781804185,90,4,>1K
1743,farm,1994,29289209,84.3839252492,90,4,>1K
1744,americans,1994,29291203,84.3896700799,90,9,>1K
1745,constantly,1993,29293196,84.3954120295,90,10,>1K
1746,1993,1993,29295189,84.4011539792,90,4,>1K
1747,1992,1992,29297181,84.4068930478,90,4,>1K
1748,prize,1991,29299172,84.4126292353,90,5,>1K
1749,1991,1991,29301163,84.4183654228,90,4,>1K
1750,1990,1990,29303153,84.4240987293,90,4,>1K
1751,1990s,1990,29305143,84.4298320357,90,5,>1K
1752,1989,1989,29307132,84.4355624611,90,4,>1K
1753,violence,1988,29309120,84.4412900055,90,8,>1K
1754,1988,1988,29311108,84.4470175498,90,4,>1K
1755,parties,1988,29313096,84.4527450942,90,7,>1K
1756,breath,1988,29315084,84.4584726385,90,6,>1K
1757,1987,1987,29317071,84.4641973018,90,4,>1K
1758,powder,1986,29319057,84.469919084,90,6,>1K
1759,1986,1986,29321043,84.4756408663,90,4,>1K
1760,1985,1985,29323028,84.4813597674,90,4,>1K
1761,protect,1985,29325013,84.4870786686,90,7,>1K
1762,pot,1985,29326998,84.4927975698,90,3,>1K
1763,1984,1984,29328982,84.4985135899,90,4,>1K
1764,anywhere,1984,29330966,84.50422961,90,8,>1K
1765,1983,1983,29332949,84.509942749,90,4,>1K
1766,vote,1982,29334931,84.515653007,90,4,>1K
1767,considering,1982,29336913,84.521363265,90,11,>1K
1768,1982,1982,29338895,84.527073523,90,4,>1K
1769,1981,1981,29340876,84.5327809,90,4,>1K
1770,1980s,1980,29342856,84.5384853958,90,5,>1K
1771,1980,1980,29344836,84.5441898917,90,4,>1K
1772,1979,1979,29346815,84.5498915065,90,4,>1K
1773,eight,1979,29348794,84.5555931214,90,5,>1K
1774,september,1979,29350773,84.5612947362,90,9,>1K
1775,1978,1978,29352751,84.5669934699,90,4,>1K
1776,1977,1977,29354728,84.5726893226,90,4,>1K
1777,1976,1976,29356704,84.5783822943,90,4,>1K
1778,1975,1975,29358679,84.5840723849,90,4,>1K
1779,1974,1974,29360653,84.5897595944,90,4,>1K
1780,google,1974,29362627,84.5954468039,90,6,>1K
1781,publishing,1973,29364600,84.6011311324,90,10,>1K
1782,1973,1973,29366573,84.6068154609,90,4,>1K
1783,direct,1973,29368546,84.6124997893,90,6,>1K
1784,texas,1972,29370518,84.6181812367,90,5,>1K
1785,1972,1972,29372490,84.6238626841,90,4,>1K
1786,update,1972,29374462,84.6295441316,90,6,>1K
1787,1971,1971,29376433,84.6352226979,90,4,>1K
1788,1970s,1970,29378403,84.6408983832,90,5,>1K
1789,1970,1970,29380373,84.6465740685,90,4,>1K
1790,1969,1969,29382342,84.6522468727,90,4,>1K
1791,1968,1968,29384310,84.6579167959,90,4,>1K
1792,army,1967,29386277,84.663583838,90,4,>1K
1793,1967,1967,29388244,84.6692508801,90,4,>1K
1794,1966,1966,29390210,84.6749150412,90,4,>1K
1795,1965,1965,29392175,84.6805763212,90,4,>1K
1796,discussion,1964,29394139,84.6862347201,90,10,>1K
1797,1964,1964,29396103,84.6918931191,90,4,>1K
1798,1963,1963,29398066,84.6975486369,90,4,>1K
1799,1962,1962,29400028,84.7032012738,90,4,>1K
1800,1961,1961,29401989,84.7088510295,90,4,>1K
1801,universe,1961,29403950,84.7145007853,90,8,>1K
1802,mental,1961,29405911,84.7201505411,90,6,>1K
1803,1960,1960,29407871,84.7257974158,90,4,>1K
1804,1960s,1960,29409831,84.7314442905,90,5,>1K
1805,1959,1959,29411790,84.7370882841,90,4,>1K
1806,1958,1958,29413748,84.7427293967,90,4,>1K
1807,1957,1957,29415705,84.7483676283,90,4,>1K
1808,techniques,1957,29417662,84.7540058598,90,10,>1K
1809,session,1957,29419619,84.7596440913,90,7,>1K
1810,1956,1956,29421575,84.7652794418,90,4,>1K
1811,ladies,1955,29423530,84.7709119112,90,6,>1K
1812,blessed,1955,29425485,84.7765443806,90,7,>1K
1813,1955,1955,29427440,84.78217685,90,4,>1K
1814,circle,1954,29429394,84.7878064384,90,6,>1K
1815,1954,1954,29431348,84.7934360267,90,4,>1K
1816,cry,1953,29433301,84.799062734,90,3,>1K
1817,1953,1953,29435254,84.8046894413,90,4,>1K
1818,1952,1952,29437206,84.8103132676,90,4,>1K
1819,benefit,1952,29439158,84.8159370938,90,7,>1K
1820,block,1952,29441110,84.8215609201,90,5,>1K
1821,pm,1952,29443062,84.8271847463,90,2,>1K
1822,charge,1951,29445013,84.8328056915,90,6,>1K
1823,effects,1951,29446964,84.8384266367,90,7,>1K
1824,1950,1950,29448914,84.8440447008,90,4,>1K
1825,1950s,1950,29450864,84.8496627649,90,5,>1K
1826,religion,1949,29452813,84.855277948,90,8,>1K
1827,described,1949,29454762,84.860893131,90,9,>1K
1828,1949,1949,29456711,84.8665083141,90,4,>1K
1829,damage,1948,29458659,84.8721206161,90,6,>1K
1830,1948,1948,29460607,84.8777329181,90,4,>1K
1831,figured,1947,29462554,84.883342339,90,7,>1K
1832,1947,1947,29464501,84.88895176,90,4,>1K
1833,handle,1947,29466448,84.8945611809,90,6,>1K
1834,european,1947,29468395,84.9001706019,90,8,>1K
1835,types,1945,29470340,84.9057742607,90,5,>1K
1836,1945,1945,29472285,84.9113779195,90,4,>1K
1837,vision,1944,29474229,84.9169786973,90,6,>1K
1838,1944,1944,29476173,84.9225794751,90,4,>1K
1839,1942,1942,29478115,84.9281744907,90,4,>1K
1840,1941,1941,29480056,84.9337666253,90,4,>1K
1841,1940,1940,29481996,84.9393558789,90,4,>1K
1842,federal,1940,29483936,84.9449451324,90,7,>1K
1843,1940s,1940,29485876,84.9505343859,90,5,>1K
1844,1939,1939,29487815,84.9561207584,90,4,>1K
1845,continues,1937,29489752,84.9617013688,90,9,>1K
1846,comfort,1936,29491688,84.9672790981,90,7,>1K
1847,lie,1934,29493622,84.9728510653,90,3,>1K
1848,l,1933,29495555,84.9784201514,90,1,>1K
1849,entry,1932,29497487,84.9839863565,90,5,>1K
1850,options,1931,29499418,84.9895496805,90,7,>1K
1851,plant,1930,29501348,84.9951101234,90,5,>1K
1852,1930,1930,29503278,85.0006705664,90,4,>1K
1853,1930s,1930,29505208,85.0062310093,90,5,>1K
1854,angry,1930,29507138,85.0117914523,90,5,>1K
1855,appeared,1929,29509067,85.0173490142,90,8,>1K
1856,sites,1928,29510995,85.022903695,90,5,>1K
1857,cars,1927,29512922,85.0284554948,90,4,>1K
1858,mary,1926,29514848,85.0340044135,90,4,>1K
1859,stayed,1925,29516773,85.0395504512,90,6,>1K
1860,management,1925,29518698,85.0450964888,90,10,>1K
1861,elements,1922,29520620,85.0506338833,90,8,>1K
1862,grade,1922,29522542,85.0561712778,90,5,>1K
1863,costs,1921,29524463,85.0617057912,90,5,>1K
1864,flat,1921,29526384,85.0672403046,90,4,>1K
1865,safety,1920,29528304,85.072771937,90,6,>1K
1866,1920s,1920,29530224,85.0783035694,90,5,>1K
1867,1920,1920,29532144,85.0838352017,90,4,>1K
1868,vintage,1918,29534062,85.089361072,90,7,>1K
1869,ribbon,1916,29535978,85.0948811801,90,6,>1K
1870,studio,1915,29537893,85.1003984072,90,6,>1K
1871,negative,1915,29539808,85.1059156343,90,8,>1K
1872,ring,1913,29541721,85.1114270992,90,4,>1K
1873,walls,1913,29543634,85.1169385642,90,5,>1K
1874,centre,1912,29545546,85.1224471481,90,6,>1K
1875,ya,1911,29547457,85.1279528509,90,2,>1K
1876,san,1908,29549365,85.1334499106,90,3,>1K
1877,mixed,1907,29551272,85.1389440892,90,5,>1K
1878,babies,1906,29553178,85.1444353867,90,6,>1K
1879,planet,1905,29555083,85.1499238032,90,6,>1K
1880,falling,1903,29556986,85.1554064576,90,7,>1K
1881,mission,1903,29558889,85.1608891119,90,7,>1K
1882,minister,1902,29560791,85.1663688853,90,8,>1K
1883,allows,1901,29562692,85.1718457775,90,6,>1K
1884,1900,1900,29564592,85.1773197887,90,4,>1K
1885,selling,1900,29566492,85.1827937999,90,7,>1K
1886,separate,1899,29568391,85.18826493,90,8,>1K
1887,experienced,1897,29570288,85.1937302981,90,11,>1K
1888,expensive,1895,29572183,85.199189904,90,9,>1K
1889,struggle,1894,29574077,85.2046466288,90,8,>1K
1890,prefer,1892,29575969,85.2100975915,90,6,>1K
1891,organization,1890,29577859,85.2155427921,90,12,>1K
1892,surely,1889,29579748,85.2209851117,90,6,>1K
1893,letters,1885,29581633,85.226415907,90,7,>1K
1894,hello,1883,29583516,85.2318409402,90,5,>1K
1895,flavor,1881,29585397,85.2372602113,90,6,>1K
1896,complex,1880,29587277,85.2426766013,90,7,>1K
1897,developed,1880,29589157,85.2480929913,90,9,>1K
1898,normally,1880,29591037,85.2535093814,90,8,>1K
1899,cookies,1877,29592914,85.2589171282,90,7,>1K
1900,ending,1876,29594790,85.264321994,90,6,>1K
1901,whilst,1875,29596665,85.2697239787,90,6,>1K
1902,paying,1874,29598539,85.2751230824,90,6,>1K
1903,guest,1872,29600411,85.280516424,90,5,>1K
1904,raise,1872,29602283,85.2859097655,90,5,>1K
1905,relationships,1870,29604153,85.291297345,90,13,>1K
1906,smooth,1865,29606018,85.2966705191,90,6,>1K
1907,suppose,1864,29607882,85.3020408122,90,7,>1K
1908,proper,1864,29609746,85.3074111053,90,6,>1K
1909,perspective,1863,29611609,85.3127785173,90,11,>1K
1910,county,1861,29613470,85.3181401672,90,6,>1K
1911,metal,1859,29615329,85.323496055,90,5,>1K
1912,politics,1857,29617186,85.3288461807,90,8,>1K
1913,wake,1856,29619042,85.3341934253,90,4,>1K
1914,sports,1855,29620897,85.3395377889,90,6,>1K
1915,lights,1853,29622750,85.3448763903,90,6,>1K
1916,ate,1851,29624601,85.3502092297,90,3,>1K
1917,younger,1851,29626452,85.355542069,90,7,>1K
1918,plants,1850,29628302,85.3608720273,90,6,>1K
1919,compared,1850,29630152,85.3662019855,90,8,>1K
1920,african,1845,29631997,85.3715175385,90,7,>1K
1921,shouldn,1844,29633841,85.3768302104,90,7,>1K
1922,forces,1843,29635684,85.3821400013,90,6,>1K
1923,speech,1843,29637527,85.3874497922,90,6,>1K
1924,silver,1843,29639370,85.392759583,90,6,>1K
1925,gifts,1842,29641212,85.3980664928,90,5,>1K
1926,scenes,1842,29643054,85.4033734026,90,6,>1K
1927,youth,1842,29644896,85.4086803124,90,5,>1K
1928,odd,1841,29646737,85.4139843412,90,3,>1K
1929,august,1840,29648577,85.4192854888,90,6,>1K
1930,bringing,1837,29650414,85.4245779934,90,8,>1K
1931,paris,1835,29652249,85.4298647357,90,5,>1K
1932,network,1835,29654084,85.4351514781,90,7,>1K
1933,stress,1832,29655916,85.4404295774,90,6,>1K
1934,broke,1832,29657748,85.4457076766,90,5,>1K
1935,foods,1830,29659578,85.4509800137,90,5,>1K
1936,gas,1830,29661408,85.4562523508,90,3,>1K
1937,decisions,1825,29663233,85.4615102826,90,9,>1K
1938,connection,1823,29665056,85.4667624523,90,10,>1K
1939,efforts,1823,29666879,85.4720146219,90,7,>1K
1940,garlic,1822,29668701,85.4772639106,90,6,>1K
1941,singing,1818,29670519,85.482501675,90,7,>1K
1942,reported,1818,29672337,85.4877394394,90,8,>1K
1943,brothers,1817,29674154,85.4929743227,90,8,>1K
1944,terrible,1816,29675970,85.498206325,90,8,>1K
1945,yard,1815,29677785,85.5034354462,90,4,>1K
1946,football,1813,29679598,85.5086588053,90,8,>1K
1947,surface,1813,29681411,85.5138821644,90,7,>1K
1948,damn,1813,29683224,85.5191055235,90,4,>1K
1949,nights,1811,29685035,85.5243231205,90,6,>1K
1950,detail,1811,29686846,85.5295407175,90,6,>1K
1951,distance,1809,29688655,85.5347525524,90,8,>1K
1952,candy,1808,29690463,85.5399615062,90,5,>1K
1953,treatment,1808,29692271,85.54517046,90,9,>1K
1954,pool,1807,29694078,85.5503765327,90,4,>1K
1955,apartment,1806,29695884,85.5555797244,90,9,>1K
1956,streets,1806,29697690,85.5607829161,90,7,>1K
1957,location,1806,29699496,85.5659861078,90,8,>1K
1958,letting,1805,29701301,85.5711864185,90,7,>1K
1959,acts,1804,29703105,85.576383848,90,4,>1K
1960,suggest,1804,29704909,85.5815812776,90,7,>1K
1961,benefits,1803,29706712,85.5867758261,90,8,>1K
1962,additional,1803,29708515,85.5919703747,90,10,>1K
1963,creation,1803,29710318,85.5971649232,90,8,>1K
1964,spoke,1803,29712121,85.6023594717,90,5,>1K
1965,y,1802,29713923,85.6075511391,90,1,>1K
1966,grateful,1801,29715724,85.6127399256,90,8,>1K
1967,smart,1796,29717520,85.6179143067,90,5,>1K
1968,insurance,1795,29719315,85.6230858067,90,9,>1K
1969,soup,1795,29721110,85.6282573068,90,4,>1K
1970,thick,1794,29722904,85.6334259258,90,5,>1K
1971,apply,1793,29724697,85.6385916637,90,5,>1K
1972,generation,1793,29726490,85.6437574016,90,10,>1K
1973,blogger,1789,29728279,85.6489116153,90,7,>1K
1974,horse,1788,29730067,85.654062948,90,5,>1K
1975,laws,1787,29731854,85.6592113995,90,4,>1K
1976,lesson,1786,29733640,85.6643569701,90,6,>1K
1977,cheap,1786,29735426,85.6695025406,90,5,>1K
1978,birds,1785,29737211,85.6746452301,90,5,>1K
1979,queen,1783,29738994,85.6797821574,90,5,>1K
1980,exist,1780,29740774,85.6849104416,90,5,>1K
1981,juice,1780,29742554,85.6900387257,90,5,>1K
1982,mess,1780,29744334,85.6951670099,90,4,>1K
1983,target,1777,29746111,85.7002866509,90,6,>1K
1984,agent,1776,29747887,85.7054034109,90,5,>1K
1985,sin,1776,29749663,85.7105201708,90,3,>1K
1986,murder,1775,29751438,85.7156340497,90,6,>1K
1987,provides,1775,29753213,85.7207479286,90,8,>1K
1988,sight,1772,29754985,85.7258531643,90,5,>1K
1989,effective,1771,29756756,85.7309555189,90,9,>1K
1990,historical,1768,29758524,85.7360492304,90,10,>1K
1991,salad,1767,29760291,85.7411400608,90,5,>1K
1992,plays,1766,29762057,85.7462280101,90,5,>1K
1993,arm,1765,29763822,85.7513130784,90,3,>1K
1994,offering,1764,29765586,85.7563952657,90,8,>1K
1995,individuals,1763,29767349,85.7614745718,90,11,>1K
1996,responsible,1762,29769111,85.766550997,90,11,>1K
1997,village,1761,29770872,85.771624541,90,7,>1K
1998,records,1761,29772633,85.7766980851,90,7,>1K
1999,stores,1760,29774393,85.7817687481,90,6,>1K
2000,layer,1759,29776152,85.78683653,90,5,>1K
2001,reminded,1757,29777909,85.7918985499,90,8,>1K
2002,claims,1753,29779662,85.7969490455,90,6,>1K
2003,fly,1752,29781414,85.80199666,90,3,>1K
2004,jump,1751,29783165,85.8070413935,90,4,>1K
2005,joined,1745,29784910,85.8120688406,90,6,>1K
2006,wow,1745,29786655,85.8170962877,90,3,>1K
2007,union,1744,29788399,85.8221208538,90,5,>1K
2008,mountain,1742,29790141,85.8271396577,90,8,>1K
2009,dropped,1741,29791882,85.8321555806,90,7,>1K
2010,barely,1741,29793623,85.8371715035,90,6,>1K
2011,suggested,1741,29795364,85.8421874264,90,9,>1K
2012,forth,1740,29797104,85.8472004682,90,5,>1K
2013,task,1740,29798844,85.8522135101,90,4,>1K
2014,appropriate,1739,29800583,85.8572236708,90,11,>1K
2015,influence,1739,29802322,85.8622338316,90,9,>1K
2016,plain,1737,29804059,85.8672382303,90,5,>1K
2017,incredibly,1737,29805796,85.8722426289,90,10,>1K
2018,nobody,1736,29807532,85.8772441465,90,6,>1K
2019,correct,1736,29809268,85.8822456641,90,7,>1K
2020,co,1733,29811001,85.8872385385,90,2,>1K
2021,solution,1732,29812733,85.8922285319,90,8,>1K
2022,announced,1730,29814463,85.8972127631,90,9,>1K
2023,washington,1730,29816193,85.9021969944,90,10,>1K
2024,seek,1729,29817922,85.9071783446,90,4,>1K
2025,visiting,1729,29819651,85.9121596948,90,8,>1K
2026,loud,1728,29821379,85.9171381639,90,4,>1K
2027,gonna,1727,29823106,85.922113752,90,5,>1K
2028,interests,1727,29824833,85.92708934,90,9,>1K
2029,lemon,1726,29826559,85.9320620471,90,5,>1K
2030,topic,1725,29828284,85.937031873,90,5,>1K
2031,adventure,1725,29830009,85.942001699,90,9,>1K
2032,develop,1725,29831734,85.9469715249,90,7,>1K
2033,chris,1724,29833458,85.9519384698,90,5,>1K
2034,civil,1723,29835181,85.9569025336,90,5,>1K
2035,produced,1721,29836902,85.9618608354,90,8,>1K
2036,reports,1719,29838621,85.966813375,90,7,>1K
2037,honor,1718,29840339,85.9717630335,90,5,>1K
2038,lies,1717,29842056,85.976709811,90,4,>1K
2039,brewing,1716,29843772,85.9816537074,90,7,>1K
2040,agreed,1715,29845487,85.9865947228,90,6,>1K
2041,bags,1715,29847202,85.9915357382,90,4,>1K
2042,alcohol,1714,29848916,85.9964738725,90,7,>1K
2043,windows,1714,29850630,86.0014120068,90,7,>1K
2044,mad,1713,29852343,86.00634726,90,3,>1K
2045,diet,1711,29854054,86.0112767512,90,4,>1K
2046,sleeping,1711,29855765,86.0162062423,90,8,>1K
2047,wet,1708,29857473,86.0211270903,90,3,>1K
2048,multiple,1707,29859180,86.0260450572,90,8,>1K
2049,kinds,1706,29860886,86.030960143,90,5,>1K
2050,mystery,1706,29862592,86.0358752288,90,7,>1K
2051,independent,1705,29864297,86.0407874336,90,11,>1K
2052,opposite,1704,29866001,86.0456967574,90,8,>1K
2053,bird,1704,29867705,86.0506060811,90,4,>1K
2054,chief,1704,29869409,86.0555154048,90,5,>1K
2055,pure,1704,29871113,86.0604247285,90,4,>1K
2056,prices,1703,29872816,86.0653311712,90,6,>1K
2057,degrees,1701,29874517,86.0702318517,90,7,>1K
2058,district,1697,29876214,86.0751210081,90,8,>1K
2059,lake,1697,29877911,86.0800101644,90,4,>1K
2060,ancient,1695,29879606,86.0848935586,90,7,>1K
2061,losing,1695,29881301,86.0897769528,90,6,>1K
2062,pleasure,1692,29882993,86.0946517038,90,8,>1K
2063,explained,1692,29884685,86.0995264548,90,9,>1K
2064,accepted,1690,29886375,86.1043954437,90,8,>1K
2065,joe,1690,29888065,86.1092644326,90,3,>1K
2066,brilliant,1688,29889753,86.1141276594,90,9,>1K
2067,signed,1687,29891440,86.1189880051,90,6,>1K
2068,unlike,1687,29893127,86.1238483509,90,6,>1K
2069,humans,1686,29894813,86.1287058155,90,6,>1K
2070,dollars,1686,29896499,86.1335632802,90,7,>1K
2071,views,1686,29898185,86.1384207449,90,5,>1K
2072,pour,1685,29899870,86.1432753285,90,4,>1K
2073,behavior,1685,29901555,86.1481299121,90,8,>1K
2074,believed,1685,29903240,86.1529844957,90,8,>1K
2075,cultural,1684,29904924,86.1578361983,90,8,>1K
2076,designs,1682,29906606,86.1626821387,90,7,>1K
2077,serving,1682,29908288,86.1675280792,90,7,>1K
2078,manage,1681,29909969,86.1723711385,90,6,>1K
2079,partner,1681,29911650,86.1772141979,90,7,>1K
2080,answers,1679,29913329,86.1820514952,90,7,>1K
2081,bathroom,1679,29915008,86.1868887924,90,8,>1K
2082,cash,1677,29916685,86.1917203276,90,4,>1K
2083,giant,1677,29918362,86.1965518627,90,5,>1K
2084,customers,1676,29920038,86.2013805168,90,9,>1K
2085,remaining,1675,29921713,86.2062062898,90,9,>1K
2086,painted,1674,29923387,86.2110291818,90,7,>1K
2087,leads,1673,29925060,86.2158491927,90,5,>1K
2088,nose,1670,29926730,86.2206605605,90,4,>1K
2089,cutting,1669,29928399,86.2254690471,90,7,>1K
2090,camp,1669,29930068,86.2302775338,90,4,>1K
2091,besides,1667,29931735,86.2350802584,90,7,>1K
2092,childhood,1665,29933400,86.2398772208,90,9,>1K
2093,matters,1664,29935064,86.2446713022,90,7,>1K
2094,fantasy,1664,29936728,86.2494653836,90,7,>1K
2095,row,1664,29938392,86.254259465,90,3,>1K
2096,facts,1664,29940056,86.2590535463,90,5,>1K
2097,code,1664,29941720,86.2638476277,90,4,>1K
2098,heads,1664,29943384,86.2686417091,90,5,>1K
2099,owner,1663,29945047,86.2734329094,90,5,>1K
2100,cooked,1662,29946709,86.2782212287,90,6,>1K
2101,homes,1659,29948368,86.2830009048,90,5,>1K
2102,reviews,1658,29950026,86.2877776998,90,7,>1K
2103,prepare,1656,29951682,86.2925487327,90,7,>1K
2104,incredible,1654,29953336,86.2973140035,90,10,>1K
2105,originally,1653,29954989,86.3020763933,90,10,>1K
2106,saved,1651,29956640,86.3068330209,90,5,>1K
2107,frame,1651,29958291,86.3115896485,90,5,>1K
2108,league,1650,29959941,86.3163433951,90,6,>1K
2109,method,1646,29961587,86.3210856174,90,6,>1K
2110,sheet,1644,29963231,86.3258220776,90,5,>1K
2111,annual,1643,29964874,86.3305556568,90,6,>1K
2112,romance,1641,29966515,86.3352834738,90,7,>1K
2113,theory,1641,29968156,86.3400112909,90,6,>1K
2114,bridge,1640,29969796,86.3447362268,90,6,>1K
2115,useful,1640,29971436,86.3494611628,90,6,>1K
2116,vanilla,1638,29973074,86.3541803367,90,7,>1K
2117,harder,1638,29974712,86.3588995106,90,6,>1K
2118,gun,1638,29976350,86.3636186844,90,3,>1K
2119,display,1636,29977986,86.3683320962,90,7,>1K
2120,authority,1636,29979622,86.3730455079,90,9,>1K
2121,traffic,1635,29981257,86.3777560386,90,7,>1K
2122,argument,1635,29982892,86.3824665693,90,8,>1K
2123,forms,1635,29984527,86.3871771,90,5,>1K
2124,signs,1634,29986161,86.3918847496,90,5,>1K
2125,conditions,1634,29987795,86.3965923992,90,10,>1K
2126,ultimately,1632,29989427,86.4012942867,90,10,>1K
2127,foundation,1631,29991058,86.4059932932,90,10,>1K
2128,horror,1631,29992689,86.4106922996,90,6,>1K
2129,achieve,1630,29994319,86.415388425,90,7,>1K
2130,faces,1630,29995949,86.4200845504,90,5,>1K
2131,tom,1628,29997577,86.4247749137,90,3,>1K
2132,cleaning,1626,29999203,86.4294595149,90,8,>1K
2133,robert,1625,30000828,86.434141235,90,6,>1K
2134,hundreds,1625,30002453,86.4388229551,90,8,>1K
2135,responsibility,1622,30004075,86.443496032,90,14,>1K
2136,drawing,1621,30005696,86.4481662279,90,7,>1K
2137,prior,1621,30007317,86.4528364237,90,5,>1K
2138,disease,1621,30008938,86.4575066196,90,7,>1K
2139,schedule,1621,30010559,86.4621768155,90,8,>1K
2140,ordered,1620,30012179,86.4668441303,90,7,>1K
2141,f,1618,30013797,86.471505683,90,1,>1K
2142,journal,1618,30015415,86.4761672357,90,7,>1K
2143,indian,1618,30017033,86.4808287883,90,6,>1K
2144,france,1614,30018647,86.4854788168,90,6,>1K
2145,museum,1611,30020258,86.4901202021,90,6,>1K
2146,advertising,1611,30021869,86.4947615874,90,11,>1K
2147,mile,1610,30023479,86.4994000916,90,4,>1K
2148,plate,1610,30025089,86.5040385958,90,5,>1K
2149,gain,1608,30026697,86.5086713379,90,4,>1K
2150,dangerous,1607,30028304,86.513301199,90,9,>1K
2151,houses,1607,30029911,86.51793106,90,6,>1K
2152,flying,1606,30031517,86.52255804,90,6,>1K
2153,suffering,1605,30033122,86.5271821389,90,9,>1K
2154,everybody,1605,30034727,86.5318062379,90,9,>1K
2155,parent,1605,30036332,86.5364303368,90,6,>1K
2156,tips,1604,30037936,86.5410515547,90,4,>1K
2157,sees,1604,30039540,86.5456727725,90,4,>1K
2158,removed,1601,30041141,86.5502853472,90,7,>1K
2159,studies,1600,30042741,86.5548950409,90,7,>1K
2160,describe,1598,30044339,86.5594989724,90,8,>1K
2161,presented,1596,30045935,86.5640971418,90,9,>1K
2162,piano,1595,30047530,86.5686924301,90,5,>1K
2163,dancing,1593,30049123,86.5732819564,90,7,>1K
2164,glory,1593,30050716,86.5778714826,90,5,>1K
2165,southern,1593,30052309,86.5824610088,90,8,>1K
2166,improve,1593,30053902,86.5870505351,90,7,>1K
2167,beans,1592,30055494,86.5916371802,90,5,>1K
2168,grab,1591,30057085,86.5962209443,90,4,>1K
2169,completed,1591,30058676,86.6008047085,90,9,>1K
2170,length,1589,30060265,86.6053827105,90,6,>1K
2171,sing,1588,30061853,86.6099578314,90,4,>1K
2172,japanese,1587,30063440,86.6145300713,90,8,>1K
2173,condition,1587,30065027,86.6191023111,90,9,>1K
2174,carried,1586,30066613,86.62367167,90,7,>1K
2175,flight,1585,30068198,86.6282381477,90,6,>1K
2176,focused,1584,30069782,86.6328017444,90,7,>1K
2177,mail,1584,30071366,86.6373653411,90,4,>1K
2178,van,1584,30072950,86.6419289378,90,3,>1K
2179,waste,1583,30074533,86.6464896535,90,5,>1K
2180,thin,1580,30076113,86.6510417259,90,4,>1K
2181,hidden,1580,30077693,86.6555937984,90,6,>1K
2182,killing,1578,30079271,86.6601401088,90,7,>1K
2183,border,1578,30080849,86.6646864191,90,6,>1K
2184,solid,1577,30082426,86.6692298484,90,5,>1K
2185,status,1577,30084003,86.6737732777,90,6,>1K
2186,german,1576,30085579,86.6783138259,90,6,>1K
2187,ensure,1573,30087152,86.682845731,90,6,>1K
2188,regarding,1572,30088724,86.687374755,90,9,>1K
2189,rare,1571,30090295,86.6919008979,90,4,>1K
2190,vacation,1570,30091865,86.6964241598,90,8,>1K
2191,doors,1570,30093435,86.7009474217,90,5,>1K
2192,bike,1568,30095003,86.7054649215,90,4,>1K
2193,worried,1568,30096571,86.7099824212,90,7,>1K
2194,previously,1567,30098138,86.7144970399,90,10,>1K
2195,emotions,1563,30099701,86.7190001344,90,8,>1K
2196,pizza,1562,30101263,86.7235003478,90,5,>1K
2197,visited,1559,30102822,86.7279919181,90,7,>1K
2198,poetry,1559,30104381,86.7324834883,90,6,>1K
2199,pregnant,1558,30105939,86.7369721775,90,8,>1K
2200,prove,1555,30107494,86.7414522235,90,5,>1K
2201,wisdom,1554,30109048,86.7459293884,90,6,>1K
2202,w,1553,30110601,86.7504036723,90,1,>1K
2203,grey,1552,30112153,86.7548750751,90,4,>1K
2204,programs,1551,30113704,86.7593435969,90,8,>1K
2205,forgot,1549,30115253,86.7638063566,90,6,>1K
2206,existence,1549,30116802,86.7682691162,90,9,>1K
2207,punch,1548,30118350,86.7727289948,90,5,>1K
2208,irish,1546,30119896,86.7771831113,90,5,>1K
2209,active,1545,30121441,86.7816343467,90,6,>1K
2210,host,1545,30122986,86.7860855821,90,4,>1K
2211,determined,1544,30124530,86.7905339365,90,10,>1K
2212,structure,1544,30126074,86.7949822909,90,9,>1K
2213,blame,1543,30127617,86.7994277642,90,5,>1K
2214,acting,1543,30129160,86.8038732375,90,6,>1K
2215,manager,1542,30130702,86.8083158297,90,7,>1K
2216,feed,1541,30132243,86.8127555409,90,4,>1K
2217,smith,1541,30133784,86.8171952521,90,5,>1K
2218,primary,1540,30135324,86.8216320822,90,7,>1K
2219,arts,1539,30136863,86.8260660313,90,4,>1K
2220,drove,1538,30138401,86.8304970993,90,5,>1K
2221,gay,1538,30139939,86.8349281673,90,3,>1K
2222,firm,1538,30141477,86.8393592353,90,4,>1K
2223,ship,1537,30143014,86.8437874222,90,4,>1K
2224,links,1537,30144551,86.8482156092,90,5,>1K
2225,canada,1537,30146088,86.8526437962,90,6,>1K
2226,cups,1536,30147624,86.857069102,90,4,>1K
2227,combination,1535,30149159,86.8614915269,90,11,>1K
2228,hardly,1534,30150693,86.8659110707,90,6,>1K
2229,manner,1532,30152225,86.8703248523,90,6,>1K
2230,laid,1532,30153757,86.874738634,90,4,>1K
2231,shoot,1531,30155288,86.8791495346,90,5,>1K
2232,advantage,1531,30156819,86.8835604352,90,9,>1K
2233,sentiment,1531,30158350,86.8879713358,90,9,>1K
2234,stands,1530,30159880,86.8923793553,90,6,>1K
2235,commercial,1528,30161408,86.8967816127,90,10,>1K
2236,happiness,1528,30162936,86.9011838702,90,9,>1K
2237,critical,1526,30164462,86.9055803655,90,8,>1K
2238,election,1526,30165988,86.9099768608,90,8,>1K
2239,attend,1526,30167514,86.9143733561,90,6,>1K
2240,core,1523,30169037,86.9187612082,90,4,>1K
2241,decent,1520,30170557,86.9231404172,90,6,>1K
2242,prevent,1520,30172077,86.9275196261,90,7,>1K
2243,introduced,1520,30173597,86.9318988351,90,10,>1K
2244,agency,1520,30175117,86.936278044,90,6,>1K
2245,tools,1516,30176633,86.9406457288,90,5,>1K
2246,entered,1516,30178149,86.9450134135,90,7,>1K
2247,forgotten,1516,30179665,86.9493810982,90,9,>1K
2248,designer,1516,30181181,86.9537487829,90,8,>1K
2249,thankful,1515,30182696,86.9581135866,90,8,>1K
2250,adults,1514,30184210,86.9624755092,90,6,>1K
2251,winning,1514,30185724,86.9668374318,90,7,>1K
2252,bodies,1508,30187232,86.9711820681,90,6,>1K
2253,fix,1508,30188740,86.9755267043,90,3,>1K
2254,mood,1504,30190244,86.9798598163,90,4,>1K
2255,italy,1504,30191748,86.9841929284,90,5,>1K
2256,carefully,1504,30193252,86.9885260404,90,9,>1K
2257,encourage,1504,30194756,86.9928591524,90,9,>1K
2258,brief,1503,30196259,86.9971893834,90,5,>1K
2259,silly,1502,30197761,87.0015167333,90,5,>1K
2260,hundred,1502,30199263,87.0058440832,90,7,>1K
2261,systems,1502,30200765,87.0101714331,90,7,>1K
2262,naturally,1500,30202265,87.0144930209,90,9,>1K
2263,appeal,1500,30203765,87.0188146086,90,6,>1K
2264,al,1500,30205265,87.0231361964,90,2,>1K
2265,opportunities,1500,30206765,87.0274577842,90,13,>1K
2266,1500,1500,30208265,87.031779372,90,4,>1K
2267,non,1499,30209764,87.0360980787,90,3,>1K
2268,pleased,1499,30211263,87.0404167855,90,7,>1K
2269,drawn,1498,30212761,87.0447326111,90,5,>1K
2270,novels,1498,30214259,87.0490484368,90,6,>1K
2271,instance,1495,30215754,87.0533556193,90,8,>1K
2272,express,1494,30217248,87.0576599207,90,7,>1K
2273,staying,1492,30218740,87.06195846,90,7,>1K
2274,label,1492,30220232,87.0662569994,90,5,>1K
2275,ages,1492,30221724,87.0705555387,90,4,>1K
2276,boxes,1491,30223215,87.0748511969,90,5,>1K
2277,purchased,1491,30224706,87.0791468552,90,9,>1K
2278,tape,1491,30226197,87.0834425134,90,4,>1K
2279,specifically,1491,30227688,87.0877381717,90,12,>1K
2280,require,1490,30229178,87.0920309489,90,7,>1K
2281,dirty,1490,30230668,87.0963237261,90,5,>1K
2282,constant,1489,30232157,87.1006136222,90,8,>1K
2283,desk,1489,30233646,87.1049035184,90,4,>1K
2284,guitar,1489,30235135,87.1091934145,90,6,>1K
2285,olive,1487,30236622,87.1134775486,90,5,>1K
2286,scared,1486,30238108,87.1177588015,90,6,>1K
2287,shower,1485,30239593,87.1220371734,90,6,>1K
2288,appearance,1485,30241078,87.1263155453,90,10,>1K
2289,belief,1485,30242563,87.1305939172,90,6,>1K
2290,falls,1483,30244046,87.134866527,90,5,>1K
2291,hat,1482,30245528,87.1391362558,90,3,>1K
2292,filling,1482,30247010,87.1434059845,90,7,>1K
2293,escape,1482,30248492,87.1476757132,90,6,>1K
2294,discover,1480,30249972,87.1519396799,90,8,>1K
2295,trail,1480,30251452,87.1562036465,90,5,>1K
2296,friendly,1480,30252932,87.1604676131,90,8,>1K
2297,nine,1478,30254410,87.1647258176,90,4,>1K
2298,excuse,1478,30255888,87.1689840221,90,6,>1K
2299,trial,1478,30257366,87.1732422266,90,5,>1K
2300,brewery,1477,30258843,87.17749755,90,7,>1K
2301,mobile,1473,30260316,87.1817413492,90,6,>1K
2302,h,1473,30261789,87.1859851484,90,1,>1K
2303,failure,1472,30263261,87.1902260666,90,7,>1K
2304,drug,1470,30264731,87.1944612226,90,4,>1K
2305,tool,1470,30266201,87.1986963786,90,4,>1K
2306,asks,1468,30267669,87.2029257726,90,4,>1K
2307,brooklyn,1466,30269135,87.2071494043,90,8,>1K
2308,forest,1465,30270600,87.2113701551,90,6,>1K
2309,repeat,1465,30272065,87.2155909058,90,6,>1K
2310,mrs,1465,30273530,87.2198116566,90,3,>1K
2311,packed,1464,30274994,87.2240295262,90,6,>1K
2312,application,1462,30276456,87.2282416338,90,11,>1K
2313,context,1462,30277918,87.2324537414,90,7,>1K
2314,protection,1461,30279379,87.2366629679,90,10,>1K
2315,neck,1460,30280839,87.2408693133,90,4,>1K
2316,pie,1457,30282296,87.2450670156,90,3,>1K
2317,crying,1455,30283751,87.2492589557,90,6,>1K
2318,score,1452,30285203,87.2534422527,90,5,>1K
2319,mini,1449,30286652,87.2576169065,90,4,>1K
2320,kick,1448,30288100,87.2617886793,90,4,>1K
2321,ms,1448,30289548,87.265960452,90,2,>1K
2322,purple,1447,30290995,87.2701293437,90,6,>1K
2323,shut,1447,30292442,87.2742982354,90,4,>1K
2324,goodness,1447,30293889,87.2784671271,90,8,>1K
2325,customer,1445,30295334,87.2826302566,90,8,>1K
2326,scale,1444,30296778,87.2867905051,90,5,>1K
2327,driver,1444,30298222,87.2909507536,90,6,>1K
2328,package,1442,30299664,87.29510524,90,7,>1K
2329,allowing,1442,30301106,87.2992597264,90,8,>1K
2330,bedroom,1441,30302547,87.3034113318,90,7,>1K
2331,teams,1440,30303987,87.307560056,90,5,>1K
2332,reduce,1439,30305426,87.3117058992,90,6,>1K
2333,boat,1438,30306864,87.3158488614,90,4,>1K
2334,coat,1436,30308300,87.3199860614,90,4,>1K
2335,typical,1435,30309735,87.3241203804,90,7,>1K
2336,heading,1435,30311170,87.3282546994,90,7,>1K
2337,v,1435,30312605,87.3323890184,90,1,>1K
2338,britain,1434,30314039,87.3365204563,90,7,>1K
2339,william,1433,30315472,87.3406490132,90,7,>1K
2340,meanwhile,1432,30316904,87.344774689,90,9,>1K
2341,coast,1431,30318335,87.3488974837,90,5,>1K
2342,crisis,1431,30319766,87.3530202785,90,6,>1K
2343,woke,1431,30321197,87.3571430732,90,4,>1K
2344,quote,1430,30322627,87.3612629869,90,5,>1K
2345,weekly,1430,30324057,87.3653829006,90,6,>1K
2346,combine,1428,30325485,87.3694970522,90,7,>1K
2347,pace,1428,30326913,87.3736112037,90,4,>1K
2348,breaking,1427,30328340,87.3777224743,90,8,>1K
2349,pants,1427,30329767,87.3818337448,90,5,>1K
2350,alternative,1426,30331193,87.3859421342,90,11,>1K
2351,guilty,1426,30332619,87.3900505237,90,6,>1K
2352,citizens,1425,30334044,87.3941560321,90,8,>1K
2353,dealing,1425,30335469,87.3982615405,90,7,>1K
2354,demand,1425,30336894,87.4023670489,90,6,>1K
2355,shirt,1424,30338318,87.4064696762,90,5,>1K
2356,prime,1424,30339742,87.4105723035,90,5,>1K
2357,storm,1424,30341166,87.4146749309,90,5,>1K
2358,helpful,1424,30342590,87.4187775582,90,7,>1K
2359,income,1423,30344013,87.4228773045,90,6,>1K
2360,sam,1418,30345431,87.4269626455,90,3,>1K
2361,importance,1418,30346849,87.4310479865,90,10,>1K
2362,hole,1417,30348266,87.4351304464,90,4,>1K
2363,kingdom,1417,30349683,87.4392129063,90,7,>1K
2364,regardless,1417,30351100,87.4432953663,90,10,>1K
2365,twenty,1416,30352516,87.4473749451,90,6,>1K
2366,communication,1416,30353932,87.451454524,90,13,>1K
2367,flow,1415,30355347,87.4555312218,90,4,>1K
2368,cell,1414,30356761,87.4596050386,90,4,>1K
2369,teeth,1414,30358175,87.4636788553,90,5,>1K
2370,merely,1414,30359589,87.4677526721,90,6,>1K
2371,revealed,1412,30361001,87.4718207267,90,8,>1K
2372,fail,1411,30362412,87.4758859003,90,4,>1K
2373,properly,1411,30363823,87.4799510739,90,8,>1K
2374,millions,1408,30365231,87.4840076043,90,8,>1K
2375,debt,1408,30366639,87.4880641347,90,4,>1K
2376,recognize,1408,30368047,87.4921206651,90,9,>1K
2377,newspaper,1408,30369455,87.4961771955,90,9,>1K
2378,shots,1407,30370862,87.5002308448,90,5,>1K
2379,dressed,1406,30372268,87.5042816131,90,7,>1K
2380,laughing,1406,30373674,87.5083323814,90,8,>1K
2381,featured,1405,30375079,87.5123802686,90,8,>1K
2382,bits,1404,30376483,87.5164252748,90,4,>1K
2383,mistake,1404,30377887,87.5204702809,90,7,>1K
2384,articles,1404,30379291,87.5245152871,90,8,>1K
2385,confidence,1402,30380693,87.5285545312,90,10,>1K
2386,sisters,1402,30382095,87.5325937752,90,7,>1K
2387,editor,1401,30383496,87.5366301382,90,6,>1K
2388,cities,1401,30384897,87.5406665012,90,6,>1K
2389,neighborhood,1401,30386298,87.5447028642,90,12,>1K
2390,honey,1400,30387698,87.5487363461,90,5,>1K
2391,committed,1400,30389098,87.5527698281,90,9,>1K
2392,intended,1400,30390498,87.55680331,90,8,>1K
2393,located,1399,30391897,87.5608339109,90,7,>1K
2394,musical,1398,30393295,87.5648616307,90,7,>1K
2395,silence,1398,30394693,87.5688893505,90,7,>1K
2396,bay,1398,30396091,87.5729170703,90,3,>1K
2397,follows,1397,30397488,87.5769419091,90,7,>1K
2398,deeply,1395,30398883,87.5809609857,90,6,>1K
2399,tale,1395,30400278,87.5849800624,90,4,>1K
2400,professor,1395,30401673,87.588999139,90,9,>1K
2401,kit,1395,30403068,87.5930182156,90,3,>1K
2402,requires,1394,30404462,87.5970344112,90,8,>1K
2403,committee,1394,30405856,87.6010506068,90,9,>1K
2404,values,1394,30407250,87.6050668024,90,6,>1K
2405,sewing,1393,30408643,87.6090801169,90,6,>1K
2406,treated,1392,30410035,87.6130905504,90,7,>1K
2407,christians,1391,30411426,87.6170981028,90,10,>1K
2408,fancy,1391,30412817,87.6211056552,90,5,>1K
2409,tall,1391,30414208,87.6251132076,90,4,>1K
2410,drama,1391,30415599,87.62912076,90,5,>1K
2411,examples,1390,30416989,87.6331254313,90,8,>1K
2412,stated,1389,30418378,87.6371272216,90,6,>1K
2413,hero,1389,30419767,87.6411290119,90,4,>1K
2414,lessons,1388,30421155,87.6451279212,90,7,>1K
2415,pointed,1388,30422543,87.6491268304,90,7,>1K
2416,surgery,1387,30423930,87.6531228586,90,7,>1K
2417,extreme,1386,30425316,87.6571160057,90,7,>1K
2418,lets,1385,30426701,87.6611062717,90,4,>1K
2419,remembered,1382,30428083,87.6650878946,90,10,>1K
2420,holds,1381,30429464,87.6690666364,90,5,>1K
2421,unable,1381,30430845,87.6730453783,90,6,>1K
2422,inner,1380,30432225,87.677021239,90,5,>1K
2423,menu,1379,30433604,87.6809942187,90,4,>1K
2424,exact,1379,30434983,87.6849671984,90,5,>1K
2425,relatively,1379,30436362,87.6889401781,90,10,>1K
2426,necessarily,1377,30437739,87.6929073957,90,11,>1K
2427,wash,1377,30439116,87.6968746133,90,4,>1K
2428,understood,1376,30440492,87.7008389498,90,10,>1K
2429,concern,1375,30441867,87.7048004053,90,7,>1K
2430,muslim,1375,30443242,87.7087618608,90,6,>1K
2431,attacks,1374,30444616,87.7127204352,90,7,>1K
2432,region,1374,30445990,87.7166790096,90,6,>1K
2433,established,1373,30447363,87.720634703,90,11,>1K
2434,senior,1373,30448736,87.7245903963,90,6,>1K
2435,patterns,1372,30450108,87.7285432086,90,8,>1K
2436,debate,1370,30451478,87.7324902588,90,6,>1K
2437,sorts,1370,30452848,87.736437309,90,5,>1K
2438,horrible,1369,30454217,87.7403814781,90,8,>1K
2439,holidays,1369,30455586,87.7443256472,90,8,>1K
2440,discuss,1368,30456954,87.7482669353,90,7,>1K
2441,sadly,1366,30458320,87.7522024612,90,5,>1K
2442,decades,1365,30459685,87.7561351061,90,7,>1K
2443,covers,1365,30461050,87.760067751,90,6,>1K
2444,checked,1364,30462414,87.7639975148,90,7,>1K
2445,darkness,1362,30463776,87.7679215165,90,8,>1K
2446,pub,1362,30465138,87.7718455182,90,3,>1K
2447,fourth,1360,30466498,87.7757637578,90,6,>1K
2448,combined,1359,30467857,87.7796791163,90,8,>1K
2449,pale,1359,30469216,87.7835944749,90,4,>1K
2450,clothing,1359,30470575,87.7875098334,90,8,>1K
2451,seeds,1358,30471933,87.7914223109,90,5,>1K
2452,suit,1358,30473291,87.7953347884,90,4,>1K
2453,invited,1355,30474646,87.7992386227,90,7,>1K
2454,remind,1353,30475999,87.8031366948,90,6,>1K
2455,officer,1352,30477351,87.807031886,90,7,>1K
2456,dying,1351,30478702,87.810924196,90,5,>1K
2457,dishes,1350,30480052,87.814813625,90,6,>1K
2458,reaction,1350,30481402,87.8187030541,90,8,>1K
2459,rarely,1348,30482750,87.8225867209,90,6,>1K
2460,anniversary,1347,30484097,87.8264675068,90,11,>1K
2461,prison,1346,30485443,87.8303454115,90,6,>1K
2462,edges,1346,30486789,87.8342233163,90,5,>1K
2463,australia,1345,30488134,87.83809834,90,9,>1K
2464,exchange,1345,30489479,87.8419733637,90,8,>1K
2465,thomas,1344,30490823,87.8458455064,90,6,>1K
2466,yours,1344,30492167,87.8497176491,90,5,>1K
2467,shame,1344,30493511,87.8535897917,90,5,>1K
2468,threat,1344,30494855,87.8574619344,90,6,>1K
2469,iron,1344,30496199,87.861334077,90,4,>1K
2470,tradition,1341,30497540,87.8651975765,90,9,>1K
2471,capital,1341,30498881,87.869061076,90,7,>1K
2472,anger,1341,30500222,87.8729245755,90,5,>1K
2473,jewish,1339,30501561,87.8767823128,90,6,>1K
2474,supply,1339,30502900,87.8806400502,90,6,>1K
2475,sketch,1337,30504237,87.8844920254,90,6,>1K
2476,boring,1337,30505574,87.8883440007,90,6,>1K
2477,defense,1335,30506909,87.8921902138,90,7,>1K
2478,ad,1334,30508243,87.8960335459,90,2,>1K
2479,pounds,1334,30509577,87.899876878,90,6,>1K
2480,minds,1334,30510911,87.90372021,90,5,>1K
2481,providing,1332,30512243,87.90755778,90,9,>1K
2482,granted,1332,30513575,87.9113953499,90,7,>1K
2483,hubby,1331,30514906,87.9152300388,90,5,>1K
2484,figures,1331,30516237,87.9190647277,90,7,>1K
2485,tag,1331,30517568,87.9228994166,90,3,>1K
2486,ocean,1329,30518897,87.9267283434,90,5,>1K
2487,unit,1329,30520226,87.9305572702,90,4,>1K
2488,riding,1329,30521555,87.934386197,90,6,>1K
2489,employees,1328,30522883,87.9382122427,90,9,>1K
2490,personality,1327,30524210,87.9420354073,90,11,>1K
2491,mirror,1327,30525537,87.945858572,90,6,>1K
2492,numerous,1327,30526864,87.9496817367,90,8,>1K
2493,chopped,1326,30528190,87.9535020203,90,7,>1K
2494,promised,1326,30529516,87.9573223039,90,8,>1K
2495,attached,1326,30530842,87.9611425875,90,8,>1K
2496,contract,1326,30532168,87.9649628711,90,8,>1K
2497,buildings,1325,30533493,87.9687802736,90,9,>1K
2498,labor,1324,30534817,87.9725947951,90,5,>1K
2499,raw,1321,30536138,87.9764006734,90,3,>1K
2500,mainly,1321,30537459,87.9802065517,90,6,>1K
2501,bloggers,1320,30538779,87.984009549,90,8,>1K
2502,vegetables,1320,30540099,87.9878125462,90,10,>1K
2503,measure,1319,30541418,87.9916126624,90,7,>1K
2504,photography,1319,30542737,87.9954127786,90,11,>1K
2505,mike,1319,30544056,87.9992128948,90,4,>1K
2506,http,1318,30545374,88.0030101299,90,4,>1K
2507,puts,1316,30546690,88.006801603,90,4,>1K
2508,ha,1315,30548005,88.0105901949,90,2,>1K
2509,waited,1315,30549320,88.0143787869,90,6,>1K
2510,rolling,1314,30550634,88.0181644978,90,7,>1K
2511,standards,1314,30551948,88.0219502087,90,9,>1K
2512,selection,1313,30553261,88.0257330385,90,9,>1K
2513,colored,1312,30554573,88.0295129873,90,7,>1K
2514,temperature,1312,30555885,88.0332929361,90,11,>1K
2515,depending,1311,30557196,88.0370700038,90,9,>1K
2516,potatoes,1311,30558507,88.0408470715,90,8,>1K
2517,cookie,1310,30559817,88.0446212582,90,6,>1K
2518,billion,1309,30561126,88.0483925638,90,7,>1K
2519,colours,1309,30562435,88.0521638694,90,7,>1K
2520,sending,1309,30563744,88.055935175,90,7,>1K
2521,tight,1306,30565050,88.0596978375,90,5,>1K
2522,genre,1306,30566356,88.0634604999,90,5,>1K
2523,highest,1305,30567661,88.0672202813,90,7,>1K
2524,entertainment,1305,30568966,88.0709800626,90,13,>1K
2525,reference,1305,30570271,88.074739844,90,9,>1K
2526,inch,1304,30571575,88.0784967443,90,4,>1K
2527,writes,1303,30572878,88.0822507636,90,6,>1K
2528,florida,1303,30574181,88.0860047828,90,7,>1K
2529,pride,1302,30575483,88.089755921,90,5,>1K
2530,leg,1301,30576784,88.0935041782,90,3,>1K
2531,occasionally,1301,30578085,88.0972524353,90,12,>1K
2532,chest,1299,30579384,88.1009949303,90,5,>1K
2533,officials,1299,30580683,88.1047374254,90,9,>1K
2534,essential,1297,30581980,88.1084741583,90,9,>1K
2535,explore,1297,30583277,88.1122108912,90,7,>1K
2536,initial,1297,30584574,88.1159476241,90,7,>1K
2537,plane,1297,30585871,88.119684357,90,5,>1K
2538,faster,1296,30587167,88.1234182088,90,6,>1K
2539,construction,1296,30588463,88.1271520607,90,12,>1K
2540,equal,1295,30589758,88.1308830315,90,5,>1K
2541,mum,1294,30591052,88.1346111212,90,3,>1K
2542,abuse,1294,30592346,88.1383392109,90,5,>1K
2543,survive,1294,30593640,88.1420673007,90,7,>1K
2544,healing,1293,30594933,88.1457925093,90,7,>1K
2545,japan,1293,30596226,88.149517718,90,5,>1K
2546,largest,1293,30597519,88.1532429267,90,7,>1K
2547,northern,1293,30598812,88.1569681353,90,8,>1K
2548,patient,1293,30600105,88.160693344,90,7,>1K
2549,contest,1292,30601397,88.1644156716,90,7,>1K
2550,nations,1292,30602689,88.1681379992,90,7,>1K
2551,careful,1292,30603981,88.1718603269,90,7,>1K
2552,corn,1289,30605270,88.1755740113,90,4,>1K
2553,giveaway,1289,30606559,88.1792876957,90,8,>1K
2554,enemy,1289,30607848,88.1830013802,90,5,>1K
2555,valley,1287,30609135,88.1867093025,90,6,>1K
2556,sources,1286,30610421,88.1904143438,90,7,>1K
2557,stopping,1286,30611707,88.194119385,90,8,>1K
2558,connected,1284,30612991,88.1978186642,90,9,>1K
2559,tickets,1283,30614274,88.2015150622,90,7,>1K
2560,moral,1281,30615555,88.2052056982,90,5,>1K
2561,calm,1281,30616836,88.2088963342,90,4,>1K
2562,possibility,1281,30618117,88.2125869702,90,11,>1K
2563,tip,1279,30619396,88.216271844,90,3,>1K
2564,powers,1279,30620675,88.2199567179,90,6,>1K
2565,listed,1279,30621954,88.2236415917,90,6,>1K
2566,hopes,1279,30623233,88.2273264656,90,5,>1K
2567,romantic,1277,30624510,88.2310055773,90,8,>1K
2568,maintain,1277,30625787,88.234684689,90,8,>1K
2569,rooms,1274,30627061,88.2383551576,90,5,>1K
2570,hide,1272,30628333,88.242019864,90,4,>1K
2571,onion,1272,30629605,88.2456845705,90,5,>1K
2572,clients,1272,30630877,88.2493492769,90,7,>1K
2573,administration,1271,30632148,88.2530111023,90,14,>1K
2574,dust,1271,30633419,88.2566729277,90,4,>1K
2575,gospel,1271,30634690,88.2603347531,90,6,>1K
2576,cuts,1269,30635959,88.2639908163,90,4,>1K
2577,situations,1269,30637228,88.2676468796,90,10,>1K
2578,jews,1269,30638497,88.2713029429,90,4,>1K
2579,wave,1269,30639766,88.2749590061,90,4,>1K
2580,labour,1269,30641035,88.2786150694,90,6,>1K
2581,thrown,1268,30642303,88.2822682516,90,6,>1K
2582,communities,1267,30643570,88.2859185528,90,11,>1K
2583,convinced,1267,30644837,88.2895688539,90,9,>1K
2584,catholic,1267,30646104,88.2932191551,90,8,>1K
2585,afford,1266,30647370,88.2968665752,90,6,>1K
2586,nervous,1265,30648635,88.3005111142,90,7,>1K
2587,regularly,1265,30649900,88.3041556532,90,9,>1K
2588,talented,1264,30651164,88.3077973112,90,8,>1K
2589,aspects,1263,30652427,88.3114360881,90,7,>1K
2590,stamped,1263,30653690,88.315074865,90,7,>1K
2591,germany,1263,30654953,88.3187136419,90,7,>1K
2592,picking,1263,30656216,88.3223524189,90,7,>1K
2593,precious,1262,30657478,88.3259883147,90,8,>1K
2594,drugs,1261,30658739,88.3296213295,90,5,>1K
2595,upset,1260,30659999,88.3332514633,90,5,>1K
2596,meals,1256,30661255,88.3368700728,90,5,>1K
2597,pen,1255,30662510,88.3404858012,90,3,>1K
2598,increased,1255,30663765,88.3441015297,90,9,>1K
2599,respond,1254,30665019,88.347714377,90,7,>1K
2600,shadow,1253,30666272,88.3513243434,90,6,>1K
2601,lying,1252,30667524,88.3549314286,90,5,>1K
2602,poem,1252,30668776,88.3585385139,90,4,>1K
2603,disappointed,1250,30670026,88.3621398371,90,12,>1K
2604,leadership,1249,30671275,88.3657382792,90,10,>1K
2605,moves,1249,30672524,88.3693367213,90,5,>1K
2606,conflict,1249,30673773,88.3729351634,90,8,>1K
2607,silent,1248,30675021,88.3765307244,90,6,>1K
2608,shoulder,1248,30676269,88.3801262854,90,8,>1K
2609,guests,1246,30677515,88.3837160844,90,6,>1K
2610,congress,1245,30678760,88.3873030022,90,8,>1K
2611,smoke,1243,30680003,88.390884158,90,5,>1K
2612,vs,1243,30681246,88.3944653137,90,2,>1K
2613,aspect,1242,30682488,88.3980435884,90,6,>1K
2614,divine,1241,30683729,88.401618982,90,6,>1K
2615,officers,1241,30684970,88.4051943757,90,8,>1K
2616,routine,1240,30686210,88.4087668882,90,7,>1K
2617,bob,1240,30687450,88.4123394008,90,3,>1K
2618,pushed,1237,30688687,88.4159032702,90,6,>1K
2619,native,1235,30689922,88.4194613775,90,6,>1K
2620,ears,1235,30691157,88.4230194847,90,4,>1K
2621,tone,1234,30692391,88.426574711,90,4,>1K
2622,grocery,1233,30693624,88.4301270561,90,7,>1K
2623,materials,1233,30694857,88.4336794013,90,9,>1K
2624,request,1233,30696090,88.4372317464,90,7,>1K
2625,steve,1233,30697323,88.4407840916,90,5,>1K
2626,bitter,1233,30698556,88.4443364368,90,6,>1K
2627,rush,1231,30699787,88.4478830198,90,4,>1K
2628,victory,1231,30701018,88.4514296028,90,7,>1K
2629,shift,1231,30702249,88.4549761859,90,5,>1K
2630,stronger,1230,30703479,88.4585198879,90,8,>1K
2631,dollar,1229,30704708,88.4620607088,90,6,>1K
2632,wore,1229,30705937,88.4656015297,90,4,>1K
2633,wrap,1229,30707166,88.4691423507,90,4,>1K
2634,false,1229,30708395,88.4726831716,90,5,>1K
2635,royal,1227,30709622,88.4762182304,90,5,>1K
2636,relief,1227,30710849,88.4797532892,90,6,>1K
2637,angel,1226,30712075,88.4832854669,90,5,>1K
2638,literature,1225,30713300,88.4868147636,90,10,>1K
2639,publisher,1224,30714524,88.4903411793,90,9,>1K
2640,seeking,1223,30715747,88.4938647138,90,7,>1K
2641,kiss,1223,30716970,88.4973882484,90,4,>1K
2642,equally,1221,30718191,88.5009060209,90,7,>1K
2643,executive,1221,30719412,88.5044237933,90,9,>1K
2644,ear,1219,30720631,88.5079358037,90,3,>1K
2645,intense,1219,30721850,88.511447814,90,7,>1K
2646,edition,1219,30723069,88.5149598244,90,7,>1K
2647,lee,1219,30724288,88.5184718347,90,3,>1K
2648,drinks,1218,30725506,88.521980964,90,6,>1K
2649,counter,1216,30726722,88.5254843311,90,7,>1K
2650,greek,1216,30727938,88.5289876983,90,5,>1K
2651,martin,1216,30729154,88.5324910655,90,6,>1K
2652,believes,1215,30730369,88.5359915516,90,8,>1K
2653,wrapped,1215,30731584,88.5394920377,90,7,>1K
2654,contemporary,1215,30732799,88.5429925238,90,12,>1K
2655,criminal,1214,30734013,88.5464901288,90,8,>1K
2656,thousand,1213,30735226,88.5499848528,90,8,>1K
2657,investment,1213,30736439,88.5534795768,90,10,>1K
2658,duty,1213,30737652,88.5569743008,90,4,>1K
2659,finger,1212,30738864,88.5604661437,90,6,>1K
2660,loose,1212,30740076,88.5639579867,90,5,>1K
2661,confused,1212,30741288,88.5674498296,90,8,>1K
2662,corporate,1210,30742498,88.5709359104,90,9,>1K
2663,owners,1210,30743708,88.5744219912,90,6,>1K
2664,gently,1209,30744917,88.577905191,90,6,>1K
2665,celebration,1208,30746125,88.5813855097,90,11,>1K
2666,literary,1208,30747333,88.5848658284,90,8,>1K
2667,noted,1207,30748540,88.588343266,90,5,>1K
2668,parking,1207,30749747,88.5918207037,90,7,>1K
2669,captain,1207,30750954,88.5952981413,90,7,>1K
2670,advance,1207,30752161,88.5987755789,90,7,>1K
2671,concerns,1207,30753368,88.6022530166,90,8,>1K
2672,transfer,1206,30754574,88.6057275732,90,8,>1K
2673,patent,1206,30755780,88.6092021297,90,6,>1K
2674,frank,1206,30756986,88.6126766863,90,5,>1K
2675,draft,1205,30758191,88.6161483618,90,5,>1K
2676,earn,1205,30759396,88.6196200374,90,4,>1K
2677,unknown,1205,30760601,88.6230917129,90,7,>1K
2678,videos,1205,30761806,88.6265633884,90,6,>1K
2679,mothers,1205,30763011,88.6300350639,90,7,>1K
2680,capable,1204,30764215,88.6335038584,90,7,>1K
2681,doctors,1203,30765418,88.6369697718,90,7,>1K
2682,conservative,1203,30766621,88.6404356852,90,12,>1K
2683,scary,1202,30767823,88.6438987175,90,5,>1K
2684,applied,1202,30769025,88.6473617499,90,7,>1K
2685,facing,1202,30770227,88.6508247822,90,6,>1K
2686,tim,1201,30771428,88.6542849335,90,3,>1K
2687,reminds,1201,30772629,88.6577450848,90,7,>1K
2688,perform,1201,30773830,88.6612052361,90,7,>1K
2689,pushing,1200,30775030,88.6646625063,90,7,>1K
2690,businesses,1199,30776229,88.6681168955,90,10,>1K
2691,asleep,1199,30777428,88.6715712847,90,6,>1K
2692,carrying,1199,30778627,88.6750256738,90,8,>1K
2693,talks,1198,30779825,88.6784771819,90,5,>1K
2694,absolute,1198,30781023,88.6819286901,90,8,>1K
2695,awards,1198,30782221,88.6853801982,90,6,>1K
2696,crew,1198,30783419,88.6888317063,90,4,>1K
2697,spanish,1197,30784616,88.6922803333,90,7,>1K
2698,rid,1196,30785812,88.6957260793,90,3,>1K
2699,sentence,1196,30787008,88.6991718253,90,8,>1K
2700,kinda,1195,30788203,88.7026146903,90,5,>1K
2701,boss,1194,30789397,88.7060546741,90,4,>1K
2702,struggling,1194,30790591,88.709494658,90,10,>1K
2703,function,1193,30791784,88.7129317608,90,8,>1K
2704,airport,1192,30792976,88.7163659826,90,7,>1K
2705,frequently,1190,30794166,88.7197944422,90,10,>1K
2706,hi,1190,30795356,88.7232229019,90,2,>1K
2707,italian,1189,30796545,88.7266484805,90,7,>1K
2708,brush,1189,30797734,88.730074059,90,5,>1K
2709,somebody,1188,30798922,88.7334967566,90,8,>1K
2710,appointment,1188,30800110,88.7369194541,90,11,>1K
2711,intelligence,1188,30801298,88.7403421516,90,12,>1K
2712,expecting,1188,30802486,88.7437648492,90,9,>1K
2713,struck,1188,30803674,88.7471875467,90,6,>1K
2714,stomach,1188,30804862,88.7506102442,90,7,>1K
2715,organic,1187,30806049,88.7540300607,90,7,>1K
2716,bands,1185,30807234,88.757444115,90,5,>1K
2717,cats,1185,30808419,88.7608581694,90,4,>1K
2718,suspect,1185,30809604,88.7642722237,90,7,>1K
2719,tries,1182,30810786,88.7676776349,90,5,>1K
2720,participate,1182,30811968,88.7710830461,90,11,>1K
2721,causes,1182,30813150,88.7744884573,90,6,>1K
2722,inches,1182,30814332,88.7778938684,90,6,>1K
2723,equipment,1182,30815514,88.7812992796,90,9,>1K
2724,developing,1182,30816696,88.7847046908,90,10,>1K
2725,comedy,1181,30817877,88.7881072209,90,6,>1K
2726,arrive,1181,30819058,88.791509751,90,6,>1K
2727,luckily,1181,30820239,88.7949122811,90,7,>1K
2728,answered,1180,30821419,88.7983119302,90,8,>1K
2729,vast,1180,30822599,88.8017115792,90,4,>1K
2730,awareness,1180,30823779,88.8051112283,90,9,>1K
2731,era,1179,30824958,88.8085079963,90,3,>1K
2732,expectations,1178,30826136,88.8119018832,90,12,>1K
2733,printed,1178,30827314,88.8152957702,90,7,>1K
2734,emergency,1177,30828491,88.8186867761,90,9,>1K
2735,richard,1177,30829668,88.822077782,90,7,>1K
2736,blend,1177,30830845,88.8254687878,90,5,>1K
2737,file,1176,30832021,88.8288569127,90,4,>1K
2738,decade,1175,30833196,88.8322421564,90,6,>1K
2739,bush,1175,30834371,88.8356274002,90,4,>1K
2740,recorded,1175,30835546,88.839012644,90,8,>1K
2741,attended,1174,30836720,88.8423950067,90,8,>1K
2742,ultimate,1174,30837894,88.8457773694,90,8,>1K
2743,route,1174,30839068,88.8491597321,90,5,>1K
2744,victims,1173,30840241,88.8525392137,90,7,>1K
2745,chain,1173,30841414,88.8559186954,90,5,>1K
2746,comic,1172,30842586,88.859295296,90,5,>1K
2747,threw,1172,30843758,88.8626718966,90,5,>1K
2748,imagination,1171,30844929,88.8660456161,90,11,>1K
2749,followers,1171,30846100,88.8694193356,90,9,>1K
2750,estate,1170,30847270,88.8727901741,90,6,>1K
2751,hungry,1169,30848439,88.8761581315,90,6,>1K
2752,rough,1169,30849608,88.8795260889,90,5,>1K
2753,ministry,1168,30850776,88.8828911653,90,8,>1K
2754,agreement,1166,30851942,88.8862504795,90,9,>1K
2755,shops,1166,30853108,88.8896097938,90,5,>1K
2756,pregnancy,1165,30854273,88.8929662269,90,9,>1K
2757,awful,1165,30855438,88.8963226601,90,5,>1K
2758,publishers,1165,30856603,88.8996790933,90,10,>1K
2759,description,1165,30857768,88.9030355265,90,11,>1K
2760,lips,1165,30858933,88.9063919597,90,4,>1K
2761,daddy,1164,30860097,88.9097455118,90,5,>1K
2762,crap,1164,30861261,88.9130990639,90,4,>1K
2763,occasion,1162,30862423,88.9164468539,90,8,>1K
2764,searching,1161,30863584,88.9197917629,90,9,>1K
2765,bars,1161,30864745,88.9231366718,90,4,>1K
2766,owned,1160,30865905,88.9264786997,90,5,>1K
2767,quilt,1157,30867062,88.9298120844,90,5,>1K
2768,sharp,1157,30868219,88.9331454691,90,5,>1K
2769,chips,1156,30869375,88.9364759728,90,5,>1K
2770,deeper,1156,30870531,88.9398064764,90,6,>1K
2771,amongst,1155,30871686,88.943134099,90,7,>1K
2772,worn,1154,30872840,88.9464588405,90,4,>1K
2773,boyfriend,1153,30873993,88.949780701,90,9,>1K
2774,ridiculous,1153,30875146,88.9531025615,90,10,>1K
2775,gallery,1152,30876298,88.9564215409,90,7,>1K
2776,banks,1151,30877449,88.9597376393,90,5,>1K
2777,replied,1151,30878600,88.9630537376,90,7,>1K
2778,winners,1151,30879751,88.966369836,90,7,>1K
2779,dedicated,1151,30880902,88.9696859344,90,9,>1K
2780,settled,1151,30882053,88.9730020327,90,7,>1K
2781,split,1150,30883203,88.97631525,90,5,>1K
2782,ideal,1149,30884352,88.9796255863,90,5,>1K
2783,recall,1149,30885501,88.9829359225,90,6,>1K
2784,mistakes,1149,30886650,88.9862462588,90,8,>1K
2785,expression,1149,30887799,88.989556595,90,10,>1K
2786,bottles,1148,30888947,88.9928640502,90,7,>1K
2787,unusual,1148,30890095,88.9961715054,90,7,>1K
2788,outfit,1148,30891243,88.9994789606,90,6,>1K
2789,fallen,1147,30892390,89.0027835347,90,6,>1K
2790,sand,1147,30893537,89.0060881088,90,4,>1K
2791,curious,1145,30894682,89.0093869208,90,7,>1K
2792,tracks,1145,30895827,89.0126857328,90,6,>1K
2793,chances,1144,30896971,89.0159816638,90,7,>1K
2794,sake,1144,30898115,89.0192775947,90,4,>1K
2795,wealth,1143,30899258,89.0225706446,90,6,>1K
2796,coach,1142,30900400,89.0258608135,90,5,>1K
2797,organized,1142,30901542,89.0291509823,90,9,>1K
2798,essentially,1141,30902683,89.0324382701,90,11,>1K
2799,shooting,1140,30903823,89.0357226768,90,8,>1K
2800,entries,1140,30904963,89.0390070835,90,7,>1K
2801,upper,1139,30906102,89.0422886092,90,5,>1K
2802,housing,1138,30907240,89.0455672538,90,7,>1K
2803,definition,1138,30908378,89.0488458984,90,10,>1K
2804,nurse,1137,30909515,89.0521216619,90,5,>1K
2805,commission,1136,30910651,89.0553945444,90,10,>1K
2806,hits,1134,30911785,89.0586616648,90,4,>1K
2807,truck,1134,30912919,89.0619287851,90,5,>1K
2808,fridge,1134,30914053,89.0651959055,90,6,>1K
2809,excitement,1133,30915186,89.0684601448,90,10,>1K
2810,typically,1132,30916318,89.0717215031,90,9,>1K
2811,boots,1131,30917449,89.0749799802,90,5,>1K
2812,rising,1131,30918580,89.0782384574,90,6,>1K
2813,uncle,1131,30919711,89.0814969346,90,5,>1K
2814,zone,1131,30920842,89.0847554118,90,4,>1K
2815,weak,1131,30921973,89.088013889,90,4,>1K
2816,santa,1130,30923103,89.0912694851,90,5,>1K
2817,ben,1130,30924233,89.0945250813,90,3,>1K
2818,accident,1129,30925362,89.0977777963,90,8,>1K
2819,choosing,1129,30926491,89.1010305114,90,8,>1K
2820,turkey,1129,30927620,89.1042832265,90,6,>1K
2821,warning,1129,30928749,89.1075359416,90,7,>1K
2822,ordinary,1128,30929877,89.1107857756,90,8,>1K
2823,worship,1128,30931005,89.1140356096,90,7,>1K
2824,liquid,1127,30932132,89.1172825626,90,6,>1K
2825,urban,1127,30933259,89.1205295155,90,5,>1K
2826,tomatoes,1127,30934386,89.1237764685,90,8,>1K
2827,ignore,1127,30935513,89.1270234214,90,6,>1K
2828,checking,1124,30936637,89.1302617312,90,8,>1K
2829,strategy,1123,30937760,89.1334971599,90,8,>1K
2830,midnight,1123,30938883,89.1367325886,90,8,>1K
2831,laughed,1123,30940006,89.1399680174,90,7,>1K
2832,mommy,1123,30941129,89.1432034461,90,5,>1K
2833,refused,1123,30942252,89.1464388748,90,7,>1K
2834,pulling,1121,30943373,89.1496685414,90,7,>1K
2835,joke,1120,30944493,89.152895327,90,4,>1K
2836,supplies,1120,30945613,89.1561221125,90,8,>1K
2837,fault,1117,30946730,89.1593402549,90,5,>1K
2838,impressed,1117,30947847,89.1625583973,90,9,>1K
2839,burn,1114,30948961,89.1657678965,90,4,>1K
2840,wings,1114,30950075,89.1689773956,90,5,>1K
2841,bet,1112,30951187,89.1721811327,90,3,>1K
2842,goods,1112,30952299,89.1753848698,90,5,>1K
2843,portion,1111,30953410,89.1785857258,90,7,>1K
2844,impression,1111,30954521,89.1817865818,90,10,>1K
2845,aid,1109,30955630,89.1849816757,90,3,>1K
2846,blind,1109,30956739,89.1881767697,90,5,>1K
2847,impressive,1109,30957848,89.1913718636,90,10,>1K
2848,latter,1107,30958955,89.1945611953,90,6,>1K
2849,charles,1107,30960062,89.1977505271,90,7,>1K
2850,quarter,1106,30961168,89.2009369779,90,7,>1K
2851,deserve,1106,30962274,89.2041234286,90,7,>1K
2852,opinions,1106,30963380,89.2073098793,90,8,>1K
2853,replaced,1106,30964486,89.21049633,90,8,>1K
2854,jim,1106,30965592,89.2136827808,90,3,>1K
2855,species,1106,30966698,89.2168692315,90,7,>1K
2856,affect,1105,30967803,89.2200528012,90,6,>1K
2857,contains,1105,30968908,89.2232363708,90,8,>1K
2858,texture,1104,30970012,89.2264170594,90,7,>1K
2859,baked,1103,30971115,89.229594867,90,5,>1K
2860,rates,1103,30972218,89.2327726745,90,5,>1K
2861,reveal,1103,30973321,89.2359504821,90,6,>1K
2862,couch,1103,30974424,89.2391282896,90,5,>1K
2863,danger,1102,30975526,89.2423032161,90,6,>1K
2864,beef,1101,30976627,89.2454752616,90,4,>1K
2865,fascinating,1101,30977728,89.248647307,90,11,>1K
2866,voices,1100,30978828,89.2518164714,90,6,>1K
2867,sarah,1099,30979927,89.2549827547,90,5,>1K
2868,blow,1099,30981026,89.258149038,90,4,>1K
2869,drew,1099,30982125,89.2613153213,90,4,>1K
2870,vehicle,1098,30983223,89.2644787236,90,7,>1K
2871,claimed,1098,30984321,89.2676421259,90,7,>1K
2872,pile,1097,30985418,89.2708026471,90,4,>1K
2873,net,1097,30986515,89.2739631683,90,3,>1K
2874,forgive,1097,30987612,89.2771236895,90,7,>1K
2875,volume,1095,30988707,89.2802784485,90,6,>1K
2876,boil,1095,30989802,89.2834332076,90,4,>1K
2877,furniture,1095,30990897,89.2865879667,90,9,>1K
2878,fields,1094,30991991,89.2897398447,90,6,>1K
2879,minor,1094,30993085,89.2928917228,90,5,>1K
2880,upcoming,1094,30994179,89.2960436008,90,8,>1K
2881,bite,1094,30995273,89.2991954788,90,4,>1K
2882,temple,1093,30996366,89.3023444758,90,6,>1K
2883,delivered,1093,30997459,89.3054934727,90,9,>1K
2884,hence,1093,30998552,89.3086424697,90,5,>1K
2885,ah,1092,30999644,89.3117885856,90,2,>1K
2886,reflect,1091,31000735,89.3149318205,90,7,>1K
2887,closet,1091,31001826,89.3180750553,90,6,>1K
2888,technique,1091,31002917,89.3212182902,90,9,>1K
2889,wise,1090,31004007,89.324358644,90,4,>1K
2890,eu,1089,31005096,89.3274961167,90,2,>1K
2891,jeans,1089,31006185,89.3306335894,90,5,>1K
2892,debut,1089,31007274,89.3337710622,90,5,>1K
2893,informed,1088,31008362,89.3369056538,90,8,>1K
2894,ticket,1087,31009449,89.3400373644,90,6,>1K
2895,chase,1087,31010536,89.3431690751,90,5,>1K
2896,ireland,1087,31011623,89.3463007857,90,7,>1K
2897,saving,1087,31012710,89.3494324963,90,6,>1K
2898,adorable,1085,31013795,89.3525584448,90,8,>1K
2899,presents,1084,31014879,89.3556815122,90,8,>1K
2900,officially,1084,31015963,89.3588045797,90,10,>1K
2901,software,1084,31017047,89.3619276471,90,8,>1K
2902,shake,1084,31018131,89.3650507146,90,5,>1K
2903,opposition,1083,31019214,89.3681709009,90,10,>1K
2904,nuclear,1082,31020296,89.3712882063,90,7,>1K
2905,www,1081,31021377,89.3744026305,90,3,>1K
2906,supporting,1080,31022457,89.3775141737,90,10,>1K
2907,spray,1080,31023537,89.3806257169,90,5,>1K
2908,woods,1080,31024617,89.3837372601,90,5,>1K
2909,wondered,1080,31025697,89.3868488033,90,8,>1K
2910,humanity,1079,31026776,89.3899574655,90,8,>1K
2911,panel,1078,31027854,89.3930632466,90,5,>1K
2912,identify,1078,31028932,89.3961690277,90,8,>1K
2913,map,1078,31030010,89.3992748088,90,3,>1K
2914,attempts,1077,31031087,89.4023777088,90,8,>1K
2915,surrounding,1077,31032164,89.4054806088,90,11,>1K
2916,mountains,1077,31033241,89.4085835088,90,9,>1K
2917,largely,1076,31034317,89.4116835278,90,7,>1K
2918,revolution,1076,31035393,89.4147835468,90,10,>1K
2919,thanksgiving,1075,31036468,89.4178806847,90,12,>1K
2920,creativity,1075,31037543,89.4209778226,90,10,>1K
2921,nearby,1073,31038616,89.4240691984,90,6,>1K
2922,stretch,1073,31039689,89.4271605742,90,7,>1K
2923,harry,1073,31040762,89.43025195,90,5,>1K
2924,determine,1073,31041835,89.4333433258,90,9,>1K
2925,pasta,1073,31042908,89.4364347016,90,5,>1K
2926,tied,1072,31043980,89.4395231963,90,4,>1K
2927,opposed,1072,31045052,89.4426116911,90,7,>1K
2928,creations,1072,31046124,89.4457001858,90,9,>1K
2929,thankfully,1071,31047195,89.4487857995,90,10,>1K
2930,formed,1071,31048266,89.4518714132,90,6,>1K
2931,flesh,1070,31049336,89.4549541458,90,5,>1K
2932,sir,1070,31050406,89.4580368784,90,3,>1K
2933,princess,1068,31051474,89.4611138489,90,8,>1K
2934,frozen,1067,31052541,89.4641879384,90,6,>1K
2935,limit,1066,31053607,89.4672591467,90,5,>1K
2936,suggests,1066,31054673,89.4703303551,90,8,>1K
2937,concert,1066,31055739,89.4734015635,90,7,>1K
2938,toys,1065,31056804,89.4764698908,90,4,>1K
2939,liberal,1064,31057868,89.4795353371,90,7,>1K
2940,noise,1063,31058931,89.4825979023,90,5,>1K
2941,ii,1062,31059993,89.4856575865,90,2,>1K
2942,conclusion,1062,31061055,89.4887172706,90,10,>1K
2943,magical,1061,31062116,89.4917740737,90,7,>1K
2944,pet,1061,31063177,89.4948308768,90,3,>1K
2945,relevant,1061,31064238,89.4978876799,90,8,>1K
2946,islam,1061,31065299,89.500944483,90,5,>1K
2947,laundry,1060,31066359,89.503998405,90,7,>1K
2948,factor,1060,31067419,89.5070523271,90,6,>1K
2949,lightly,1060,31068479,89.5101062491,90,7,>1K
2950,suffer,1060,31069539,89.5131601712,90,6,>1K
2951,jones,1059,31070598,89.5162112121,90,5,>1K
2952,grandmother,1058,31071656,89.519259372,90,11,>1K
2953,cried,1057,31072713,89.5223046509,90,5,>1K
2954,sudden,1056,31073769,89.5253470487,90,6,>1K
2955,challenging,1056,31074825,89.5283894465,90,11,>1K
2956,layout,1056,31075881,89.5314318443,90,6,>1K
2957,policies,1055,31076936,89.5344713611,90,8,>1K
2958,ugly,1055,31077991,89.5375108778,90,4,>1K
2959,discussed,1054,31079045,89.5405475135,90,9,>1K
2960,angels,1054,31080099,89.5435841492,90,6,>1K
2961,grant,1054,31081153,89.5466207848,90,5,>1K
2962,confident,1054,31082207,89.5496574205,90,9,>1K
2963,electric,1054,31083261,89.5526940562,90,8,>1K
2964,gym,1053,31084314,89.5557278108,90,3,>1K
2965,wooden,1052,31085366,89.5587586844,90,6,>1K
2966,faced,1052,31086418,89.561789558,90,5,>1K
2967,soldiers,1052,31087470,89.5648204315,90,8,>1K
2968,nicely,1052,31088522,89.5678513051,90,6,>1K
2969,adds,1051,31089573,89.5708792976,90,4,>1K
2970,technical,1051,31090624,89.5739072901,90,9,>1K
2971,lazy,1050,31091674,89.5769324016,90,4,>1K
2972,mexico,1050,31092724,89.579957513,90,6,>1K
2973,argue,1050,31093774,89.5829826245,90,5,>1K
2974,channel,1049,31094823,89.5860048549,90,7,>1K
2975,destroy,1049,31095872,89.5890270853,90,7,>1K
2976,recommended,1049,31096921,89.5920493157,90,11,>1K
2977,restaurants,1047,31097968,89.5950657839,90,11,>1K
2978,handed,1047,31099015,89.5980822522,90,6,>1K
2979,prince,1045,31100060,89.6010929584,90,6,>1K
2980,grabbed,1044,31101104,89.6041007835,90,7,>1K
2981,sport,1044,31102148,89.6071086086,90,5,>1K
2982,romney,1044,31103192,89.6101164337,90,6,>1K
2983,tower,1043,31104235,89.6131213777,90,5,>1K
2984,henry,1043,31105278,89.6161263217,90,5,>1K
2985,depth,1043,31106321,89.6191312658,90,5,>1K
2986,app,1042,31107363,89.6221333288,90,3,>1K
2987,receiving,1042,31108405,89.6251353917,90,9,>1K
2988,carolina,1042,31109447,89.6281374547,90,8,>1K
2989,breaks,1042,31110489,89.6311395177,90,6,>1K
2990,dessert,1042,31111531,89.6341415807,90,7,>1K
2991,unto,1041,31112572,89.6371407626,90,4,>1K
2992,layers,1041,31113613,89.6401399445,90,6,>1K
2993,hung,1041,31114654,89.6431391265,90,4,>1K
2994,clock,1041,31115695,89.6461383084,90,5,>1K
2995,garage,1040,31116735,89.6491346092,90,6,>1K
2996,bath,1039,31117774,89.6521280291,90,4,>1K
2997,operation,1039,31118813,89.6551214489,90,9,>1K
2998,beloved,1039,31119852,89.6581148687,90,7,>1K
2999,agents,1038,31120890,89.6611054074,90,6,>1K
3000,dining,1038,31121928,89.6640959462,90,6,>1K
3001,category,1037,31122965,89.6670836039,90,8,>1K
3002,practical,1037,31124002,89.6700712615,90,9,>1K
3003,seed,1037,31125039,89.6730589192,90,4,>1K
3004,arrested,1037,31126076,89.6760465769,90,8,>1K
3005,onions,1037,31127113,89.6790342346,90,6,>1K
3006,violent,1036,31128149,89.6820190112,90,7,>1K
3007,motion,1036,31129185,89.6850037879,90,6,>1K
3008,walks,1035,31130220,89.6879856834,90,5,>1K
3009,tomato,1035,31131255,89.690967579,90,6,>1K
3010,hoped,1035,31132290,89.6939494746,90,5,>1K
3011,pork,1035,31133325,89.6969313702,90,4,>1K
3012,victim,1033,31134358,89.6999075036,90,6,>1K
3013,shortly,1033,31135391,89.7028836371,90,7,>1K
3014,environmental,1033,31136424,89.7058597705,90,13,>1K
3015,sunny,1033,31137457,89.708835904,90,5,>1K
3016,replace,1033,31138490,89.7118120374,90,7,>1K
3017,rolled,1032,31139522,89.7147852898,90,6,>1K
3018,finishing,1031,31140553,89.7177556612,90,9,>1K
3019,proof,1031,31141584,89.7207260325,90,5,>1K
3020,cycle,1030,31142614,89.7236935228,90,5,>1K
3021,bell,1030,31143644,89.7266610131,90,4,>1K
3022,info,1030,31144674,89.7296285033,90,4,>1K
3023,praise,1030,31145704,89.7325959936,90,6,>1K
3024,philosophy,1030,31146734,89.7355634839,90,10,>1K
3025,represent,1030,31147764,89.7385309742,90,9,>1K
3026,messages,1029,31148793,89.7414955834,90,8,>1K
3027,commitment,1028,31149821,89.7444573116,90,10,>1K
3028,occurred,1028,31150849,89.7474190397,90,8,>1K
3029,alex,1027,31151876,89.7503778868,90,4,>1K
3030,organizations,1027,31152903,89.7533367339,90,13,>1K
3031,element,1026,31153929,89.7562927,90,7,>1K
3032,pocket,1025,31154954,89.759245785,90,6,>1K
3033,causing,1024,31155978,89.7621959889,90,7,>1K
3034,remained,1024,31157002,89.7651461928,90,8,>1K
3035,screaming,1024,31158026,89.7680963968,90,9,>1K
3036,usa,1024,31159050,89.7710466007,90,3,>1K
3037,pics,1023,31160073,89.7739939236,90,4,>1K
3038,burning,1023,31161096,89.7769412464,90,7,>1K
3039,importantly,1023,31162119,89.7798885693,90,11,>1K
3040,politicians,1023,31163142,89.7828358922,90,11,>1K
3041,storage,1023,31164165,89.785783215,90,7,>1K
3042,wars,1022,31165187,89.7887276569,90,4,>1K
3043,increasing,1021,31166208,89.7916692176,90,10,>1K
3044,narrative,1021,31167229,89.7946107784,90,9,>1K
3045,recording,1021,31168250,89.7975523391,90,9,>1K
3046,extent,1021,31169271,89.8004938999,90,6,>1K
3047,baseball,1020,31170291,89.8034325796,90,8,>1K
3048,mere,1019,31171310,89.8063683782,90,4,>1K
3049,subtle,1019,31172329,89.8093041768,90,6,>1K
3050,painful,1019,31173348,89.8122399755,90,7,>1K
3051,lifestyle,1018,31174366,89.815172893,90,9,>1K
3052,phrase,1018,31175384,89.8181058106,90,6,>1K
3053,throwing,1017,31176401,89.8210358471,90,8,>1K
3054,initially,1017,31177418,89.8239658837,90,9,>1K
3055,reasonable,1016,31178434,89.8268930391,90,10,>1K
3056,blocks,1015,31179449,89.8298173135,90,6,>1K
3057,scott,1014,31180463,89.8327387069,90,5,>1K
3058,nuts,1014,31181477,89.8356601002,90,4,>1K
3059,potato,1013,31182490,89.8385786125,90,6,>1K
3060,complicated,1012,31183502,89.8414942437,90,11,>1K
3061,taxes,1012,31184514,89.8444098749,90,5,>1K
3062,promote,1011,31185525,89.8473226251,90,7,>1K
3063,jane,1010,31186535,89.8502324942,90,4,>1K
3064,favorites,1010,31187545,89.8531423633,90,9,>1K
3065,landscape,1010,31188555,89.8560522324,90,9,>1K
3066,users,1010,31189565,89.8589621015,90,5,>1K
3067,increasingly,1009,31190574,89.8618690896,90,12,>1K
3068,drunk,1009,31191583,89.8647760776,90,5,>1K
3069,youtube,1008,31192591,89.8676801846,90,7,>1K
3070,resist,1007,31193598,89.8705814106,90,6,>1K
3071,balls,1007,31194605,89.8734826365,90,5,>1K
3072,illegal,1006,31195611,89.8763809814,90,7,>1K
3073,gray,1006,31196617,89.8792793263,90,4,>1K
3074,eaten,1006,31197623,89.8821776711,90,5,>1K
3075,tons,1005,31198628,89.885073135,90,4,>1K
3076,crossed,1005,31199633,89.8879685988,90,7,>1K
3077,funds,1005,31200638,89.8908640626,90,5,>1K
3078,exception,1005,31201643,89.8937595264,90,9,>1K
3079,dozen,1004,31202647,89.8966521092,90,5,>1K
3080,markets,1004,31203651,89.8995446919,90,7,>1K
3081,strike,1004,31204655,89.9024372747,90,6,>1K
3082,cd,1003,31205658,89.9053269764,90,2,>1K
3083,endless,1003,31206661,89.9082166781,90,7,>1K
3084,object,1003,31207664,89.9111063798,90,6,>1K
3085,dried,1002,31208666,89.9139932004,90,5,>1K
3086,patients,1002,31209668,89.9168800211,90,8,>1K
3087,copies,1001,31210669,89.9197639606,90,6,>1K
3088,1000,1000,31211669,89.9226450192,90,4,>100
3089,consequences,1000,31212669,89.9255260777,90,12,>100
3090,tastes,998,31213667,89.9284013741,90,6,>100
3091,connect,998,31214665,89.9312766705,90,7,>100
3092,stash,997,31215662,89.9341490858,90,5,>100
3093,tsp,997,31216659,89.9370215012,90,3,>100
3094,dates,997,31217656,89.9398939165,90,5,>100
3095,roof,996,31218652,89.9427634508,90,4,>100
3096,immediate,996,31219648,89.9456329851,90,9,>100
3097,surrounded,996,31220644,89.9485025194,90,10,>100
3098,theatre,996,31221640,89.9513720537,90,7,>100
3099,muslims,995,31222635,89.9542387069,90,7,>100
3100,atmosphere,995,31223630,89.9571053602,90,10,>100
3101,ghost,993,31224623,89.9599662513,90,5,>100
3102,device,993,31225616,89.9628271424,90,6,>100
3103,coconut,993,31226609,89.9656880335,90,7,>100
3104,sunshine,992,31227601,89.9685460436,90,8,>100
3105,innocent,992,31228593,89.9714040536,90,8,>100
3106,featuring,991,31229584,89.9742591826,90,9,>100
3107,lists,990,31230574,89.9771114306,90,5,>100
3108,orders,990,31231564,89.9799636785,90,6,>100
3109,friendship,989,31232553,89.9828130454,90,10,>100
3110,instructions,989,31233542,89.9856624123,90,12,>100
3111,client,989,31234531,89.9885117791,90,6,>100
3112,differences,989,31235520,89.991361146,_100,11,>100
3113,deliver,988,31236508,89.9942076318,_100,7,>100
3114,flash,988,31237496,89.9970541177,_100,5,>100
3115,reads,988,31238484,89.9999006035,_100,5,>100
3116,incident,987,31239471,90.0027442082,_100,8,>100
3117,thrilled,986,31240457,90.0055849319,_100,8,>100
3118,eastern,985,31241442,90.0084227746,_100,7,>100
3119,visual,985,31242427,90.0112606172,_100,6,>100
3120,stops,984,31243411,90.0140955788,_100,5,>100
3121,hunt,984,31244395,90.0169305404,_100,4,>100
3122,suffered,984,31245379,90.019765502,_100,8,>100
3123,eve,983,31246362,90.0225975825,_100,3,>100
3124,favor,982,31247344,90.025426782,_100,5,>100
3125,depression,982,31248326,90.0282559815,_100,10,>100
3126,shock,982,31249308,90.0310851809,_100,5,>100
3127,cardstock,981,31250289,90.0339114994,_100,9,>100
3128,beliefs,981,31251270,90.0367378178,_100,7,>100
3129,therapy,979,31252249,90.0395583741,_100,7,>100
3130,hunger,979,31253228,90.0423789304,_100,6,>100
3131,contrast,978,31254206,90.0451966056,_100,8,>100
3132,verse,978,31255184,90.0480142808,_100,5,>100
3133,beings,978,31256162,90.0508319561,_100,6,>100
3134,valuable,978,31257140,90.0536496313,_100,8,>100
3135,extended,977,31258117,90.0564644255,_100,8,>100
3136,slight,977,31259094,90.0592792197,_100,6,>100
3137,existing,976,31260070,90.0620911328,_100,8,>100
3138,residents,976,31261046,90.0649030459,_100,9,>100
3139,worthy,975,31262021,90.067712078,_100,6,>100
3140,listened,975,31262996,90.07052111,_100,8,>100
3141,creates,975,31263971,90.0733301421,_100,7,>100
3142,guard,975,31264946,90.0761391741,_100,5,>100
3143,performed,975,31265921,90.0789482062,_100,9,>100
3144,climate,974,31266895,90.0817543572,_100,7,>100
3145,medicine,974,31267869,90.0845605082,_100,8,>100
3146,emails,974,31268843,90.0873666592,_100,6,>100
3147,adventures,973,31269816,90.0901699292,_100,10,>100
3148,differently,973,31270789,90.0929731991,_100,11,>100
3149,models,972,31271761,90.095773588,_100,6,>100
3150,seemingly,972,31272733,90.0985739769,_100,9,>100
3151,democratic,971,31273704,90.1013714847,_100,10,>100
3152,andrew,971,31274675,90.1041689925,_100,6,>100
3153,killer,970,31275645,90.1069636193,_100,6,>100
3154,scheduled,970,31276615,90.1097582461,_100,9,>100
3155,slice,970,31277585,90.1125528728,_100,5,>100
3156,wolf,970,31278555,90.1153474996,_100,4,>100
3157,dave,970,31279525,90.1181421264,_100,4,>100
3158,load,969,31280494,90.1209338721,_100,4,>100
3159,trips,969,31281463,90.1237256178,_100,5,>100
3160,joining,969,31282432,90.1265173635,_100,7,>100
3161,physically,968,31283400,90.1293062281,_100,10,>100
3162,suggestions,968,31284368,90.1320950928,_100,11,>100
3163,witness,967,31285335,90.1348810764,_100,7,>100
3164,actor,967,31286302,90.13766706,_100,5,>100
3165,embrace,966,31287268,90.1404501625,_100,7,>100
3166,singer,964,31288232,90.1432275029,_100,6,>100
3167,surprisingly,964,31289196,90.1460048433,_100,12,>100
3168,directed,963,31290159,90.1487793027,_100,8,>100
3169,tests,963,31291122,90.1515537621,_100,5,>100
3170,conversations,963,31292085,90.1543282214,_100,13,>100
3171,explains,961,31293046,90.1570969187,_100,8,>100
3172,bond,961,31294007,90.1598656159,_100,4,>100
3173,supreme,960,31294967,90.1626314321,_100,7,>100
3174,feedback,960,31295927,90.1653972483,_100,8,>100
3175,fried,959,31296886,90.1681601834,_100,5,>100
3176,badly,958,31297844,90.1709202375,_100,5,>100
3177,eternal,958,31298802,90.1736802915,_100,7,>100
3178,cupcakes,957,31299759,90.1764374645,_100,8,>100
3179,driven,957,31300716,90.1791946375,_100,6,>100
3180,encouraged,957,31301673,90.1819518106,_100,10,>100
3181,hollywood,957,31302630,90.1847089836,_100,9,>100
3182,bones,956,31303586,90.1874632755,_100,5,>100
3183,spoken,956,31304542,90.1902175675,_100,6,>100
3184,trend,956,31305498,90.1929718594,_100,5,>100
3185,studying,955,31306453,90.1957232703,_100,8,>100
3186,dies,955,31307408,90.1984746812,_100,4,>100
3187,awhile,954,31308362,90.201223211,_100,6,>100
3188,charged,953,31309315,90.2039688598,_100,7,>100
3189,beneath,953,31310268,90.2067145086,_100,7,>100
3190,explanation,953,31311221,90.2094601573,_100,11,>100
3191,blessing,952,31312173,90.2122029251,_100,8,>100
3192,downtown,952,31313125,90.2149456928,_100,8,>100
3193,monster,952,31314077,90.2176884605,_100,7,>100
3194,gods,952,31315029,90.2204312282,_100,4,>100
3195,tender,951,31315980,90.2231711149,_100,6,>100
3196,closely,951,31316931,90.2259110015,_100,7,>100
3197,happily,950,31317881,90.2286480071,_100,7,>100
3198,dialogue,949,31318830,90.2313821316,_100,8,>100
3199,sons,949,31319779,90.2341162562,_100,4,>100
3200,adam,949,31320728,90.2368503807,_100,4,>100
3201,seasons,948,31321676,90.2395816242,_100,7,>100
3202,humor,948,31322624,90.2423128677,_100,5,>100
3203,meets,948,31323572,90.2450441112,_100,5,>100
3204,tables,948,31324520,90.2477753546,_100,6,>100
3205,bother,948,31325468,90.2505065981,_100,6,>100
3206,bonus,947,31326415,90.2532349606,_100,5,>100
3207,horses,946,31327361,90.2559604419,_100,6,>100
3208,methods,946,31328307,90.2586859233,_100,7,>100
3209,launch,945,31329252,90.2614085236,_100,6,>100
3210,whites,945,31330197,90.2641311239,_100,6,>100
3211,afterwards,945,31331142,90.2668537242,_100,10,>100
3212,objects,945,31332087,90.2695763245,_100,7,>100
3213,touched,944,31333031,90.2722960437,_100,7,>100
3214,gentle,944,31333975,90.275015763,_100,6,>100
3215,skill,943,31334918,90.2777326012,_100,5,>100
3216,traveling,943,31335861,90.2804494394,_100,9,>100
3217,exists,942,31336803,90.2831633965,_100,6,>100
3218,ginger,942,31337745,90.2858773536,_100,6,>100
3219,fits,941,31338686,90.2885884297,_100,4,>100
3220,returning,940,31339626,90.2912966247,_100,9,>100
3221,nowhere,940,31340566,90.2940048197,_100,7,>100
3222,visitors,939,31341505,90.2967101337,_100,8,>100
3223,gathered,939,31342444,90.2994154476,_100,8,>100
3224,thread,939,31343383,90.3021207616,_100,6,>100
3225,math,939,31344322,90.3048260755,_100,4,>100
3226,directions,939,31345261,90.3075313895,_100,10,>100
3227,affected,939,31346200,90.3102367034,_100,8,>100
3228,hops,938,31347138,90.3129391363,_100,4,>100
3229,fed,938,31348076,90.3156415692,_100,3,>100
3230,preparing,938,31349014,90.3183440021,_100,9,>100
3231,tap,938,31349952,90.321046435,_100,3,>100
3232,mama,938,31350890,90.3237488679,_100,4,>100
3233,cloud,938,31351828,90.3264513008,_100,5,>100
3234,enemies,938,31352766,90.3291537337,_100,7,>100
3235,investigation,937,31353703,90.3318532856,_100,13,>100
3236,roots,937,31354640,90.3345528374,_100,5,>100
3237,elizabeth,936,31355576,90.3372495082,_100,9,>100
3238,referred,936,31356512,90.3399461789,_100,8,>100
3239,speaks,936,31357448,90.3426428497,_100,6,>100
3240,photographs,935,31358383,90.3453366394,_100,11,>100
3241,realise,935,31359318,90.3480304292,_100,7,>100
3242,democracy,935,31360253,90.3507242189,_100,9,>100
3243,copyright,935,31361188,90.3534180086,_100,9,>100
3244,unexpected,933,31362121,90.3561060362,_100,10,>100
3245,involves,933,31363054,90.3587940638,_100,8,>100
3246,gained,933,31363987,90.3614820914,_100,6,>100
3247,habit,933,31364920,90.364170119,_100,5,>100
3248,kate,933,31365853,90.3668581466,_100,4,>100
3249,styles,932,31366785,90.3695432932,_100,6,>100
3250,tongue,932,31367717,90.3722284397,_100,6,>100
3251,exposed,932,31368649,90.3749135863,_100,7,>100
3252,deals,931,31369580,90.3775958517,_100,5,>100
3253,skirt,930,31370510,90.3802752362,_100,5,>100
3254,dating,930,31371440,90.3829546206,_100,6,>100
3255,smiled,929,31372369,90.385631124,_100,6,>100
3256,marathon,929,31373298,90.3883076273,_100,8,>100
3257,selected,929,31374227,90.3909841307,_100,8,>100
3258,girlfriend,928,31375155,90.393657753,_100,10,>100
3259,accounts,928,31376083,90.3963313753,_100,8,>100
3260,tony,928,31377011,90.3990049976,_100,4,>100
3261,uncomfortable,927,31377938,90.4016757389,_100,13,>100
3262,capture,927,31378865,90.4043464801,_100,7,>100
3263,contain,927,31379792,90.4070172214,_100,7,>100
3264,fixed,926,31380718,90.4096850816,_100,5,>100
3265,sample,925,31381643,90.4123500607,_100,6,>100
3266,valentine,925,31382568,90.4150150398,_100,9,>100
3267,coverage,925,31383493,90.417680019,_100,8,>100
3268,matt,925,31384418,90.4203449981,_100,4,>100
3269,continuing,924,31385342,90.4230070962,_100,10,>100
3270,entertaining,924,31386266,90.4256691943,_100,12,>100
3271,fairy,924,31387190,90.4283312923,_100,5,>100
3272,desperate,923,31388113,90.4309905094,_100,9,>100
3273,testing,923,31389036,90.4336497264,_100,7,>100
3274,bacon,923,31389959,90.4363089434,_100,5,>100
3275,charges,923,31390882,90.4389681604,_100,7,>100
3276,secure,922,31391804,90.4416244964,_100,6,>100
3277,daniel,922,31392726,90.4442808323,_100,6,>100
3278,neighbors,922,31393648,90.4469371683,_100,9,>100
3279,scientific,921,31394569,90.4495906232,_100,10,>100
3280,nick,921,31395490,90.4522440781,_100,4,>100
3281,canadian,920,31396410,90.4548946519,_100,8,>100
3282,bound,920,31397330,90.4575452258,_100,5,>100
3283,destroyed,920,31398250,90.4601957996,_100,9,>100
3284,los,919,31399169,90.4628434924,_100,3,>100
3285,chat,919,31400088,90.4654911852,_100,4,>100
3286,workshop,918,31401006,90.4681359969,_100,8,>100
3287,stepped,918,31401924,90.4707808086,_100,7,>100
3288,lace,918,31402842,90.4734256204,_100,4,>100
3289,purposes,917,31403759,90.476067551,_100,8,>100
3290,reaching,917,31404676,90.4787094817,_100,8,>100
3291,practices,917,31405593,90.4813514124,_100,9,>100
3292,demands,916,31406509,90.483990462,_100,7,>100
3293,authorities,916,31407425,90.4866295116,_100,11,>100
3294,stairs,916,31408341,90.4892685612,_100,6,>100
3295,courage,916,31409257,90.4919076108,_100,7,>100
3296,raising,916,31410173,90.4945466604,_100,7,>100
3297,anxiety,914,31411087,90.4971799479,_100,7,>100
3298,scripture,914,31412001,90.4998132354,_100,9,>100
3299,weapons,914,31412915,90.5024465229,_100,7,>100
3300,tie,914,31413829,90.5050798104,_100,3,>100
3301,topics,914,31414743,90.5077130979,_100,6,>100
3302,shocked,914,31415657,90.5103463853,_100,7,>100
3303,thoroughly,914,31416571,90.5129796728,_100,10,>100
3304,trained,912,31417483,90.5156071982,_100,7,>100
3305,yoga,912,31418395,90.5182347236,_100,4,>100
3306,grandma,912,31419307,90.520862249,_100,7,>100
3307,engaged,911,31420218,90.5234868933,_100,7,>100
3308,911,911,31421129,90.5261115376,_100,3,>100
3309,celebrating,911,31422040,90.5287361819,_100,11,>100
3310,amounts,910,31422950,90.5313579452,_100,7,>100
3311,spoon,910,31423860,90.5339797084,_100,5,>100
3312,fund,909,31424769,90.5365985906,_100,4,>100
3313,beside,908,31425677,90.5392145918,_100,6,>100
3314,distress,908,31426585,90.5418305929,_100,8,>100
3315,relate,907,31427492,90.544443713,_100,6,>100
3316,mysterious,907,31428399,90.5470568331,_100,10,>100
3317,anybody,906,31429305,90.5496670721,_100,7,>100
3318,ill,906,31430211,90.5522773111,_100,3,>100
3319,dressing,905,31431116,90.5548846691,_100,8,>100
3320,intellectual,905,31432021,90.557492027,_100,12,>100
3321,hills,905,31432926,90.560099385,_100,5,>100
3322,introduction,905,31433831,90.562706743,_100,12,>100
3323,sounded,904,31434735,90.5653112199,_100,7,>100
3324,laptop,904,31435639,90.5679156968,_100,6,>100
3325,jumped,903,31436542,90.5705172926,_100,6,>100
3326,delivery,903,31437445,90.5731188885,_100,8,>100
3327,gate,903,31438348,90.5757204843,_100,4,>100
3328,regard,903,31439251,90.5783220802,_100,6,>100
3329,austin,902,31440153,90.5809207949,_100,6,>100
3330,marks,902,31441055,90.5835195097,_100,5,>100
3331,aunt,902,31441957,90.5861182245,_100,4,>100
3332,creatures,901,31442858,90.5887140583,_100,9,>100
3333,prayers,901,31443759,90.591309892,_100,7,>100
3334,wire,900,31444659,90.5939028447,_100,4,>100
3335,900,900,31445559,90.5964957973,_100,3,>100
3336,brian,900,31446459,90.59908875,_100,5,>100
3337,blues,900,31447359,90.6016817027,_100,5,>100
3338,expressed,900,31448259,90.6042746553,_100,9,>100
3339,gathering,900,31449159,90.606867608,_100,9,>100
3340,tasty,899,31450058,90.6094576796,_100,5,>100
3341,sacrifice,899,31450957,90.6120477512,_100,9,>100
3342,ryan,899,31451856,90.6146378229,_100,4,>100
3343,experiment,899,31452755,90.6172278945,_100,10,>100
3344,armed,898,31453653,90.619815085,_100,5,>100
3345,realised,898,31454551,90.6224022756,_100,8,>100
3346,empire,898,31455449,90.6249894661,_100,6,>100
3347,shade,897,31456346,90.6275737756,_100,5,>100
3348,swimming,897,31457243,90.6301580851,_100,8,>100
3349,bills,896,31458139,90.6327395136,_100,5,>100
3350,bored,896,31459035,90.635320942,_100,5,>100
3351,disaster,895,31459930,90.6378994894,_100,8,>100
3352,cousin,895,31460825,90.6404780368,_100,6,>100
3353,secrets,895,31461720,90.6430565841,_100,7,>100
3354,beautifully,895,31462615,90.6456351315,_100,11,>100
3355,jackson,894,31463509,90.6482107978,_100,7,>100
3356,chef,894,31464403,90.6507864642,_100,4,>100
3357,reduced,894,31465297,90.6533621305,_100,7,>100
3358,roads,894,31466191,90.6559377968,_100,5,>100
3359,glue,894,31467085,90.6585134631,_100,4,>100
3360,fuel,894,31467979,90.6610891294,_100,4,>100
3361,imagined,893,31468872,90.6636619147,_100,8,>100
3362,detailed,893,31469765,90.6662347,_100,8,>100
3363,pleasant,891,31470656,90.6688017231,_100,8,>100
3364,actors,890,31471546,90.6713658652,_100,6,>100
3365,trick,890,31472436,90.6739300073,_100,5,>100
3366,relations,890,31473326,90.6764941494,_100,9,>100
3367,attorney,890,31474216,90.6790582914,_100,8,>100
3368,oldest,890,31475106,90.6816224335,_100,6,>100
3369,annoying,889,31475995,90.6841836946,_100,8,>100
3370,clouds,889,31476884,90.6867449556,_100,6,>100
3371,lifetime,888,31477772,90.6893033356,_100,8,>100
3372,linked,888,31478660,90.6918617155,_100,6,>100
3373,photograph,888,31479548,90.6944200955,_100,10,>100
3374,consciousness,887,31480435,90.6969755944,_100,13,>100
3375,roman,886,31481321,90.6995282123,_100,5,>100
3376,ease,886,31482207,90.7020808301,_100,4,>100
3377,fortunately,886,31483093,90.704633448,_100,11,>100
3378,wheat,886,31483979,90.7071860658,_100,5,>100
3379,fears,886,31484865,90.7097386837,_100,5,>100
3380,root,886,31485751,90.7122913015,_100,4,>100
3381,begun,886,31486637,90.7148439194,_100,5,>100
3382,republican,885,31487522,90.7173936562,_100,10,>100
3383,proved,885,31488407,90.719943393,_100,6,>100
3384,surprising,885,31489292,90.7224931298,_100,10,>100
3385,dan,883,31490175,90.7250371044,_100,3,>100
3386,farmers,883,31491058,90.7275810791,_100,7,>100
3387,williams,882,31491940,90.7301221727,_100,8,>100
3388,select,882,31492822,90.7326632663,_100,6,>100
3389,internal,882,31493704,90.73520436,_100,8,>100
3390,sometime,882,31494586,90.7377454536,_100,8,>100
3391,introduce,881,31495467,90.7402836661,_100,9,>100
3392,harm,880,31496347,90.7428189976,_100,4,>100
3393,twelve,879,31497226,90.7453514481,_100,6,>100
3394,attending,879,31498105,90.7478838985,_100,9,>100
3395,mode,879,31498984,90.750416349,_100,4,>100
3396,fold,879,31499863,90.7529487994,_100,4,>100
3397,effectively,879,31500742,90.7554812499,_100,11,>100
3398,lyrics,879,31501621,90.7580137003,_100,6,>100
3399,secretary,879,31502500,90.7605461507,_100,9,>100
3400,measures,877,31503377,90.7630728391,_100,8,>100
3401,staring,877,31504254,90.7655995274,_100,7,>100
3402,principles,877,31505131,90.7681262157,_100,10,>100
3403,brew,877,31506008,90.770652904,_100,4,>100
3404,funding,877,31506885,90.7731795924,_100,7,>100
3405,illinois,876,31507761,90.7757033996,_100,8,>100
3406,strongly,876,31508637,90.7782272069,_100,8,>100
3407,flavors,876,31509513,90.7807510142,_100,7,>100
3408,gather,876,31510389,90.7832748214,_100,6,>100
3409,seats,876,31511265,90.7857986287,_100,5,>100
3410,abandoned,875,31512140,90.7883195549,_100,9,>100
3411,editing,875,31513015,90.7908404811,_100,7,>100
3412,kevin,875,31513890,90.7933614073,_100,5,>100
3413,accurate,875,31514765,90.7958823335,_100,8,>100
3414,praying,875,31515640,90.7984032597,_100,7,>100
3415,malt,875,31516515,90.800924186,_100,4,>100
3416,joseph,874,31517389,90.8034422311,_100,6,>100
3417,presentation,874,31518263,90.8059602763,_100,12,>100
3418,closing,874,31519137,90.8084783214,_100,7,>100
3419,breathing,873,31520010,90.8109934855,_100,9,>100
3420,outcome,873,31520883,90.8135086496,_100,7,>100
3421,twist,873,31521756,90.8160238137,_100,5,>100
3422,opens,873,31522629,90.8185389778,_100,5,>100
3423,teen,872,31523501,90.8210512608,_100,4,>100
3424,desert,872,31524373,90.8235635438,_100,6,>100
3425,halloween,871,31525244,90.8260729458,_100,9,>100
3426,gardens,871,31526115,90.8285823478,_100,7,>100
3427,covering,871,31526986,90.8310917498,_100,8,>100
3428,russian,871,31527857,90.8336011517,_100,7,>100
3429,stunning,870,31528727,90.8361076726,_100,8,>100
3430,bone,870,31529597,90.8386141936,_100,4,>100
3431,destruction,870,31530467,90.8411207145,_100,11,>100
3432,download,869,31531336,90.8436243543,_100,8,>100
3433,sheets,869,31532205,90.8461279942,_100,6,>100
3434,shelf,869,31533074,90.8486316341,_100,5,>100
3435,heavily,869,31533943,90.8511352739,_100,7,>100
3436,sits,868,31534811,90.8536360327,_100,4,>100
3437,dresses,868,31535679,90.8561367915,_100,7,>100
3438,interior,868,31536547,90.8586375503,_100,8,>100
3439,earned,868,31537415,90.8611383091,_100,6,>100
3440,engage,868,31538283,90.8636390679,_100,6,>100
3441,hiding,868,31539151,90.8661398267,_100,6,>100
3442,meetings,868,31540019,90.8686405855,_100,8,>100
3443,tales,867,31540886,90.8711384632,_100,5,>100
3444,spare,867,31541753,90.873636341,_100,5,>100
3445,elsewhere,867,31542620,90.8761342187,_100,9,>100
3446,holes,867,31543487,90.8786320965,_100,5,>100
3447,batter,867,31544354,90.8811299742,_100,6,>100
3448,apparent,867,31545221,90.8836278519,_100,8,>100
3449,spots,867,31546088,90.8861257297,_100,5,>100
3450,patience,866,31546954,90.8886207264,_100,8,>100
3451,cotton,866,31547820,90.891115723,_100,6,>100
3452,clever,866,31548686,90.8936107197,_100,6,>100
3453,enjoyable,865,31549551,90.8961028354,_100,9,>100
3454,dawn,865,31550416,90.898594951,_100,4,>100
3455,crown,865,31551281,90.9010870666,_100,5,>100
3456,minimum,864,31552145,90.9035763012,_100,7,>100
3457,settle,864,31553009,90.9060655357,_100,6,>100
3458,bin,864,31553873,90.9085547703,_100,3,>100
3459,entering,864,31554737,90.9110440049,_100,8,>100
3460,transition,863,31555600,90.9135303584,_100,10,>100
3461,melted,863,31556463,90.9160167119,_100,6,>100
3462,afghanistan,862,31557325,90.9185001843,_100,11,>100
3463,comparison,862,31558187,90.9209836568,_100,10,>100
3464,hitting,862,31559049,90.9234671292,_100,7,>100
3465,hint,862,31559911,90.9259506017,_100,4,>100
3466,sink,862,31560773,90.9284340741,_100,4,>100
3467,generous,862,31561635,90.9309175466,_100,8,>100
3468,fought,861,31562496,90.9333981379,_100,6,>100
3469,yards,860,31563356,90.9358758483,_100,5,>100
3470,bloody,860,31564216,90.9383535586,_100,6,>100
3471,devil,860,31565076,90.9408312689,_100,5,>100
3472,occur,860,31565936,90.9433089793,_100,5,>100
3473,expert,859,31566795,90.9457838085,_100,6,>100
3474,theater,859,31567654,90.9482586378,_100,7,>100
3475,belly,859,31568513,90.9507334671,_100,5,>100
3476,lonely,858,31569371,90.9532054153,_100,6,>100
3477,soil,858,31570229,90.9556773635,_100,4,>100
3478,promises,858,31571087,90.9581493117,_100,8,>100
3479,salvation,857,31571944,90.9606183789,_100,9,>100
3480,dvd,857,31572801,90.963087446,_100,3,>100
3481,episodes,857,31573658,90.9655565132,_100,8,>100
3482,relax,856,31574514,90.9680226993,_100,5,>100
3483,solutions,856,31575370,90.9704888854,_100,9,>100
3484,overwhelming,855,31576225,90.9729521904,_100,12,>100
3485,spaces,855,31577080,90.9754154955,_100,6,>100
3486,avenue,855,31577935,90.9778788005,_100,6,>100
3487,leather,854,31578789,90.9803392245,_100,7,>100
3488,toilet,853,31579642,90.9827967674,_100,6,>100
3489,socks,853,31580495,90.9852543103,_100,5,>100
3490,bold,852,31581347,90.9877089722,_100,4,>100
3491,waters,852,31582199,90.990163634,_100,6,>100
3492,disney,852,31583051,90.9926182959,_100,6,>100
3493,handful,851,31583902,90.9950700767,_100,7,>100
3494,boston,851,31584753,90.9975218575,_100,6,>100
3495,lift,851,31585604,90.9999736383,_100,4,>100
3496,banana,851,31586455,91.0024254191,_100,6,>100
3497,ton,850,31587305,91.0048743189,_100,3,>100
3498,proposed,850,31588155,91.0073232186,_100,8,>100
3499,wing,849,31589004,91.0097692373,_100,4,>100
3500,frankly,849,31589853,91.012215256,_100,7,>100
3501,supported,849,31590702,91.0146612747,_100,9,>100
3502,slept,849,31591551,91.0171072934,_100,5,>100
3503,francisco,849,31592400,91.019553312,_100,9,>100
3504,tune,849,31593249,91.0219993307,_100,4,>100
3505,encounter,848,31594097,91.0244424684,_100,9,>100
3506,judgment,848,31594945,91.026885606,_100,8,>100
3507,poverty,848,31595793,91.0293287436,_100,7,>100
3508,lover,847,31596640,91.0317690002,_100,5,>100
3509,defined,846,31597486,91.0342063757,_100,7,>100
3510,knife,846,31598332,91.0366437512,_100,5,>100
3511,meantime,846,31599178,91.0390811267,_100,8,>100
3512,bbc,845,31600023,91.0415156212,_100,3,>100
3513,gotta,845,31600868,91.0439501156,_100,5,>100
3514,rolls,845,31601713,91.0463846101,_100,5,>100
3515,sins,844,31602557,91.0488162235,_100,4,>100
3516,shadows,843,31603400,91.0512449558,_100,7,>100
3517,dare,843,31604243,91.0536736881,_100,4,>100
3518,academic,842,31605085,91.0560995394,_100,8,>100
3519,quit,841,31605926,91.0585225096,_100,4,>100
3520,pretend,841,31606767,91.0609454799,_100,7,>100
3521,bow,841,31607608,91.0633684501,_100,3,>100
3522,castle,840,31608448,91.0657885392,_100,6,>100
3523,rocks,840,31609288,91.0682086284,_100,5,>100
3524,phase,840,31610128,91.0706287176,_100,5,>100
3525,shoulders,840,31610968,91.0730488067,_100,9,>100
3526,industrial,840,31611808,91.0754688959,_100,10,>100
3527,churches,839,31612647,91.077886104,_100,8,>100
3528,chaos,839,31613486,91.0803033121,_100,5,>100
3529,instantly,839,31614325,91.0827205202,_100,9,>100
3530,guilt,838,31615163,91.0851348472,_100,5,>100
3531,capacity,838,31616001,91.0875491743,_100,8,>100
3532,spain,838,31616839,91.0899635013,_100,5,>100
3533,celebrated,838,31617677,91.0923778284,_100,10,>100
3534,fake,838,31618515,91.0947921554,_100,4,>100
3535,switch,838,31619353,91.0972064824,_100,6,>100
3536,pp,838,31620191,91.0996208095,_100,2,>100
3537,fox,837,31621028,91.1020322555,_100,3,>100
3538,independence,837,31621865,91.1044437015,_100,12,>100
3539,sector,837,31622702,91.1068551474,_100,6,>100
3540,smiling,837,31623539,91.1092665934,_100,7,>100
3541,peanut,837,31624376,91.1116780394,_100,6,>100
3542,cinnamon,837,31625213,91.1140894854,_100,8,>100
3543,entrance,836,31626049,91.1164980503,_100,8,>100
3544,islamic,836,31626885,91.1189066152,_100,7,>100
3545,treasure,836,31627721,91.1213151802,_100,8,>100
3546,yummy,835,31628556,91.123720864,_100,5,>100
3547,le,835,31629391,91.1261265479,_100,2,>100
3548,publication,835,31630226,91.1285322318,_100,11,>100
3549,refuse,835,31631061,91.1309379156,_100,6,>100
3550,universal,835,31631896,91.1333435995,_100,9,>100
3551,zero,834,31632730,91.1357464023,_100,4,>100
3552,adopted,834,31633564,91.1381492051,_100,7,>100
3553,gender,834,31634398,91.1405520079,_100,6,>100
3554,suicide,833,31635231,91.1429519297,_100,7,>100
3555,pumpkin,833,31636064,91.1453518514,_100,7,>100
3556,immigration,833,31636897,91.1477517732,_100,11,>100
3557,toy,833,31637730,91.1501516949,_100,3,>100
3558,alien,832,31638562,91.1525487356,_100,5,>100
3559,ye,831,31639393,91.1549428953,_100,2,>100
3560,coloured,831,31640224,91.1573370549,_100,8,>100
3561,fees,830,31641054,91.1597283335,_100,4,>100
3562,instant,830,31641884,91.162119612,_100,7,>100
3563,platform,830,31642714,91.1645108906,_100,8,>100
3564,gear,829,31643543,91.1668992881,_100,4,>100
3565,possibilities,829,31644372,91.1692876857,_100,13,>100
3566,catching,829,31645201,91.1716760832,_100,8,>100
3567,makeup,829,31646030,91.1740644807,_100,6,>100
3568,branch,829,31646859,91.1764528782,_100,6,>100
3569,rescue,829,31647688,91.1788412757,_100,6,>100
3570,confirmed,829,31648517,91.1812296732,_100,9,>100
3571,profile,828,31649345,91.1836151897,_100,7,>100
3572,visible,828,31650173,91.1860007061,_100,7,>100
3573,amy,828,31651001,91.1883862226,_100,3,>100
3574,factors,828,31651829,91.1907717391,_100,7,>100
3575,ipa,827,31652656,91.1931543745,_100,3,>100
3576,attractive,827,31653483,91.1955370099,_100,10,>100
3577,achieved,826,31654309,91.1979167642,_100,8,>100
3578,dramatic,826,31655135,91.2002965185,_100,8,>100
3579,jacket,826,31655961,91.2026762729,_100,6,>100
3580,launched,826,31656787,91.2050560272,_100,8,>100
3581,sandwich,825,31657612,91.2074329005,_100,8,>100
3582,versions,825,31658437,91.2098097738,_100,8,>100
3583,discovery,825,31659262,91.2121866471,_100,9,>100
3584,heritage,825,31660087,91.2145635204,_100,8,>100
3585,yep,825,31660912,91.2169403936,_100,3,>100
3586,refer,825,31661737,91.2193172669,_100,5,>100
3587,household,825,31662562,91.2216941402,_100,9,>100
3588,division,824,31663386,91.2240681324,_100,8,>100
3589,simon,824,31664210,91.2264421246,_100,5,>100
3590,epic,824,31665034,91.2288161169,_100,4,>100
3591,reminder,823,31665857,91.231187228,_100,8,>100
3592,waves,823,31666680,91.2335583392,_100,5,>100
3593,brave,823,31667503,91.2359294504,_100,5,>100
3594,marked,823,31668326,91.2383005615,_100,6,>100
3595,johnson,822,31669148,91.2406687916,_100,7,>100
3596,accused,822,31669970,91.2430370217,_100,7,>100
3597,fate,821,31670791,91.2454023708,_100,4,>100
3598,eric,821,31671612,91.2477677198,_100,4,>100
3599,magazines,821,31672433,91.2501330689,_100,9,>100
3600,strip,821,31673254,91.2524984179,_100,5,>100
3601,breast,820,31674074,91.2548608859,_100,6,>100
3602,hated,820,31674894,91.2572233539,_100,5,>100
3603,agenda,820,31675714,91.2595858219,_100,6,>100
3604,vampire,820,31676534,91.2619482899,_100,7,>100
3605,nevertheless,819,31677353,91.2643078768,_100,12,>100
3606,heck,819,31678172,91.2666674638,_100,4,>100
3607,reputation,819,31678991,91.2690270507,_100,10,>100
3608,height,819,31679810,91.2713866376,_100,6,>100
3609,awkward,819,31680629,91.2737462246,_100,7,>100
3610,positions,818,31681447,91.2761029304,_100,9,>100
3611,peaceful,818,31682265,91.2784596363,_100,8,>100
3612,illness,818,31683083,91.2808163422,_100,7,>100
3613,basket,817,31683900,91.283170167,_100,6,>100
3614,buried,817,31684717,91.2855239918,_100,6,>100
3615,subjects,817,31685534,91.2878778166,_100,8,>100
3616,wishes,817,31686351,91.2902316414,_100,6,>100
3617,polish,817,31687168,91.2925854662,_100,6,>100
3618,climb,816,31687984,91.29493641,_100,5,>100
3619,severe,816,31688800,91.2972873538,_100,6,>100
3620,asian,816,31689616,91.2996382975,_100,5,>100
3621,souls,815,31690431,91.3019863602,_100,5,>100
3622,wheel,815,31691246,91.3043344229,_100,5,>100
3623,sessions,815,31692061,91.3066824856,_100,8,>100
3624,pin,815,31692876,91.3090305483,_100,3,>100
3625,script,814,31693690,91.3113757299,_100,6,>100
3626,oz,814,31694504,91.3137209116,_100,2,>100
3627,websites,813,31695317,91.3160632122,_100,8,>100
3628,mercy,812,31696129,91.3184026317,_100,5,>100
3629,monthly,812,31696941,91.3207420512,_100,7,>100
3630,iphone,812,31697753,91.3230814707,_100,6,>100
3631,charlie,812,31698565,91.3254208902,_100,7,>100
3632,steel,812,31699377,91.3277603098,_100,5,>100
3633,feeding,812,31700189,91.3300997293,_100,7,>100
3634,candidate,811,31701000,91.3324362677,_100,9,>100
3635,alongside,811,31701811,91.3347728062,_100,9,>100
3636,albums,811,31702622,91.3371093447,_100,6,>100
3637,chairs,811,31703433,91.3394458831,_100,6,>100
3638,approximately,811,31704244,91.3417824216,_100,13,>100
3639,dc,811,31705055,91.3441189601,_100,2,>100
3640,belt,811,31705866,91.3464554985,_100,4,>100
3641,yeast,811,31706677,91.348792037,_100,5,>100
3642,homemade,811,31707488,91.3511285754,_100,8,>100
3643,convince,810,31708298,91.3534622329,_100,8,>100
3644,liberty,810,31709108,91.3557958903,_100,7,>100
3645,recovery,809,31709917,91.3581266666,_100,8,>100
3646,mixing,809,31710726,91.3604574429,_100,6,>100
3647,ray,809,31711535,91.3627882193,_100,3,>100
3648,batch,809,31712344,91.3651189956,_100,5,>100
3649,genuine,809,31713153,91.367449772,_100,7,>100
3650,delight,808,31713961,91.3697776673,_100,7,>100
3651,attempted,808,31714769,91.3721055626,_100,9,>100
3652,defend,807,31715576,91.3744305768,_100,6,>100
3653,tear,807,31716383,91.376755591,_100,4,>100
3654,phones,807,31717190,91.3790806052,_100,6,>100
3655,shine,807,31717997,91.3814056195,_100,5,>100
3656,patrick,807,31718804,91.3837306337,_100,7,>100
3657,reply,806,31719610,91.3860527669,_100,5,>100
3658,describes,806,31720416,91.3883749,_100,9,>100
3659,cherry,805,31721221,91.3906941522,_100,6,>100
3660,narrow,805,31722026,91.3930134043,_100,6,>100
3661,rings,805,31722831,91.3953326564,_100,5,>100
3662,lighting,805,31723636,91.3976519085,_100,8,>100
3663,rack,804,31724440,91.3999682795,_100,4,>100
3664,engine,804,31725244,91.4022846506,_100,6,>100
3665,injury,804,31726048,91.4046010217,_100,6,>100
3666,operations,804,31726852,91.4069173927,_100,10,>100
3667,ed,803,31727655,91.4092308827,_100,2,>100
3668,planted,803,31728458,91.4115443727,_100,7,>100
3669,australian,803,31729261,91.4138578627,_100,10,>100
3670,leaf,803,31730064,91.4161713527,_100,4,>100
3671,permanent,803,31730867,91.4184848427,_100,9,>100
3672,represents,803,31731670,91.4207983327,_100,10,>100
3673,ignored,801,31732471,91.4231060606,_100,7,>100
3674,circles,801,31733272,91.4254137884,_100,7,>100
3675,nap,801,31734073,91.4277215163,_100,3,>100
3676,destination,801,31734874,91.4300292442,_100,11,>100
3677,habits,801,31735675,91.4323369721,_100,6,>100
3678,yarn,801,31736476,91.4346446999,_100,4,>100
3679,format,800,31737276,91.4369495468,_100,6,>100
3680,800,800,31738076,91.4392543936,_100,3,>100
3681,gap,799,31738875,91.4415563593,_100,3,>100
3682,vegetable,799,31739674,91.4438583251,_100,9,>100
3683,jam,799,31740473,91.4461602909,_100,3,>100
3684,highlight,798,31741271,91.4484593756,_100,9,>100
3685,jazz,797,31742068,91.4507555792,_100,4,>100
3686,greatly,797,31742865,91.4530517828,_100,7,>100
3687,accomplished,797,31743662,91.4553479865,_100,12,>100
3688,consistent,797,31744459,91.4576441901,_100,10,>100
3689,scheme,797,31745256,91.4599403938,_100,6,>100
3690,domestic,796,31746052,91.4622337164,_100,8,>100
3691,responded,795,31746847,91.4645241579,_100,9,>100
3692,beating,794,31747641,91.4668117184,_100,7,>100
3693,collect,794,31748435,91.4690992788,_100,7,>100
3694,desired,793,31749228,91.4713839582,_100,7,>100
3695,mainstream,793,31750021,91.4736686376,_100,10,>100
3696,smoking,793,31750814,91.4759533171,_100,7,>100
3697,quest,792,31751606,91.4782351154,_100,5,>100
3698,naked,792,31752398,91.4805169138,_100,5,>100
3699,knees,792,31753190,91.4827987121,_100,5,>100
3700,sprinkle,791,31753981,91.4850776294,_100,8,>100
3701,crimes,791,31754772,91.4873565467,_100,6,>100
3702,ought,790,31755562,91.4896325829,_100,5,>100
3703,nasty,790,31756352,91.4919086192,_100,5,>100
3704,visits,790,31757142,91.4941846554,_100,6,>100
3705,participants,790,31757932,91.4964606916,_100,12,>100
3706,intention,789,31758721,91.4987338468,_100,9,>100
3707,overcome,789,31759510,91.501007002,_100,8,>100
3708,swear,789,31760299,91.5032801572,_100,5,>100
3709,graphic,788,31761087,91.5055504313,_100,7,>100
3710,miracle,788,31761875,91.5078207054,_100,7,>100
3711,dirt,788,31762663,91.5100909795,_100,4,>100
3712,stephen,788,31763451,91.5123612536,_100,7,>100
3713,jewelry,788,31764239,91.5146315277,_100,7,>100
3714,advanced,787,31765026,91.5168989208,_100,8,>100
3715,inspire,787,31765813,91.5191663139,_100,7,>100
3716,heroes,787,31766600,91.5214337069,_100,6,>100
3717,statements,787,31767387,91.5237011,_100,10,>100
3718,attempting,786,31768173,91.525965612,_100,10,>100
3719,louis,786,31768959,91.528230124,_100,5,>100
3720,mac,786,31769745,91.530494636,_100,3,>100
3721,keys,786,31770531,91.532759148,_100,4,>100
3722,worlds,786,31771317,91.53502366,_100,6,>100
3723,max,786,31772103,91.537288172,_100,3,>100
3724,command,786,31772889,91.539552684,_100,7,>100
3725,urge,785,31773674,91.5418143149,_100,4,>100
3726,angeles,784,31774458,91.5440730648,_100,7,>100
3727,charity,784,31775242,91.5463318147,_100,7,>100
3728,tasted,783,31776025,91.5485876835,_100,6,>100
3729,needless,783,31776808,91.5508435523,_100,8,>100
3730,belong,783,31777591,91.5530994212,_100,6,>100
3731,crack,783,31778374,91.55535529,_100,5,>100
3732,criticism,783,31779157,91.5576111588,_100,9,>100
3733,emotion,782,31779939,91.5598641466,_100,7,>100
3734,fruits,782,31780721,91.5621171343,_100,6,>100
3735,breathe,782,31781503,91.5643701221,_100,7,>100
3736,scientists,781,31782284,91.5666202288,_100,10,>100
3737,sought,781,31783065,91.5688703355,_100,6,>100
3738,elected,781,31783846,91.5711204422,_100,7,>100
3739,sheer,780,31784626,91.5733676679,_100,5,>100
3740,glitter,779,31785405,91.5756120125,_100,7,>100
3741,grief,778,31786183,91.577853476,_100,5,>100
3742,cakes,777,31786960,91.5800920585,_100,5,>100
3743,sour,777,31787737,91.5823306409,_100,4,>100
3744,improved,777,31788514,91.5845692234,_100,8,>100
3745,anna,776,31789290,91.5868049248,_100,4,>100
3746,educational,776,31790066,91.5890406262,_100,11,>100
3747,daughters,776,31790842,91.5912763277,_100,9,>100
3748,jeff,775,31791617,91.593509148,_100,4,>100
3749,throat,775,31792392,91.5957419684,_100,6,>100
3750,formula,775,31793167,91.5979747887,_100,7,>100
3751,folk,775,31793942,91.6002076091,_100,4,>100
3752,ann,774,31794716,91.6024375484,_100,3,>100
3753,glorious,774,31795490,91.6046674877,_100,8,>100
3754,regret,774,31796264,91.606897427,_100,6,>100
3755,interviews,774,31797038,91.6091273663,_100,10,>100
3756,elections,774,31797812,91.6113573056,_100,9,>100
3757,designers,774,31798586,91.6135872449,_100,9,>100
3758,affairs,773,31799359,91.6158143031,_100,7,>100
3759,matthew,773,31800132,91.6180413613,_100,7,>100
3760,roles,773,31800905,91.6202684196,_100,5,>100
3761,fifth,772,31801677,91.6224925968,_100,5,>100
3762,punk,772,31802449,91.6247167739,_100,4,>100
3763,permission,772,31803221,91.6269409511,_100,10,>100
3764,quietly,772,31803993,91.6291651283,_100,7,>100
3765,shelves,772,31804765,91.6313893055,_100,7,>100
3766,newly,771,31805536,91.6336106016,_100,5,>100
3767,involving,771,31806307,91.6358318977,_100,9,>100
3768,performing,770,31807077,91.6380503128,_100,10,>100
3769,calories,770,31807847,91.6402687279,_100,8,>100
3770,fired,770,31808617,91.6424871429,_100,5,>100
3771,enormous,770,31809387,91.644705558,_100,8,>100
3772,performances,769,31810156,91.646921092,_100,12,>100
3773,accessories,769,31810925,91.649136626,_100,11,>100
3774,arrival,769,31811694,91.65135216,_100,7,>100
3775,returns,769,31812463,91.653567694,_100,7,>100
3776,moms,768,31813231,91.6557803469,_100,4,>100
3777,notion,768,31813999,91.6579929999,_100,6,>100
3778,conscious,767,31814766,91.6602027718,_100,9,>100
3779,sensitive,767,31815533,91.6624125437,_100,9,>100
3780,mexican,766,31816299,91.6646194345,_100,7,>100
3781,protest,766,31817065,91.6668263253,_100,7,>100
3782,appreciated,766,31817831,91.6690332162,_100,11,>100
3783,overnight,766,31818597,91.671240107,_100,9,>100
3784,invite,765,31819362,91.6734441168,_100,6,>100
3785,communicate,765,31820127,91.6756481265,_100,11,>100
3786,themes,765,31820892,91.6778521363,_100,6,>100
3787,generations,765,31821657,91.6800561461,_100,11,>100
3788,frustrated,765,31822422,91.6822601558,_100,10,>100
3789,amazed,764,31823186,91.6844612846,_100,6,>100
3790,jersey,764,31823950,91.6866624133,_100,6,>100
3791,cafe,763,31824713,91.6888606609,_100,4,>100
3792,roasted,763,31825476,91.6910589086,_100,7,>100
3793,peak,763,31826239,91.6932571562,_100,4,>100
3794,slip,763,31827002,91.6954554039,_100,4,>100
3795,survey,763,31827765,91.6976536515,_100,6,>100
3796,resistance,762,31828527,91.6998490181,_100,10,>100
3797,jason,762,31829289,91.7020443847,_100,5,>100
3798,sacred,762,31830051,91.7042397513,_100,6,>100
3799,recognized,762,31830813,91.7064351179,_100,10,>100
3800,inspiring,761,31831574,91.7086276035,_100,9,>100
3801,occasional,761,31832335,91.710820089,_100,10,>100
3802,neighbor,761,31833096,91.7130125745,_100,8,>100
3803,crisp,761,31833857,91.7152050601,_100,5,>100
3804,ours,761,31834618,91.7173975456,_100,4,>100
3805,hilarious,761,31835379,91.7195900311,_100,9,>100
3806,vital,760,31836139,91.7217796356,_100,5,>100
3807,thou,760,31836899,91.7239692401,_100,4,>100
3808,sticks,760,31837659,91.7261588446,_100,6,>100
3809,syrup,760,31838419,91.728348449,_100,5,>100
3810,popped,759,31839178,91.7305351725,_100,6,>100
3811,lined,759,31839937,91.7327218959,_100,5,>100
3812,skip,758,31840695,91.7349057382,_100,4,>100
3813,arguments,758,31841453,91.7370895806,_100,9,>100
3814,solve,758,31842211,91.739273423,_100,5,>100
3815,tension,757,31842968,91.7414543843,_100,7,>100
3816,limits,756,31843724,91.7436324645,_100,6,>100
3817,midst,756,31844480,91.7458105448,_100,5,>100
3818,exhausted,756,31845236,91.747988625,_100,9,>100
3819,shapes,755,31845991,91.7501638242,_100,6,>100
3820,forum,754,31846745,91.7523361423,_100,5,>100
3821,declared,754,31847499,91.7545084604,_100,8,>100
3822,encouraging,753,31848252,91.7566778975,_100,11,>100
3823,navy,753,31849005,91.7588473346,_100,4,>100
3824,blanket,753,31849758,91.7610167717,_100,7,>100
3825,anyways,752,31850510,91.7631833277,_100,7,>100
3826,awake,752,31851262,91.7653498837,_100,5,>100
3827,locked,752,31852014,91.7675164397,_100,6,>100
3828,fence,752,31852766,91.7696829957,_100,5,>100
3829,aim,751,31853517,91.7718466706,_100,3,>100
3830,virginia,750,31854267,91.7740074645,_100,8,>100
3831,calendar,750,31855017,91.7761682584,_100,8,>100
3832,ceremony,750,31855767,91.7783290523,_100,8,>100
3833,laughter,749,31856516,91.7804869652,_100,8,>100
3834,submit,749,31857265,91.782644878,_100,6,>100
3835,formal,749,31858014,91.7848027908,_100,6,>100
3836,attacked,749,31858763,91.7869607037,_100,8,>100
3837,concrete,748,31859511,91.7891157354,_100,8,>100
3838,whisk,747,31860258,91.7912678862,_100,5,>100
3839,racist,747,31861005,91.7934200369,_100,6,>100
3840,labels,747,31861752,91.7955721876,_100,6,>100
3841,decides,747,31862499,91.7977243383,_100,7,>100
3842,races,747,31863246,91.799876489,_100,5,>100
3843,fry,747,31863993,91.8020286397,_100,3,>100
3844,solar,747,31864740,91.8041807905,_100,5,>100
3845,gang,747,31865487,91.8063329412,_100,4,>100
3846,blessings,746,31866233,91.8084822108,_100,9,>100
3847,issued,746,31866979,91.8106314805,_100,6,>100
3848,grows,746,31867725,91.8127807501,_100,5,>100
3849,participating,746,31868471,91.8149300198,_100,13,>100
3850,occasions,746,31869217,91.8170792895,_100,9,>100
3851,laying,746,31869963,91.8192285591,_100,6,>100
3852,desires,745,31870708,91.8213749477,_100,7,>100
3853,lane,745,31871453,91.8235213363,_100,4,>100
3854,poems,745,31872198,91.8256677249,_100,5,>100
3855,reflection,745,31872943,91.8278141135,_100,10,>100
3856,bless,745,31873688,91.8299605021,_100,5,>100
3857,serves,745,31874433,91.8321068907,_100,6,>100
3858,lime,744,31875177,91.8342503983,_100,4,>100
3859,closest,744,31875921,91.8363939058,_100,7,>100
3860,paintings,744,31876665,91.8385374134,_100,9,>100
3861,tasting,744,31877409,91.8406809209,_100,7,>100
3862,jumping,744,31878153,91.8428244284,_100,7,>100
3863,paste,744,31878897,91.844967936,_100,5,>100
3864,iraq,743,31879640,91.8471085625,_100,4,>100
3865,ca,743,31880383,91.8492491889,_100,2,>100
3866,taylor,743,31881126,91.8513898154,_100,6,>100
3867,nail,743,31881869,91.8535304419,_100,4,>100
3868,scotland,742,31882611,91.8556681873,_100,8,>100
3869,acceptable,742,31883353,91.8578059328,_100,10,>100
3870,reserve,742,31884095,91.8599436782,_100,7,>100
3871,shaped,742,31884837,91.8620814236,_100,6,>100
3872,burned,741,31885578,91.864216288,_100,6,>100
3873,announce,741,31886319,91.8663511523,_100,8,>100
3874,roses,741,31887060,91.8684860167,_100,5,>100
3875,goodies,741,31887801,91.8706208811,_100,7,>100
3876,faithful,740,31888541,91.8727528644,_100,8,>100
3877,alright,740,31889281,91.8748848477,_100,7,>100
3878,survived,740,31890021,91.877016831,_100,8,>100
3879,pearls,740,31890761,91.8791488143,_100,6,>100
3880,shed,739,31891500,91.8812779166,_100,4,>100
3881,affair,739,31892239,91.8834070188,_100,6,>100
3882,pat,739,31892978,91.8855361211,_100,3,>100
3883,teenage,739,31893717,91.8876652233,_100,7,>100
3884,unlikely,739,31894456,91.8897943256,_100,8,>100
3885,devices,739,31895195,91.8919234278,_100,7,>100
3886,swing,739,31895934,91.8940525301,_100,5,>100
3887,survival,739,31896673,91.8961816323,_100,8,>100
3888,agencies,739,31897412,91.8983107346,_100,8,>100
3889,pakistan,738,31898150,91.9004369557,_100,8,>100
3890,snack,738,31898888,91.9025631769,_100,5,>100
3891,pound,738,31899626,91.9046893981,_100,5,>100
3892,grounds,738,31900364,91.9068156193,_100,7,>100
3893,focusing,738,31901102,91.9089418405,_100,8,>100
3894,photographer,737,31901839,91.9110651806,_100,12,>100
3895,treats,737,31902576,91.9131885208,_100,6,>100
3896,absence,736,31903312,91.9153089798,_100,7,>100
3897,satisfied,736,31904048,91.9174294389,_100,9,>100
3898,racing,736,31904784,91.919549898,_100,6,>100
3899,compare,736,31905520,91.9216703571,_100,7,>100
3900,gradually,735,31906255,91.9237879351,_100,9,>100
3901,hunting,735,31906990,91.9259055131,_100,7,>100
3902,junior,735,31907725,91.9280230911,_100,6,>100
3903,whereas,734,31908459,91.9301377881,_100,7,>100
3904,relative,734,31909193,91.932252485,_100,8,>100
3905,primarily,734,31909927,91.934367182,_100,9,>100
3906,insight,733,31910660,91.9364789979,_100,7,>100
3907,underneath,733,31911393,91.9385908138,_100,10,>100
3908,stirring,733,31912126,91.9407026297,_100,8,>100
3909,blast,732,31912858,91.9428115645,_100,5,>100
3910,troops,732,31913590,91.9449204994,_100,6,>100
3911,accomplish,732,31914322,91.9470294342,_100,10,>100
3912,units,731,31915053,91.949135488,_100,5,>100
3913,stones,731,31915784,91.9512415418,_100,6,>100
3914,slices,731,31916515,91.9533475955,_100,6,>100
3915,clue,730,31917245,91.9554507683,_100,4,>100
3916,aged,730,31917975,91.957553941,_100,4,>100
3917,remarkable,730,31918705,91.9596571137,_100,10,>100
3918,zombie,730,31919435,91.9617602864,_100,6,>100
3919,crafting,729,31920164,91.9638605781,_100,8,>100
3920,obsessed,729,31920893,91.9659608698,_100,8,>100
3921,discussing,729,31921622,91.9680611614,_100,10,>100
3922,cabinet,729,31922351,91.9701614531,_100,7,>100
3923,tube,728,31923079,91.9722588637,_100,4,>100
3924,knee,727,31923806,91.9743533932,_100,4,>100
3925,sticking,726,31924532,91.9764450417,_100,8,>100
3926,panic,726,31925258,91.9785366902,_100,5,>100
3927,bare,726,31925984,91.9806283387,_100,4,>100
3928,sooner,726,31926710,91.9827199872,_100,6,>100
3929,washing,726,31927436,91.9848116357,_100,7,>100
3930,drain,726,31928162,91.9869032842,_100,5,>100
3931,teaspoon,725,31928887,91.9889920516,_100,8,>100
3932,lawyer,725,31929612,91.991080819,_100,6,>100
3933,pinterest,725,31930337,91.9931695865,_100,9,>100
3934,stuffed,725,31931062,91.9952583539,_100,7,>100
3935,speaker,724,31931786,91.9973442403,_100,7,>100
3936,dragon,724,31932510,91.9994301266,_100,6,>100
3937,wee,723,31933233,92.0015131319,_100,3,>100
3938,hip,723,31933956,92.0035961372,_100,3,>100
3939,toss,723,31934679,92.0056791426,_100,4,>100
3940,mall,723,31935402,92.0077621479,_100,4,>100
3941,quotes,722,31936124,92.0098422721,_100,6,>100
3942,goodbye,722,31936846,92.0119223964,_100,7,>100
3943,ongoing,722,31937568,92.0140025206,_100,7,>100
3944,profit,722,31938290,92.0160826449,_100,6,>100
3945,ruling,722,31939012,92.0181627691,_100,6,>100
3946,intelligent,721,31939733,92.0202400123,_100,11,>100
3947,mayor,721,31940454,92.0223172555,_100,5,>100
3948,workout,720,31941174,92.0243916177,_100,7,>100
3949,convention,720,31941894,92.0264659798,_100,10,>100
3950,kicked,720,31942614,92.0285403419,_100,6,>100
3951,resolution,720,31943334,92.0306147041,_100,10,>100
3952,dt,720,31944054,92.0326890662,_100,2,>100
3953,publish,720,31944774,92.0347634284,_100,7,>100
3954,approached,720,31945494,92.0368377905,_100,10,>100
3955,teens,720,31946214,92.0389121526,_100,5,>100
3956,warned,719,31946933,92.0409836337,_100,6,>100
3957,connections,719,31947652,92.0430551148,_100,11,>100
3958,governments,718,31948370,92.0451237148,_100,11,>100
3959,depends,718,31949088,92.0471923148,_100,7,>100
3960,string,718,31949806,92.0492609149,_100,6,>100
3961,persons,718,31950524,92.0513295149,_100,7,>100
3962,autumn,718,31951242,92.0533981149,_100,6,>100
3963,sections,717,31951959,92.0554638339,_100,8,>100
3964,define,717,31952676,92.0575295528,_100,6,>100
3965,q,717,31953393,92.0595952718,_100,1,>100
3966,voters,717,31954110,92.0616609907,_100,6,>100
3967,melt,717,31954827,92.0637267097,_100,4,>100
3968,crystal,717,31955544,92.0657924287,_100,7,>100
3969,marry,716,31956260,92.0678552666,_100,5,>100
3970,engaging,715,31956975,92.0699152234,_100,8,>100
3971,kim,715,31957690,92.0719751803,_100,3,>100
3972,rely,714,31958404,92.074032256,_100,4,>100
3973,bride,714,31959118,92.0760893318,_100,5,>100
3974,preparation,713,31959831,92.0781435266,_100,11,>100
3975,dude,713,31960544,92.0801977213,_100,4,>100
3976,balanced,713,31961257,92.082251916,_100,8,>100
3977,thy,712,31961969,92.0843032297,_100,3,>100
3978,veggies,712,31962681,92.0863545434,_100,7,>100
3979,markers,711,31963392,92.088402976,_100,7,>100
3980,brands,711,31964103,92.0904514086,_100,6,>100
3981,complain,711,31964814,92.0924998412,_100,8,>100
3982,stout,711,31965525,92.0945482738,_100,5,>100
3983,crafts,711,31966236,92.0965967064,_100,6,>100
3984,lisa,710,31966946,92.098642258,_100,4,>100
3985,jar,710,31967656,92.1006878095,_100,3,>100
3986,commit,710,31968366,92.1027333611,_100,6,>100
3987,caring,710,31969076,92.1047789126,_100,6,>100
3988,realistic,710,31969786,92.1068244642,_100,9,>100
3989,stream,709,31970495,92.1088671347,_100,6,>100
3990,contrary,709,31971204,92.1109098051,_100,8,>100
3991,stranger,709,31971913,92.1129524756,_100,8,>100
3992,essence,708,31972621,92.1149922651,_100,7,>100
3993,scream,708,31973329,92.1170320545,_100,6,>100
3994,shoe,708,31974037,92.1190718439,_100,4,>100
3995,files,708,31974745,92.1211116334,_100,5,>100
3996,insane,708,31975453,92.1231514228,_100,6,>100
3997,practically,708,31976161,92.1251912123,_100,11,>100
3998,wordpress,707,31976868,92.1272281206,_100,9,>100
3999,testament,707,31977575,92.129265029,_100,9,>100
4000,rent,707,31978282,92.1313019374,_100,4,>100
4001,spirits,707,31978989,92.1333388458,_100,7,>100
4002,cupcake,707,31979696,92.1353757541,_100,7,>100
4003,drops,707,31980403,92.1374126625,_100,5,>100
4004,confusion,707,31981110,92.1394495709,_100,9,>100
4005,tank,707,31981817,92.1414864793,_100,4,>100
4006,shades,706,31982523,92.1435205066,_100,6,>100
4007,cloth,706,31983229,92.1455545339,_100,5,>100
4008,solo,706,31983935,92.1475885612,_100,4,>100
4009,campus,706,31984641,92.1496225885,_100,6,>100
4010,vegan,706,31985347,92.1516566159,_100,5,>100
4011,artistic,706,31986053,92.1536906432,_100,8,>100
4012,deck,705,31986758,92.1557217894,_100,4,>100
4013,payment,705,31987463,92.1577529357,_100,7,>100
4014,martha,705,31988168,92.1597840819,_100,6,>100
4015,charm,704,31988872,92.1618123472,_100,5,>100
4016,sigh,704,31989576,92.1638406124,_100,4,>100
4017,contained,704,31990280,92.1658688776,_100,9,>100
4018,trailer,703,31990983,92.1678942617,_100,7,>100
4019,terror,703,31991686,92.1699196458,_100,6,>100
4020,blah,703,31992389,92.17194503,_100,4,>100
4021,reward,703,31993092,92.1739704141,_100,6,>100
4022,admitted,703,31993795,92.1759957983,_100,8,>100
4023,utterly,703,31994498,92.1780211824,_100,7,>100
4024,sizes,703,31995201,92.1800465665,_100,5,>100
4025,disappeared,703,31995904,92.1820719507,_100,11,>100
4026,deserves,702,31996606,92.1840944538,_100,8,>100
4027,collected,702,31997308,92.1861169569,_100,9,>100
4028,relaxed,701,31998009,92.1881365789,_100,7,>100
4029,shares,701,31998710,92.1901562009,_100,6,>100
4030,foster,701,31999411,92.1921758229,_100,6,>100
4031,fool,701,32000112,92.194195445,_100,4,>100
4032,desperately,701,32000813,92.196215067,_100,11,>100
4033,partners,701,32001514,92.198234689,_100,8,>100
4034,existed,701,32002215,92.200254311,_100,7,>100
4035,deny,701,32002916,92.2022739331,_100,4,>100
4036,captured,701,32003617,92.2042935551,_100,8,>100
4037,lewis,700,32004317,92.2063102961,_100,5,>100
4038,700,700,32005017,92.208327037,_100,3,>100
4039,guns,700,32005717,92.210343778,_100,4,>100
4040,fishing,700,32006417,92.212360519,_100,7,>100
4041,cares,699,32007116,92.2143743789,_100,5,>100
4042,requirements,699,32007815,92.2163882388,_100,12,>100
4043,inevitable,698,32008513,92.2183992176,_100,10,>100
4044,widely,698,32009211,92.2204101965,_100,6,>100
4045,radical,698,32009909,92.2224211753,_100,7,>100
4046,corners,697,32010606,92.2244292731,_100,7,>100
4047,apples,697,32011303,92.2264373709,_100,6,>100
4048,exposure,697,32012000,92.2284454687,_100,8,>100
4049,preheat,697,32012697,92.2304535665,_100,7,>100
4050,someday,697,32013394,92.2324616643,_100,7,>100
4051,successfully,696,32014090,92.234466881,_100,12,>100
4052,extraordinary,696,32014786,92.2364720977,_100,13,>100
4053,yay,696,32015482,92.2384773145,_100,3,>100
4054,license,696,32016178,92.2404825312,_100,7,>100
4055,shy,695,32016873,92.2424848669,_100,3,>100
4056,updated,695,32017568,92.2444872026,_100,7,>100
4057,principle,695,32018263,92.2464895382,_100,9,>100
4058,emily,694,32018957,92.2484889928,_100,5,>100
4059,sew,694,32019651,92.2504884475,_100,3,>100
4060,regional,694,32020345,92.2524879021,_100,8,>100
4061,temporary,693,32021038,92.2544844756,_100,9,>100
4062,struggles,693,32021731,92.2564810492,_100,9,>100
4063,legislation,693,32022424,92.2584776227,_100,11,>100
4064,tail,693,32023117,92.2604741963,_100,4,>100
4065,bears,693,32023810,92.2624707699,_100,5,>100
4066,asia,693,32024503,92.2644673434,_100,4,>100
4067,republic,693,32025196,92.266463917,_100,8,>100
4068,ceiling,693,32025889,92.2684604905,_100,7,>100
4069,dig,693,32026582,92.2704570641,_100,3,>100
4070,wilson,692,32027274,92.2724507566,_100,6,>100
4071,chip,692,32027966,92.2744444491,_100,4,>100
4072,emotionally,692,32028658,92.2764381416,_100,11,>100
4073,intent,692,32029350,92.2784318341,_100,6,>100
4074,steal,691,32030041,92.2804226455,_100,5,>100
4075,preferred,691,32030732,92.282413457,_100,9,>100
4076,reveals,691,32031423,92.2844042684,_100,7,>100
4077,egypt,691,32032114,92.2863950798,_100,5,>100
4078,fortunate,691,32032805,92.2883858913,_100,9,>100
4079,controlled,690,32033495,92.2903738217,_100,10,>100
4080,locations,690,32034185,92.292361752,_100,9,>100
4081,ohio,690,32034875,92.2943496824,_100,4,>100
4082,creamy,690,32035565,92.2963376128,_100,6,>100
4083,pointing,690,32036255,92.2983255432,_100,8,>100
4084,equivalent,690,32036945,92.3003134736,_100,10,>100
4085,memorable,689,32037634,92.3022985229,_100,9,>100
4086,motivation,689,32038323,92.3042835722,_100,10,>100
4087,identified,689,32039012,92.3062686215,_100,10,>100
4088,legend,689,32039701,92.3082536709,_100,6,>100
4089,georgia,688,32040389,92.3102358391,_100,7,>100
4090,cultures,688,32041077,92.3122180074,_100,8,>100
4091,electronic,688,32041765,92.3142001757,_100,10,>100
4092,collective,688,32042453,92.3161823439,_100,10,>100
4093,iran,687,32043140,92.3181616311,_100,4,>100
4094,mouse,687,32043827,92.3201409183,_100,5,>100
4095,gross,687,32044514,92.3221202055,_100,5,>100
4096,washed,687,32045201,92.3240994927,_100,6,>100
4097,alice,686,32045887,92.3260758989,_100,5,>100
4098,productive,686,32046573,92.328052305,_100,10,>100
4099,broad,686,32047259,92.3300287112,_100,5,>100
4100,wanna,686,32047945,92.3320051173,_100,5,>100
4101,artwork,685,32048630,92.3339786424,_100,7,>100
4102,neat,685,32049315,92.3359521675,_100,4,>100
4103,behaviour,685,32050000,92.3379256926,_100,9,>100
4104,scratch,685,32050685,92.3398992177,_100,7,>100
4105,buddy,684,32051369,92.3418698617,_100,5,>100
4106,applications,684,32052053,92.3438405058,_100,12,>100
4107,consumers,684,32052737,92.3458111498,_100,9,>100
4108,lap,683,32053420,92.3477789128,_100,3,>100
4109,branches,683,32054103,92.3497466757,_100,8,>100
4110,resort,683,32054786,92.3517144387,_100,6,>100
4111,atlantic,683,32055469,92.3536822017,_100,8,>100
4112,repeated,683,32056152,92.3556499646,_100,8,>100
4113,russia,682,32056834,92.3576148466,_100,6,>100
4114,christianity,681,32057515,92.3595768474,_100,12,>100
4115,potentially,681,32058196,92.3615388483,_100,11,>100
4116,tuned,681,32058877,92.3635008491,_100,5,>100
4117,overwhelmed,681,32059558,92.36546285,_100,11,>100
4118,creature,681,32060239,92.3674248508,_100,8,>100
4119,sliced,680,32060919,92.3693839706,_100,6,>100
4120,fortune,680,32061599,92.3713430904,_100,7,>100
4121,occupy,680,32062279,92.3733022102,_100,6,>100
4122,updates,680,32062959,92.37526133,_100,7,>100
4123,experts,680,32063639,92.3772204498,_100,7,>100
4124,difficulty,679,32064318,92.3791766885,_100,10,>100
4125,fame,679,32064997,92.3811329273,_100,4,>100
4126,wildlife,679,32065676,92.383089166,_100,8,>100
4127,pursue,679,32066355,92.3850454048,_100,6,>100
4128,colleagues,679,32067034,92.3870016435,_100,10,>100
4129,relaxing,679,32067713,92.3889578822,_100,8,>100
4130,slide,679,32068392,92.390914121,_100,5,>100
4131,soda,678,32069070,92.3928674787,_100,4,>100
4132,genius,678,32069748,92.3948208363,_100,6,>100
4133,venue,678,32070426,92.396774194,_100,5,>100
4134,clay,678,32071104,92.3987275517,_100,4,>100
4135,flew,677,32071781,92.4006780283,_100,4,>100
4136,corruption,677,32072458,92.4026285049,_100,10,>100
4137,saint,677,32073135,92.4045789816,_100,5,>100
4138,involve,677,32073812,92.4065294582,_100,7,>100
4139,abilities,676,32074488,92.4084770537,_100,9,>100
4140,kelly,676,32075164,92.4104246493,_100,5,>100
4141,hurts,676,32075840,92.4123722449,_100,5,>100
4142,countless,676,32076516,92.4143198404,_100,9,>100
4143,grill,676,32077192,92.416267436,_100,5,>100
4144,wishing,676,32077868,92.4182150315,_100,7,>100
4145,believing,675,32078543,92.4201597461,_100,9,>100
4146,cleaned,675,32079218,92.4221044606,_100,7,>100
4147,tutorial,675,32079893,92.4240491751,_100,8,>100
4148,producing,675,32080568,92.4259938896,_100,9,>100
4149,tbsp,675,32081243,92.4279386041,_100,4,>100
4150,experiencing,675,32081918,92.4298833186,_100,12,>100
4151,succeed,675,32082593,92.4318280331,_100,7,>100
4152,decline,675,32083268,92.4337727476,_100,7,>100
4153,wins,675,32083943,92.4357174621,_100,4,>100
4154,chapters,675,32084618,92.4376621766,_100,8,>100
4155,creek,674,32085292,92.43960401,_100,5,>100
4156,briefly,674,32085966,92.4415458435,_100,7,>100
4157,underground,674,32086640,92.4434876769,_100,11,>100
4158,pitch,674,32087314,92.4454295104,_100,5,>100
4159,charming,674,32087988,92.4473713438,_100,8,>100
4160,champion,674,32088662,92.4493131773,_100,8,>100
4161,rubber,673,32089335,92.4512521296,_100,6,>100
4162,carrots,673,32090008,92.453191082,_100,7,>100
4163,drag,673,32090681,92.4551300344,_100,4,>100
4164,parliament,672,32091353,92.4570661057,_100,10,>100
4165,ipad,672,32092025,92.4590021771,_100,4,>100
4166,luke,671,32092696,92.4609353673,_100,4,>100
4167,steady,671,32093367,92.4628685576,_100,6,>100
4168,acknowledge,671,32094038,92.4648017479,_100,11,>100
4169,fewer,671,32094709,92.4667349382,_100,5,>100
4170,highlights,670,32095379,92.4686652474,_100,10,>100
4171,luxury,670,32096049,92.4705955566,_100,6,>100
4172,handy,670,32096719,92.4725258658,_100,5,>100
4173,explaining,670,32097389,92.474456175,_100,10,>100
4174,denied,669,32098058,92.4763836031,_100,6,>100
4175,behalf,669,32098727,92.4783110313,_100,6,>100
4176,resource,669,32099396,92.4802384595,_100,8,>100
4177,consideration,669,32100065,92.4821658876,_100,13,>100
4178,operating,669,32100734,92.4840933158,_100,9,>100
4179,revelation,668,32101402,92.4860178629,_100,10,>100
4180,logic,668,32102070,92.4879424099,_100,5,>100
4181,trash,668,32102738,92.489866957,_100,5,>100
4182,anne,668,32103406,92.4917915041,_100,4,>100
4183,candidates,667,32104073,92.4937131702,_100,10,>100
4184,fitting,667,32104740,92.4956348362,_100,7,>100
4185,contribute,667,32105407,92.4975565022,_100,10,>100
4186,thee,667,32106074,92.4994781683,_100,4,>100
4187,symptoms,667,32106741,92.5013998343,_100,8,>100
4188,correctly,667,32107408,92.5033215003,_100,9,>100
4189,hug,667,32108075,92.5052431664,_100,3,>100
4190,crash,667,32108742,92.5071648324,_100,5,>100
4191,soap,666,32109408,92.5090836174,_100,4,>100
4192,racial,666,32110074,92.5110024024,_100,6,>100
4193,scrap,666,32110740,92.5129211873,_100,5,>100
4194,frustration,666,32111406,92.5148399723,_100,11,>100
4195,hook,666,32112072,92.5167587573,_100,4,>100
4196,concerning,665,32112737,92.5186746612,_100,10,>100
4197,casual,665,32113402,92.5205905651,_100,6,>100
4198,scenario,665,32114067,92.5225064691,_100,8,>100
4199,rear,665,32114732,92.524422373,_100,4,>100
4200,heels,664,32115396,92.5263353958,_100,5,>100
4201,shipping,664,32116060,92.5282484187,_100,8,>100
4202,el,663,32116723,92.5301585605,_100,2,>100
4203,bean,663,32117386,92.5320687023,_100,4,>100
4204,lighter,662,32118048,92.533975963,_100,7,>100
4205,territory,662,32118710,92.5358832238,_100,9,>100
4206,touching,661,32119371,92.5377876035,_100,8,>100
4207,rob,661,32120032,92.5396919832,_100,3,>100
4208,wherever,661,32120693,92.5415963628,_100,8,>100
4209,whoever,661,32121354,92.5435007425,_100,7,>100
4210,prizes,661,32122015,92.5454051222,_100,6,>100
4211,cells,661,32122676,92.5473095019,_100,5,>100
4212,beads,660,32123336,92.5492110005,_100,5,>100
4213,shiny,660,32123996,92.5511124991,_100,5,>100
4214,harsh,660,32124656,92.5530139978,_100,5,>100
4215,outdoor,660,32125316,92.5549154964,_100,7,>100
4216,jail,659,32125975,92.556814114,_100,4,>100
4217,emma,659,32126634,92.5587127315,_100,4,>100
4218,thirty,659,32127293,92.5606113491,_100,6,>100
4219,creator,658,32127951,92.5625070856,_100,7,>100
4220,employment,658,32128609,92.5644028221,_100,10,>100
4221,factory,658,32129267,92.5662985586,_100,7,>100
4222,roughly,658,32129925,92.5681942951,_100,7,>100
4223,scottish,658,32130583,92.5700900316,_100,8,>100
4224,recognition,657,32131240,92.5719828871,_100,11,>100
4225,da,657,32131897,92.5738757425,_100,2,>100
4226,dropping,657,32132554,92.575768598,_100,8,>100
4227,loads,656,32133210,92.5776585724,_100,5,>100
4228,rejected,656,32133866,92.5795485468,_100,8,>100
4229,distant,656,32134522,92.5814385212,_100,7,>100
4230,refreshing,656,32135178,92.5833284956,_100,10,>100
4231,grave,655,32135833,92.5852155889,_100,5,>100
4232,rural,655,32136488,92.5871026822,_100,5,>100
4233,lovers,655,32137143,92.5889897756,_100,6,>100
4234,eager,655,32137798,92.5908768689,_100,5,>100
4235,exclusive,655,32138453,92.5927639622,_100,9,>100
4236,disorder,655,32139108,92.5946510556,_100,8,>100
4237,venture,654,32139762,92.5965352678,_100,7,>100
4238,cent,654,32140416,92.5984194801,_100,4,>100
4239,elite,654,32141070,92.6003036924,_100,5,>100
4240,canvas,654,32141724,92.6021879047,_100,6,>100
4241,reporting,654,32142378,92.6040721169,_100,9,>100
4242,retail,653,32143031,92.6059534481,_100,6,>100
4243,nails,653,32143684,92.6078347794,_100,5,>100
4244,protected,653,32144337,92.6097161106,_100,9,>100
4245,accepting,653,32144990,92.6115974418,_100,9,>100
4246,weekends,652,32145642,92.613475892,_100,8,>100
4247,resulting,652,32146294,92.6153543421,_100,9,>100
4248,priest,652,32146946,92.6172327923,_100,6,>100
4249,represented,652,32147598,92.6191112424,_100,11,>100
4250,pressed,651,32148249,92.6209868115,_100,7,>100
4251,kindle,651,32148900,92.6228623806,_100,6,>100
4252,finance,651,32149551,92.6247379497,_100,7,>100
4253,freezer,650,32150201,92.6266106378,_100,7,>100
4254,tops,650,32150851,92.6284833258,_100,4,>100
4255,divorce,650,32151501,92.6303560138,_100,7,>100
4256,embossing,650,32152151,92.6322287019,_100,9,>100
4257,bothered,650,32152801,92.6341013899,_100,8,>100
4258,samples,650,32153451,92.635974078,_100,7,>100
4259,cinema,650,32154101,92.637846766,_100,6,>100
4260,graduate,650,32154751,92.639719454,_100,8,>100
4261,spotted,649,32155400,92.641589261,_100,7,>100
4262,weapon,649,32156049,92.643459068,_100,6,>100
4263,parenting,649,32156698,92.645328875,_100,9,>100
4264,container,648,32157346,92.6471958009,_100,9,>100
4265,crafty,648,32157994,92.6490627268,_100,6,>100
4266,dip,648,32158642,92.6509296528,_100,3,>100
4267,bug,648,32159290,92.6527965787,_100,3,>100
4268,mild,647,32159937,92.6546606236,_100,4,>100
4269,tasks,647,32160584,92.6565246684,_100,5,>100
4270,employee,647,32161231,92.6583887133,_100,8,>100
4271,professionals,647,32161878,92.6602527581,_100,13,>100
4272,um,647,32162525,92.662116803,_100,2,>100
4273,motivated,646,32163171,92.6639779668,_100,9,>100
4274,centuries,645,32163816,92.6658362496,_100,9,>100
4275,spell,645,32164461,92.6676945323,_100,5,>100
4276,pacific,645,32165106,92.6695528151,_100,7,>100
4277,priority,645,32165751,92.6714110978,_100,8,>100
4278,meaningful,644,32166395,92.6732664995,_100,10,>100
4279,counting,644,32167039,92.6751219012,_100,8,>100
4280,supporters,644,32167683,92.6769773029,_100,10,>100
4281,stays,643,32168326,92.6788298235,_100,5,>100
4282,error,643,32168969,92.6806823441,_100,5,>100
4283,arena,643,32169612,92.6825348648,_100,5,>100
4284,firmly,643,32170255,92.6843873854,_100,6,>100
4285,blank,643,32170898,92.686239906,_100,5,>100
4286,drivers,643,32171541,92.6880924267,_100,7,>100
4287,jokes,642,32172183,92.6899420662,_100,5,>100
4288,adoption,642,32172825,92.6917917058,_100,8,>100
4289,programme,642,32173467,92.6936413454,_100,9,>100
4290,stations,642,32174109,92.695490985,_100,8,>100
4291,strips,642,32174751,92.6973406245,_100,6,>100
4292,ties,642,32175393,92.6991902641,_100,4,>100
4293,establish,642,32176035,92.7010399037,_100,9,>100
4294,pastor,642,32176677,92.7028895432,_100,6,>100
4295,significantly,641,32177318,92.7047363018,_100,13,>100
4296,rome,641,32177959,92.7065830603,_100,4,>100
4297,kings,640,32178599,92.7084269377,_100,5,>100
4298,struggled,640,32179239,92.7102708152,_100,9,>100
4299,crust,640,32179879,92.7121146926,_100,5,>100
4300,statistics,640,32180519,92.7139585701,_100,10,>100
4301,sheep,640,32181159,92.7158024475,_100,5,>100
4302,haha,640,32181799,92.717646325,_100,4,>100
4303,disciples,640,32182439,92.7194902025,_100,9,>100
4304,highway,639,32183078,92.7213311989,_100,7,>100
4305,custom,639,32183717,92.7231721952,_100,6,>100
4306,machines,639,32184356,92.7250131916,_100,8,>100
4307,mp,639,32184995,92.726854188,_100,2,>100
4308,guarantee,639,32185634,92.7286951844,_100,9,>100
4309,greece,638,32186272,92.7305332998,_100,6,>100
4310,exploring,638,32186910,92.7323714151,_100,9,>100
4311,knitting,638,32187548,92.7342095305,_100,8,>100
4312,protein,638,32188186,92.7360476458,_100,7,>100
4313,trading,638,32188824,92.7378857611,_100,7,>100
4314,flag,637,32189461,92.7397209954,_100,4,>100
4315,waking,637,32190098,92.7415562297,_100,6,>100
4316,lit,636,32190734,92.7433885829,_100,3,>100
4317,user,636,32191370,92.7452209361,_100,4,>100
4318,doll,636,32192006,92.7470532894,_100,4,>100
4319,clip,636,32192642,92.7488856426,_100,4,>100
4320,wonders,636,32193278,92.7507179958,_100,7,>100
4321,pearl,635,32193913,92.752547468,_100,5,>100
4322,penny,635,32194548,92.7543769401,_100,5,>100
4323,rating,635,32195183,92.7562064123,_100,6,>100
4324,distinct,635,32195818,92.7580358844,_100,8,>100
4325,memorial,635,32196453,92.7598653566,_100,8,>100
4326,keen,634,32197087,92.7616919477,_100,4,>100
4327,studied,634,32197721,92.7635185388,_100,7,>100
4328,spin,633,32198354,92.7653422489,_100,4,>100
4329,poured,633,32198987,92.7671659589,_100,6,>100
4330,cheaper,633,32199620,92.768989669,_100,7,>100
4331,johnny,632,32200252,92.7708104979,_100,6,>100
4332,consumer,632,32200884,92.7726313269,_100,8,>100
4333,fitness,632,32201516,92.7744521559,_100,7,>100
4334,farmer,632,32202148,92.7762729849,_100,6,>100
4335,wished,632,32202780,92.7780938139,_100,6,>100
4336,invisible,631,32203411,92.7799117618,_100,9,>100
4337,anc,630,32204041,92.7817268287,_100,3,>100
4338,filed,630,32204671,92.7835418956,_100,5,>100
4339,argued,630,32205301,92.7853569624,_100,6,>100
4340,releases,630,32205931,92.7871720293,_100,8,>100
4341,comics,629,32206560,92.7889842151,_100,6,>100
4342,categories,629,32207189,92.7907964009,_100,10,>100
4343,hosting,629,32207818,92.7926085867,_100,7,>100
4344,burst,629,32208447,92.7944207725,_100,5,>100
4345,retired,629,32209076,92.7962329584,_100,7,>100
4346,traditions,629,32209705,92.7980451442,_100,10,>100
4347,grain,628,32210333,92.7998544489,_100,5,>100
4348,rachel,628,32210961,92.8016637537,_100,6,>100
4349,porch,628,32211589,92.8034730584,_100,5,>100
4350,evolution,628,32212217,92.8052823632,_100,9,>100
4351,judges,628,32212845,92.8070916679,_100,6,>100
4352,musicians,628,32213473,92.8089009727,_100,9,>100
4353,republicans,627,32214100,92.8107073964,_100,11,>100
4354,divided,627,32214727,92.8125138201,_100,7,>100
4355,darker,627,32215354,92.8143202438,_100,6,>100
4356,tested,627,32215981,92.8161266675,_100,6,>100
4357,audio,627,32216608,92.8179330912,_100,5,>100
4358,mentally,627,32217235,92.8197395149,_100,8,>100
4359,submitted,627,32217862,92.8215459386,_100,9,>100
4360,movements,627,32218489,92.8233523622,_100,9,>100
4361,repeatedly,627,32219116,92.8251587859,_100,10,>100
4362,knock,627,32219743,92.8269652096,_100,5,>100
4363,volunteer,627,32220370,92.8287716333,_100,9,>100
4364,blown,626,32220996,92.830575176,_100,5,>100
4365,roast,626,32221622,92.8323787186,_100,5,>100
4366,chart,626,32222248,92.8341822612,_100,5,>100
4367,fails,626,32222874,92.8359858039,_100,5,>100
4368,towel,625,32223499,92.8377864654,_100,5,>100
4369,ain,625,32224124,92.839587127,_100,3,>100
4370,challenged,625,32224749,92.8413877886,_100,10,>100
4371,org,625,32225374,92.8431884502,_100,3,>100
4372,boards,625,32225999,92.8449891118,_100,6,>100
4373,joint,624,32226623,92.8467868923,_100,5,>100
4374,consistently,624,32227247,92.8485846728,_100,12,>100
4375,heal,624,32227871,92.8503824533,_100,4,>100
4376,proposal,624,32228495,92.8521802338,_100,8,>100
4377,sang,623,32229118,92.8539751333,_100,4,>100
4378,anxious,623,32229741,92.8557700328,_100,7,>100
4379,vehicles,623,32230364,92.8575649322,_100,8,>100
4380,towns,622,32230986,92.8593569506,_100,5,>100
4381,diverse,622,32231608,92.861148969,_100,7,>100
4382,jacob,622,32232230,92.8629409874,_100,5,>100
4383,shelter,622,32232852,92.8647330058,_100,7,>100
4384,spinach,622,32233474,92.8665250242,_100,7,>100
4385,punishment,622,32234096,92.8683170426,_100,10,>100
4386,sized,622,32234718,92.870109061,_100,5,>100
4387,kansas,622,32235340,92.8719010794,_100,6,>100
4388,pillow,622,32235962,92.8736930978,_100,6,>100
4389,virtually,621,32236583,92.8754822352,_100,9,>100
4390,flavour,621,32237204,92.8772713725,_100,7,>100
4391,bizarre,621,32237825,92.8790605099,_100,7,>100
4392,discussions,621,32238446,92.8808496472,_100,11,>100
4393,beds,621,32239067,92.8826387846,_100,4,>100
4394,flip,620,32239687,92.8844250408,_100,4,>100
4395,sufficient,620,32240307,92.8862112971,_100,10,>100
4396,delicate,620,32240927,92.8879975534,_100,8,>100
4397,mask,620,32241547,92.8897838097,_100,4,>100
4398,approaching,620,32242167,92.891570066,_100,11,>100
4399,loan,620,32242787,92.8933563223,_100,4,>100
4400,essay,620,32243407,92.8951425785,_100,5,>100
4401,vulnerable,620,32244027,92.8969288348,_100,10,>100
4402,andy,620,32244647,92.8987150911,_100,4,>100
4403,etsy,619,32245266,92.9004984663,_100,4,>100
4404,improvement,619,32245885,92.9022818416,_100,11,>100
4405,cameron,619,32246504,92.9040652168,_100,7,>100
4406,sweat,619,32247123,92.905848592,_100,5,>100
4407,strangers,618,32247741,92.9076290862,_100,9,>100
4408,historic,618,32248359,92.9094095804,_100,8,>100
4409,worldwide,618,32248977,92.9111900745,_100,9,>100
4410,compete,618,32249595,92.9129705687,_100,7,>100
4411,loaded,618,32250213,92.9147510629,_100,6,>100
4412,claiming,617,32250830,92.916528676,_100,8,>100
4413,increases,617,32251447,92.9183062891,_100,9,>100
4414,pic,617,32252064,92.9200839022,_100,3,>100
4415,winds,617,32252681,92.9218615153,_100,5,>100
4416,hired,617,32253298,92.9236391284,_100,5,>100
4417,youngest,617,32253915,92.9254167415,_100,8,>100
4418,upstairs,616,32254531,92.9271914736,_100,8,>100
4419,nonetheless,616,32255147,92.9289662056,_100,11,>100
4420,plates,615,32255762,92.9307380566,_100,6,>100
4421,excess,615,32256377,92.9325099076,_100,6,>100
4422,landed,615,32256992,92.9342817586,_100,6,>100
4423,fee,615,32257607,92.9360536096,_100,3,>100
4424,suitable,615,32258222,92.9378254606,_100,8,>100
4425,complaining,614,32258836,92.9395944305,_100,11,>100
4426,resurrection,614,32259450,92.9413634004,_100,12,>100
4427,lid,614,32260064,92.9431323704,_100,3,>100
4428,gary,614,32260678,92.9449013403,_100,4,>100
4429,tin,614,32261292,92.9466703102,_100,3,>100
4430,stewart,614,32261906,92.9484392802,_100,7,>100
4431,spectacular,613,32262519,92.9502053691,_100,11,>100
4432,sadness,613,32263132,92.9519714579,_100,7,>100
4433,actively,613,32263745,92.9537375468,_100,8,>100
4434,warmth,613,32264358,92.9555036357,_100,6,>100
4435,presidential,613,32264971,92.9572697246,_100,12,>100
4436,palm,613,32265584,92.9590358134,_100,4,>100
4437,partly,613,32266197,92.9608019023,_100,6,>100
4438,parks,613,32266810,92.9625679912,_100,5,>100
4439,angle,613,32267423,92.9643340801,_100,5,>100
4440,defeat,612,32268035,92.9660972879,_100,6,>100
4441,maker,612,32268647,92.9678604957,_100,5,>100
4442,viewed,611,32269258,92.9696208224,_100,6,>100
4443,muscles,611,32269869,92.9713811492,_100,7,>100
4444,failing,611,32270480,92.973141476,_100,7,>100
4445,floating,611,32271091,92.9749018027,_100,8,>100
4446,topped,611,32271702,92.9766621295,_100,6,>100
4447,divide,611,32272313,92.9784224562,_100,6,>100
4448,chickens,611,32272924,92.980182783,_100,8,>100
4449,swim,610,32273534,92.9819402287,_100,4,>100
4450,exhibition,610,32274144,92.9836976744,_100,10,>100
4451,prospect,610,32274754,92.9854551201,_100,8,>100
4452,guidance,610,32275364,92.9872125658,_100,8,>100
4453,muscle,609,32275973,92.9889671304,_100,6,>100
4454,votes,609,32276582,92.9907216951,_100,5,>100
4455,oak,609,32277191,92.9924762597,_100,3,>100
4456,tragedy,609,32277800,92.9942308244,_100,7,>100
4457,lens,609,32278409,92.995985389,_100,4,>100
4458,sticky,608,32279017,92.9977370726,_100,6,>100
4459,apologize,608,32279625,92.9994887562,_100,9,>100
4460,smiles,608,32280233,93.0012404397,_100,6,>100
4461,immigrants,608,32280841,93.0029921233,_100,10,>100
4462,wider,608,32281449,93.0047438069,_100,5,>100
4463,blacks,608,32282057,93.0064954905,_100,6,>100
4464,carpet,607,32282664,93.008244293,_100,6,>100
4465,bunny,607,32283271,93.0099930955,_100,5,>100
4466,expand,607,32283878,93.0117418981,_100,6,>100
4467,golf,607,32284485,93.0134907006,_100,4,>100
4468,engineering,607,32285092,93.0152395031,_100,11,>100
4469,banner,606,32285698,93.0169854246,_100,6,>100
4470,lifted,606,32286304,93.018731346,_100,6,>100
4471,cable,606,32286910,93.0204772675,_100,5,>100
4472,michigan,606,32287516,93.022223189,_100,8,>100
4473,dutch,606,32288122,93.0239691104,_100,5,>100
4474,hardest,606,32288728,93.0257150319,_100,7,>100
4475,jerusalem,605,32289333,93.0274580723,_100,9,>100
4476,borders,605,32289938,93.0292011127,_100,7,>100
4477,properties,605,32290543,93.0309441531,_100,10,>100
4478,im,605,32291148,93.0326871935,_100,2,>100
4479,huh,605,32291753,93.0344302339,_100,3,>100
4480,teenager,605,32292358,93.0361732744,_100,8,>100
4481,responses,604,32292962,93.0379134337,_100,9,>100
4482,alleged,604,32293566,93.039653593,_100,7,>100
4483,references,604,32294170,93.0413937524,_100,10,>100
4484,matching,604,32294774,93.0431339117,_100,8,>100
4485,hooked,604,32295378,93.0448740711,_100,6,>100
4486,tan,603,32295981,93.0466113494,_100,3,>100
4487,qualities,603,32296584,93.0483486277,_100,9,>100
4488,intentions,603,32297187,93.050085906,_100,10,>100
4489,collecting,603,32297790,93.0518231843,_100,10,>100
4490,torn,603,32298393,93.0535604625,_100,4,>100
4491,overly,603,32298996,93.0552977408,_100,6,>100
4492,tends,603,32299599,93.0570350191,_100,5,>100
4493,approval,603,32300202,93.0587722974,_100,8,>100
4494,rounds,602,32300804,93.0605066946,_100,6,>100
4495,democrats,602,32301406,93.0622410919,_100,9,>100
4496,regime,602,32302008,93.0639754891,_100,6,>100
4497,humble,602,32302610,93.0657098863,_100,6,>100
4498,newest,602,32303212,93.0674442836,_100,6,>100
4499,governor,602,32303814,93.0691786808,_100,8,>100
4500,discipline,602,32304416,93.070913078,_100,10,>100
4501,interpretation,602,32305018,93.0726474753,_100,14,>100
4502,knit,600,32305618,93.0743761104,_100,4,>100
4503,conduct,600,32306218,93.0761047455,_100,7,>100
4504,ma,600,32306818,93.0778333806,_100,2,>100
4505,founded,600,32307418,93.0795620157,_100,7,>100
4506,beaten,600,32308018,93.0812906508,_100,6,>100
4507,600,600,32308618,93.0830192859,_100,3,>100
4508,twin,600,32309218,93.0847479211,_100,4,>100
4509,noble,599,32309817,93.0864736751,_100,5,>100
4510,resulted,599,32310416,93.0881994292,_100,8,>100
4511,worrying,599,32311015,93.0899251832,_100,8,>100
4512,camping,599,32311614,93.0916509373,_100,7,>100
4513,automatically,599,32312213,93.0933766913,_100,13,>100
4514,homework,599,32312812,93.0951024454,_100,8,>100
4515,reform,599,32313411,93.0968281995,_100,6,>100
4516,laura,599,32314010,93.0985539535,_100,5,>100
4517,relation,598,32314608,93.1002768265,_100,8,>100
4518,vice,598,32315206,93.1019996995,_100,4,>100
4519,grandfather,598,32315804,93.1037225725,_100,11,>100
4520,spite,598,32316402,93.1054454455,_100,5,>100
4521,journalist,598,32317000,93.1071683185,_100,10,>100
4522,referring,598,32317598,93.1088911915,_100,9,>100
4523,accompanied,598,32318196,93.1106140645,_100,11,>100
4524,worries,598,32318794,93.1123369375,_100,7,>100
4525,electricity,598,32319392,93.1140598105,_100,11,>100
4526,deaths,597,32319989,93.1157798024,_100,6,>100
4527,approved,597,32320586,93.1174997944,_100,8,>100
4528,drank,597,32321183,93.1192197863,_100,5,>100
4529,beast,597,32321780,93.1209397782,_100,5,>100
4530,acceptance,596,32322376,93.1226568891,_100,10,>100
4531,alexander,596,32322972,93.124374,_100,9,>100
4532,et,595,32323567,93.1260882298,_100,2,>100
4533,similarly,595,32324162,93.1278024596,_100,9,>100
4534,latin,595,32324757,93.1295166895,_100,5,>100
4535,perception,595,32325352,93.1312309193,_100,10,>100
4536,signing,595,32325947,93.1329451491,_100,7,>100
4537,injured,595,32326542,93.1346593789,_100,7,>100
4538,diamond,595,32327137,93.1363736088,_100,7,>100
4539,terribly,594,32327731,93.1380849575,_100,8,>100
4540,salmon,594,32328325,93.1397963063,_100,6,>100
4541,teenagers,594,32328919,93.141507655,_100,9,>100
4542,glimpse,594,32329513,93.1432190038,_100,7,>100
4543,proven,594,32330107,93.1449303526,_100,6,>100
4544,warming,594,32330701,93.1466417013,_100,7,>100
4545,bull,594,32331295,93.1483530501,_100,4,>100
4546,hobby,594,32331889,93.1500643989,_100,5,>100
4547,newspapers,594,32332483,93.1517757476,_100,10,>100
4548,threatened,593,32333076,93.1534842153,_100,10,>100
4549,facility,593,32333669,93.155192683,_100,8,>100
4550,settings,593,32334262,93.1569011507,_100,8,>100
4551,rapidly,593,32334855,93.1586096184,_100,7,>100
4552,odds,593,32335448,93.1603180861,_100,4,>100
4553,dont,592,32336040,93.1620236728,_100,4,>100
4554,extensive,592,32336632,93.1637292594,_100,9,>100
4555,risks,592,32337224,93.1654348461,_100,5,>100
4556,nyc,592,32337816,93.1671404327,_100,3,>100
4557,michelle,592,32338408,93.1688460194,_100,8,>100
4558,suits,592,32339000,93.170551606,_100,5,>100
4559,miller,592,32339592,93.1722571927,_100,6,>100
4560,jr,591,32340183,93.1739598983,_100,2,>100
4561,shore,591,32340774,93.1756626038,_100,5,>100
4562,wool,591,32341365,93.1773653094,_100,4,>100
4563,strawberry,591,32341956,93.179068015,_100,10,>100
4564,adore,591,32342547,93.1807707206,_100,5,>100
4565,cricket,591,32343138,93.1824734262,_100,7,>100
4566,appreciation,591,32343729,93.1841761318,_100,12,>100
4567,chill,591,32344320,93.1858788374,_100,5,>100
4568,vinegar,591,32344911,93.187581543,_100,7,>100
4569,elegant,591,32345502,93.1892842485,_100,7,>100
4570,arab,590,32346092,93.1909840731,_100,4,>100
4571,enthusiasm,590,32346682,93.1926838976,_100,10,>100
4572,encouragement,590,32347272,93.1943837221,_100,13,>100
4573,sum,589,32347861,93.1960806656,_100,3,>100
4574,murdered,589,32348450,93.1977776091,_100,8,>100
4575,squeeze,589,32349039,93.1994745525,_100,7,>100
4576,subsequent,589,32349628,93.201171496,_100,10,>100
4577,pro,589,32350217,93.2028684395,_100,3,>100
4578,sc,589,32350806,93.204565383,_100,2,>100
4579,worker,588,32351394,93.2062594454,_100,6,>100
4580,authentic,588,32351982,93.2079535078,_100,9,>100
4581,index,588,32352570,93.2096475702,_100,5,>100
4582,sneak,588,32353158,93.2113416326,_100,5,>100
4583,fathers,588,32353746,93.213035695,_100,7,>100
4584,crucial,588,32354334,93.2147297574,_100,7,>100
4585,arizona,588,32354922,93.2164238198,_100,7,>100
4586,wound,588,32355510,93.2181178823,_100,5,>100
4587,goat,587,32356097,93.2198090636,_100,4,>100
4588,percentage,587,32356684,93.221500245,_100,10,>100
4589,prints,587,32357271,93.2231914263,_100,6,>100
4590,smells,587,32357858,93.2248826077,_100,6,>100
4591,lamb,587,32358445,93.226573789,_100,4,>100
4592,yogurt,586,32359031,93.2282620893,_100,6,>100
4593,mighty,586,32359617,93.2299503896,_100,6,>100
4594,distribution,586,32360203,93.2316386899,_100,12,>100
4595,purse,586,32360789,93.2333269902,_100,5,>100
4596,offensive,585,32361374,93.2350124094,_100,9,>100
4597,brewers,585,32361959,93.2366978287,_100,7,>100
4598,consumption,585,32362544,93.2383832479,_100,11,>100
4599,virtual,583,32363127,93.240062905,_100,7,>100
4600,representative,583,32363710,93.2417425622,_100,14,>100
4601,viewing,583,32364293,93.2434222193,_100,7,>100
4602,announcement,583,32364876,93.2451018764,_100,12,>100
4603,carries,583,32365459,93.2467815335,_100,7,>100
4604,objective,582,32366041,93.2484583096,_100,9,>100
4605,mid,582,32366623,93.2501350856,_100,3,>100
4606,influenced,582,32367205,93.2518118617,_100,10,>100
4607,fever,582,32367787,93.2534886378,_100,5,>100
4608,dots,582,32368369,93.2551654138,_100,4,>100
4609,snap,581,32368950,93.2568393088,_100,4,>100
4610,kidding,581,32369531,93.2585132038,_100,7,>100
4611,column,581,32370112,93.2601870988,_100,6,>100
4612,sequence,581,32370693,93.2618609938,_100,8,>100
4613,toes,581,32371274,93.2635348888,_100,4,>100
4614,accent,581,32371855,93.2652087838,_100,6,>100
4615,terrorist,581,32372436,93.2668826788,_100,9,>100
4616,fundamental,581,32373017,93.2685565738,_100,11,>100
4617,welfare,581,32373598,93.2702304688,_100,7,>100
4618,aggressive,581,32374179,93.2719043638,_100,10,>100
4619,bubble,580,32374759,93.2735753778,_100,6,>100
4620,harvest,580,32375339,93.2752463917,_100,7,>100
4621,bruce,580,32375919,93.2769174057,_100,5,>100
4622,globe,580,32376499,93.2785884196,_100,5,>100
4623,burden,580,32377079,93.2802594336,_100,6,>100
4624,demanding,580,32377659,93.2819304475,_100,9,>100
4625,port,579,32378238,93.2835985804,_100,4,>100
4626,kicking,579,32378817,93.2852667133,_100,7,>100
4627,kindness,579,32379396,93.2869348462,_100,8,>100
4628,couples,579,32379975,93.288602979,_100,7,>100
4629,korean,579,32380554,93.2902711119,_100,6,>100
4630,racism,579,32381133,93.2919392448,_100,6,>100
4631,logical,579,32381712,93.2936073777,_100,7,>100
4632,chili,578,32382290,93.2952726295,_100,5,>100
4633,antique,578,32382868,93.2969378814,_100,7,>100
4634,addressed,578,32383446,93.2986031332,_100,9,>100
4635,halfway,578,32384024,93.300268385,_100,7,>100
4636,steam,577,32384601,93.3019307558,_100,5,>100
4637,emphasis,577,32385178,93.3035931265,_100,8,>100
4638,freely,577,32385755,93.3052554973,_100,6,>100
4639,autism,577,32386332,93.3069178681,_100,6,>100
4640,israeli,577,32386909,93.3085802388,_100,7,>100
4641,brick,577,32387486,93.3102426096,_100,5,>100
4642,appealing,577,32388063,93.3119049804,_100,9,>100
4643,concepts,577,32388640,93.3135673512,_100,8,>100
4644,hers,577,32389217,93.3152297219,_100,4,>100
4645,commented,577,32389794,93.3168920927,_100,9,>100
4646,occurs,577,32390371,93.3185544635,_100,6,>100
4647,lacking,576,32390947,93.3202139532,_100,7,>100
4648,drives,576,32391523,93.3218734429,_100,6,>100
4649,semester,576,32392099,93.3235329326,_100,8,>100
4650,breeze,576,32392675,93.3251924223,_100,6,>100
4651,davis,576,32393251,93.326851912,_100,5,>100
4652,victoria,575,32393826,93.3285085207,_100,8,>100
4653,un,575,32394401,93.3301651293,_100,2,>100
4654,edward,575,32394976,93.331821738,_100,6,>100
4655,suggestion,575,32395551,93.3334783466,_100,10,>100
4656,amber,575,32396126,93.3351349553,_100,5,>100
4657,reaches,574,32396700,93.3367886829,_100,7,>100
4658,disagree,574,32397274,93.3384424104,_100,8,>100
4659,unemployment,574,32397848,93.340096138,_100,12,>100
4660,courses,574,32398422,93.3417498656,_100,7,>100
4661,frequent,574,32398996,93.3434035932,_100,8,>100
4662,loans,574,32399570,93.3450573208,_100,5,>100
4663,torture,574,32400144,93.3467110484,_100,7,>100
4664,colorado,573,32400717,93.3483618949,_100,8,>100
4665,complaint,573,32401290,93.3500127415,_100,9,>100
4666,fort,573,32401863,93.351663588,_100,4,>100
4667,dakota,573,32402436,93.3533144345,_100,6,>100
4668,alike,573,32403009,93.3549652811,_100,5,>100
4669,vaguely,573,32403582,93.3566161276,_100,7,>100
4670,alas,572,32404154,93.3582640931,_100,4,>100
4671,deciding,572,32404726,93.3599120586,_100,8,>100
4672,heights,572,32405298,93.361560024,_100,7,>100
4673,scent,571,32405869,93.3632051085,_100,5,>100
4674,citizen,571,32406440,93.3648501929,_100,7,>100
4675,coats,571,32407011,93.3664952773,_100,5,>100
4676,voted,571,32407582,93.3681403617,_100,5,>100
4677,cocoa,571,32408153,93.3697854461,_100,5,>100
4678,operate,571,32408724,93.3714305305,_100,7,>100
4679,safely,571,32409295,93.373075615,_100,6,>100
4680,mixer,570,32409865,93.3747178183,_100,5,>100
4681,duck,570,32410435,93.3763600217,_100,4,>100
4682,fifteen,570,32411005,93.378002225,_100,7,>100
4683,delightful,570,32411575,93.3796444284,_100,10,>100
4684,useless,570,32412145,93.3812866318,_100,7,>100
4685,ny,569,32412714,93.3829259541,_100,2,>100
4686,stolen,569,32413283,93.3845652764,_100,6,>100
4687,lasted,569,32413852,93.3862045987,_100,6,>100
4688,caramel,568,32414420,93.3878410399,_100,7,>100
4689,producer,568,32414988,93.3894774811,_100,8,>100
4690,maximum,568,32415556,93.3911139224,_100,7,>100
4691,lager,568,32416124,93.3927503636,_100,5,>100
4692,ads,568,32416692,93.3943868049,_100,3,>100
4693,blowing,567,32417259,93.3960203651,_100,7,>100
4694,oregon,567,32417826,93.3976539252,_100,6,>100
4695,singapore,567,32418393,93.3992874854,_100,9,>100
4696,shorts,567,32418960,93.4009210456,_100,6,>100
4697,tech,567,32419527,93.4025546058,_100,4,>100
4698,chairman,566,32420093,93.4041852849,_100,8,>100
4699,register,566,32420659,93.405815964,_100,8,>100
4700,intend,566,32421225,93.4074466432,_100,6,>100
4701,affordable,566,32421791,93.4090773223,_100,10,>100
4702,strikes,566,32422357,93.4107080014,_100,7,>100
4703,whipped,566,32422923,93.4123386805,_100,7,>100
4704,colorful,565,32423488,93.4139664786,_100,8,>100
4705,katie,565,32424053,93.4155942767,_100,5,>100
4706,peel,565,32424618,93.4172220747,_100,4,>100
4707,cap,565,32425183,93.4188498728,_100,3,>100
4708,cave,565,32425748,93.4204776709,_100,4,>100
4709,psychological,565,32426313,93.4221054689,_100,13,>100
4710,unity,564,32426877,93.4237303859,_100,5,>100
4711,timing,564,32427441,93.4253553029,_100,6,>100
4712,guardian,564,32428005,93.4269802199,_100,8,>100
4713,knocked,564,32428569,93.428605137,_100,7,>100
4714,ups,564,32429133,93.430230054,_100,3,>100
4715,nursing,563,32429696,93.4318520899,_100,7,>100
4716,billy,563,32430259,93.4334741259,_100,5,>100
4717,frosting,563,32430822,93.4350961618,_100,8,>100
4718,pond,563,32431385,93.4367181978,_100,4,>100
4719,dealt,563,32431948,93.4383402337,_100,5,>100
4720,pint,563,32432511,93.4399622697,_100,4,>100
4721,junk,563,32433074,93.4415843056,_100,4,>100
4722,stare,563,32433637,93.4432063416,_100,5,>100
4723,jimmy,562,32434199,93.4448254964,_100,5,>100
4724,detective,562,32434761,93.4464446513,_100,9,>100
4725,guidelines,562,32435323,93.4480638062,_100,10,>100
4726,packing,562,32435885,93.4496829611,_100,7,>100
4727,clubs,562,32436447,93.451302116,_100,5,>100
4728,inc,562,32437009,93.4529212709,_100,3,>100
4729,silk,562,32437571,93.4545404258,_100,4,>100
4730,processes,562,32438133,93.4561595807,_100,9,>100
4731,wicked,562,32438695,93.4577787356,_100,6,>100
4732,lock,562,32439257,93.4593978905,_100,4,>100
4733,trapped,562,32439819,93.4610170454,_100,7,>100
4734,poster,561,32440380,93.4626333192,_100,6,>100
4735,arrest,561,32440941,93.464249593,_100,6,>100
4736,cape,560,32441501,93.4658629858,_100,4,>100
4737,sore,560,32442061,93.4674763786,_100,4,>100
4738,ceo,560,32442621,93.4690897713,_100,3,>100
4739,stressed,560,32443181,93.4707031641,_100,8,>100
4740,foam,560,32443741,93.4723165569,_100,4,>100
4741,defence,559,32444300,93.4739270686,_100,7,>100
4742,rick,559,32444859,93.4755375803,_100,4,>100
4743,obtain,559,32445418,93.477148092,_100,6,>100
4744,profound,559,32445977,93.4787586037,_100,8,>100
4745,frustrating,559,32446536,93.4803691155,_100,11,>100
4746,climbing,559,32447095,93.4819796272,_100,8,>100
4747,lip,559,32447654,93.4835901389,_100,3,>100
4748,hosted,559,32448213,93.4852006506,_100,6,>100
4749,sentences,559,32448772,93.4868111623,_100,9,>100
4750,adjust,559,32449331,93.488421674,_100,6,>100
4751,trek,559,32449890,93.4900321857,_100,4,>100
4752,satisfying,558,32450448,93.4916398164,_100,10,>100
4753,delighted,558,32451006,93.4932474471,_100,9,>100
4754,lean,558,32451564,93.4948550777,_100,4,>100
4755,observed,557,32452121,93.4964598273,_100,8,>100
4756,minority,557,32452678,93.4980645769,_100,8,>100
4757,coloring,557,32453235,93.4996693265,_100,8,>100
4758,tablespoons,557,32453792,93.5012740761,_100,11,>100
4759,compelling,557,32454349,93.5028788257,_100,10,>100
4760,discount,557,32454906,93.5044835753,_100,8,>100
4761,facilities,557,32455463,93.5060883249,_100,10,>100
4762,acquired,557,32456020,93.5076930745,_100,8,>100
4763,ego,556,32456576,93.509294943,_100,3,>100
4764,disappointment,556,32457132,93.5108968116,_100,14,>100
4765,arranged,556,32457688,93.5124986801,_100,8,>100
4766,dull,556,32458244,93.5141005487,_100,4,>100
4767,malaysia,556,32458800,93.5157024172,_100,8,>100
4768,promoting,556,32459356,93.5173042857,_100,9,>100
4769,jake,556,32459912,93.5189061543,_100,4,>100
4770,flowing,556,32460468,93.5205080228,_100,7,>100
4771,shirts,555,32461023,93.5221070103,_100,6,>100
4772,wrestling,555,32461578,93.5237059978,_100,9,>100
4773,computers,555,32462133,93.5253049853,_100,9,>100
4774,costume,555,32462688,93.5269039727,_100,7,>100
4775,admire,555,32463243,93.5285029602,_100,6,>100
4776,dumb,555,32463798,93.5301019477,_100,4,>100
4777,genuinely,554,32464352,93.5316980541,_100,9,>100
4778,symbol,554,32464906,93.5332941605,_100,6,>100
4779,min,554,32465460,93.534890267,_100,3,>100
4780,congratulations,554,32466014,93.5364863734,_100,15,>100
4781,aroma,554,32466568,93.5380824798,_100,5,>100
4782,wonderfully,554,32467122,93.5396785862,_100,11,>100
4783,ward,554,32467676,93.5412746927,_100,4,>100
4784,grilled,553,32468229,93.542867918,_100,7,>100
4785,corporation,553,32468782,93.5444611434,_100,11,>100
4786,cure,553,32469335,93.5460543687,_100,4,>100
4787,alan,553,32469888,93.5476475941,_100,4,>100
4788,messy,553,32470441,93.5492408195,_100,5,>100
4789,voting,553,32470994,93.5508340448,_100,6,>100
4790,shorter,553,32471547,93.5524272702,_100,7,>100
4791,combat,552,32472099,93.5540176145,_100,6,>100
4792,rainbow,552,32472651,93.5556079588,_100,7,>100
4793,susan,552,32473203,93.5571983031,_100,5,>100
4794,seattle,552,32473755,93.5587886474,_100,7,>100
4795,unschooling,552,32474307,93.5603789917,_100,11,>100
4796,mate,551,32474858,93.561966455,_100,4,>100
4797,paragraph,551,32475409,93.5635539182,_100,9,>100
4798,decorating,551,32475960,93.5651413815,_100,10,>100
4799,hats,551,32476511,93.5667288447,_100,4,>100
4800,procedure,551,32477062,93.568316308,_100,9,>100
4801,obsession,551,32477613,93.5699037712,_100,9,>100
4802,tourists,550,32478163,93.5714883534,_100,8,>100
4803,soccer,550,32478713,93.5730729356,_100,6,>100
4804,mushrooms,550,32479263,93.5746575178,_100,9,>100
4805,ron,550,32479813,93.5762421,_100,3,>100
4806,journalists,550,32480363,93.5778266821,_100,11,>100
4807,wealthy,550,32480913,93.5794112643,_100,7,>100
4808,heavenly,550,32481463,93.5809958465,_100,8,>100
4809,consistency,550,32482013,93.5825804287,_100,11,>100
4810,bucket,550,32482563,93.5841650109,_100,6,>100
4811,traveled,550,32483113,93.5857495931,_100,8,>100
4812,stages,549,32483662,93.5873312942,_100,6,>100
4813,abroad,549,32484211,93.5889129953,_100,6,>100
4814,efficient,549,32484760,93.5904946965,_100,9,>100
4815,stumbled,549,32485309,93.5920763976,_100,8,>100
4816,devoted,549,32485858,93.5936580987,_100,7,>100
4817,howard,548,32486406,93.5952369188,_100,6,>100
4818,requests,548,32486954,93.5968157389,_100,8,>100
4819,stable,548,32487502,93.5983945589,_100,6,>100
4820,trim,548,32488050,93.599973379,_100,4,>100
4821,conducted,547,32488597,93.601549318,_100,9,>100
4822,scored,547,32489144,93.603125257,_100,6,>100
4823,lands,547,32489691,93.6047011961,_100,5,>100
4824,jennifer,546,32490237,93.606274254,_100,8,>100
4825,savings,546,32490783,93.607847312,_100,7,>100
4826,functions,546,32491329,93.6094203699,_100,9,>100
4827,volunteers,546,32491875,93.6109934279,_100,10,>100
4828,lab,546,32492421,93.6125664858,_100,3,>100
4829,grasp,545,32492966,93.6141366627,_100,5,>100
4830,tackle,545,32493511,93.6157068396,_100,6,>100
4831,addiction,545,32494056,93.6172770165,_100,9,>100
4832,mount,545,32494601,93.6188471934,_100,5,>100
4833,parade,545,32495146,93.6204173703,_100,6,>100
4834,alarm,545,32495691,93.6219875472,_100,5,>100
4835,dynamic,545,32496236,93.6235577241,_100,7,>100
4836,linking,544,32496780,93.6251250199,_100,7,>100
4837,basics,544,32497324,93.6266923158,_100,6,>100
4838,strawberries,544,32497868,93.6282596116,_100,12,>100
4839,pr,544,32498412,93.6298269074,_100,2,>100
4840,lbs,544,32498956,93.6313942033,_100,3,>100
4841,barack,544,32499500,93.6329614991,_100,6,>100
4842,tricks,544,32500044,93.634528795,_100,6,>100
4843,necklace,543,32500587,93.6360932097,_100,8,>100
4844,communications,543,32501130,93.6376576245,_100,14,>100
4845,foil,543,32501673,93.6392220393,_100,4,>100
4846,unfortunate,543,32502216,93.6407864541,_100,11,>100
4847,pad,543,32502759,93.6423508688,_100,3,>100
4848,realm,543,32503302,93.6439152836,_100,5,>100
4849,virgin,543,32503845,93.6454796984,_100,6,>100
4850,tags,543,32504388,93.6470441132,_100,4,>100
4851,hire,543,32504931,93.648608528,_100,4,>100
4852,picks,543,32505474,93.6501729427,_100,5,>100
4853,funeral,543,32506017,93.6517373575,_100,7,>100
4854,runner,543,32506560,93.6533017723,_100,6,>100
4855,vegas,543,32507103,93.6548661871,_100,5,>100
4856,attracted,542,32507645,93.6564277208,_100,9,>100
4857,outstanding,542,32508187,93.6579892545,_100,11,>100
4858,paths,542,32508729,93.6595507882,_100,5,>100
4859,shell,542,32509271,93.661112322,_100,5,>100
4860,vocals,542,32509813,93.6626738557,_100,6,>100
4861,tent,542,32510355,93.6642353894,_100,4,>100
4862,initiative,542,32510897,93.6657969231,_100,10,>100
4863,pastry,542,32511439,93.6673584568,_100,6,>100
4864,fluffy,541,32511980,93.6689171095,_100,6,>100
4865,placing,541,32512521,93.6704757622,_100,7,>100
4866,shining,541,32513062,93.6720344148,_100,7,>100
4867,curry,541,32513603,93.6735930675,_100,5,>100
4868,llc,541,32514144,93.6751517201,_100,3,>100
4869,infection,541,32514685,93.6767103728,_100,9,>100
4870,pencil,540,32515225,93.6782661444,_100,6,>100
4871,manchester,540,32515765,93.679821916,_100,10,>100
4872,poet,540,32516305,93.6813776876,_100,4,>100
4873,attract,540,32516845,93.6829334592,_100,7,>100
4874,travelling,539,32517384,93.6844863498,_100,10,>100
4875,diversity,539,32517923,93.6860392403,_100,9,>100
4876,gluten,539,32518462,93.6875921308,_100,6,>100
4877,amen,539,32519001,93.6891450214,_100,4,>100
4878,forgiveness,538,32519539,93.6906950309,_100,11,>100
4879,biblical,538,32520077,93.6922450404,_100,8,>100
4880,stroke,538,32520615,93.6937950499,_100,6,>100
4881,feast,538,32521153,93.6953450593,_100,5,>100
4882,superior,537,32521690,93.6968921878,_100,8,>100
4883,wardrobe,537,32522227,93.6984393162,_100,8,>100
4884,grandparents,537,32522764,93.6999864446,_100,12,>100
4885,boundaries,537,32523301,93.701533573,_100,10,>100
4886,miserable,537,32523838,93.7030807015,_100,9,>100
4887,backyard,537,32524375,93.7046278299,_100,8,>100
4888,happier,536,32524911,93.7061720773,_100,7,>100
4889,korea,536,32525447,93.7077163246,_100,5,>100
4890,counts,536,32525983,93.709260572,_100,6,>100
4891,remote,536,32526519,93.7108048194,_100,6,>100
4892,supportive,536,32527055,93.7123490667,_100,10,>100
4893,react,535,32527590,93.7138904331,_100,5,>100
4894,origin,535,32528125,93.7154317994,_100,6,>100
4895,donate,535,32528660,93.7169731657,_100,6,>100
4896,masters,535,32529195,93.718514532,_100,7,>100
4897,altogether,535,32529730,93.7200558983,_100,10,>100
4898,basketball,535,32530265,93.7215972646,_100,10,>100
4899,hood,534,32530799,93.7231357499,_100,4,>100
4900,crop,534,32531333,93.7246742351,_100,4,>100
4901,bang,533,32531866,93.7262098393,_100,4,>100
4902,prayed,533,32532399,93.7277454435,_100,6,>100
4903,barrel,533,32532932,93.7292810477,_100,6,>100
4904,amazingly,533,32533465,93.7308166519,_100,9,>100
4905,commonly,533,32533998,93.7323522561,_100,8,>100
4906,blew,532,32534530,93.7338849792,_100,4,>100
4907,cameras,532,32535062,93.7354177023,_100,7,>100
4908,palace,532,32535594,93.7369504255,_100,6,>100
4909,transportation,532,32536126,93.7384831486,_100,14,>100
4910,secondary,532,32536658,93.7400158718,_100,9,>100
4911,needing,532,32537190,93.7415485949,_100,7,>100
4912,scrapbook,532,32537722,93.743081318,_100,9,>100
4913,herbs,531,32538253,93.7446111601,_100,5,>100
4914,privilege,531,32538784,93.7461410022,_100,9,>100
4915,periods,531,32539315,93.7476708442,_100,7,>100
4916,pouring,531,32539846,93.7492006863,_100,7,>100
4917,external,531,32540377,93.7507305284,_100,8,>100
4918,islands,530,32540907,93.7522574894,_100,7,>100
4919,tremendous,530,32541437,93.7537844504,_100,10,>100
4920,gates,530,32541967,93.7553114115,_100,5,>100
4921,courts,530,32542497,93.7568383725,_100,6,>100
4922,supposedly,530,32543027,93.7583653335,_100,10,>100
4923,employed,530,32543557,93.7598922945,_100,8,>100
4924,extract,529,32544086,93.7614163745,_100,7,>100
4925,selfish,529,32544615,93.7629404544,_100,7,>100
4926,sweetness,528,32545143,93.7644616533,_100,9,>100
4927,pulls,528,32545671,93.7659828522,_100,5,>100
4928,intimate,528,32546199,93.7675040511,_100,8,>100
4929,tendency,528,32546727,93.76902525,_100,8,>100
4930,crossing,528,32547255,93.7705464489,_100,8,>100
4931,crushed,528,32547783,93.7720676478,_100,7,>100
4932,barn,528,32548311,93.7735888467,_100,4,>100
4933,pockets,527,32548838,93.7751071646,_100,7,>100
4934,damaged,527,32549365,93.7766254824,_100,7,>100
4935,backing,527,32549892,93.7781438003,_100,7,>100
4936,wasted,527,32550419,93.7796621181,_100,6,>100
4937,decorated,527,32550946,93.7811804359,_100,9,>100
4938,expense,527,32551473,93.7826987538,_100,7,>100
4939,academy,527,32552000,93.7842170716,_100,7,>100
4940,hugs,526,32552526,93.7857325084,_100,4,>100
4941,texts,526,32553052,93.7872479452,_100,5,>100
4942,myth,526,32553578,93.788763382,_100,4,>100
4943,confusing,526,32554104,93.7902788188,_100,9,>100
4944,aimed,526,32554630,93.7917942555,_100,5,>100
4945,elderly,526,32555156,93.7933096923,_100,7,>100
4946,contacted,525,32555681,93.7948222481,_100,9,>100
4947,talents,525,32556206,93.7963348038,_100,7,>100
4948,belgian,524,32556730,93.7978444784,_100,7,>100
4949,boost,524,32557254,93.7993541531,_100,5,>100
4950,submission,524,32557778,93.8008638278,_100,10,>100
4951,rushed,524,32558302,93.8023735024,_100,6,>100
4952,substantial,524,32558826,93.8038831771,_100,11,>100
4953,shocking,524,32559350,93.8053928518,_100,8,>100
4954,amendment,524,32559874,93.8069025264,_100,9,>100
4955,bench,524,32560398,93.8084122011,_100,5,>100
4956,stamping,523,32560921,93.8099189947,_100,8,>100
4957,behold,523,32561444,93.8114257883,_100,6,>100
4958,christopher,523,32561967,93.8129325819,_100,11,>100
4959,editors,523,32562490,93.8144393755,_100,7,>100
4960,mustard,523,32563013,93.8159461692,_100,7,>100
4961,solely,523,32563536,93.8174529628,_100,6,>100
4962,requested,523,32564059,93.8189597564,_100,9,>100
4963,hatred,523,32564582,93.82046655,_100,6,>100
4964,bitterness,523,32565105,93.8219733436,_100,10,>100
4965,sword,522,32565627,93.8234772561,_100,5,>100
4966,conservatives,522,32566149,93.8249811687,_100,13,>100
4967,senses,522,32566671,93.8264850812,_100,6,>100
4968,relatives,522,32567193,93.8279889938,_100,9,>100
4969,retirement,521,32567714,93.8294900253,_100,10,>100
4970,broadcast,521,32568235,93.8309910568,_100,9,>100
4971,uniform,521,32568756,93.8324920883,_100,7,>100
4972,offices,521,32569277,93.8339931197,_100,7,>100
4973,dna,521,32569798,93.8354941512,_100,3,>100
4974,architecture,521,32570319,93.8369951827,_100,12,>100
4975,privacy,521,32570840,93.8384962142,_100,7,>100
4976,registered,521,32571361,93.8399972457,_100,10,>100
4977,pudding,520,32571881,93.8414953961,_100,7,>100
4978,publicly,520,32572401,93.8429935466,_100,8,>100
4979,realizing,520,32572921,93.844491697,_100,9,>100
4980,integrity,520,32573441,93.8459898474,_100,9,>100
4981,mat,520,32573961,93.8474879979,_100,3,>100
4982,ian,520,32574481,93.8489861483,_100,3,>100
4983,toddler,520,32575001,93.8504842987,_100,7,>100
4984,houston,520,32575521,93.8519824492,_100,7,>100
4985,ethnic,520,32576041,93.8534805996,_100,6,>100
4986,languages,519,32576560,93.854975869,_100,9,>100
4987,valid,519,32577079,93.8564711383,_100,5,>100
4988,clark,519,32577598,93.8579664077,_100,5,>100
4989,outer,519,32578117,93.8594616771,_100,5,>100
4990,critics,519,32578636,93.8609569465,_100,7,>100
4991,favour,519,32579155,93.8624522158,_100,6,>100
4992,enterprise,519,32579674,93.8639474852,_100,10,>100
4993,opera,519,32580193,93.8654427546,_100,5,>100
4994,imperial,518,32580711,93.8669351429,_100,8,>100
4995,matches,518,32581229,93.8684275312,_100,7,>100
4996,brutal,518,32581747,93.8699199195,_100,6,>100
4997,pubs,518,32582265,93.8714123079,_100,4,>100
4998,perceived,518,32582783,93.8729046962,_100,9,>100
4999,disappear,518,32583301,93.8743970845,_100,9,>100
5000,satan,518,32583819,93.8758894728,_100,5,>100
5001,estimated,517,32584336,93.8773789801,_100,9,>100
5002,phenomenon,517,32584853,93.8788684873,_100,10,>100
5003,ruled,517,32585370,93.8803579946,_100,5,>100
5004,jordan,517,32585887,93.8818475018,_100,6,>100
5005,rage,517,32586404,93.8833370091,_100,4,>100
5006,garbage,517,32586921,93.8848265163,_100,7,>100
5007,glance,516,32587437,93.8863131425,_100,6,>100
5008,toast,516,32587953,93.8877997687,_100,5,>100
5009,applies,516,32588469,93.8892863949,_100,7,>100
5010,prominent,516,32588985,93.8907730211,_100,9,>100
5011,companion,516,32589501,93.8922596473,_100,9,>100
5012,bloom,516,32590017,93.8937462735,_100,5,>100
5013,producers,516,32590533,93.8952328997,_100,9,>100
5014,demonstrate,516,32591049,93.8967195259,_100,11,>100
5015,hunter,515,32591564,93.8982032711,_100,6,>100
5016,mornings,515,32592079,93.8996870162,_100,8,>100
5017,yacht,515,32592594,93.9011707613,_100,5,>100
5018,shook,515,32593109,93.9026545065,_100,5,>100
5019,clinic,515,32593624,93.9041382516,_100,6,>100
5020,interaction,515,32594139,93.9056219968,_100,11,>100
5021,distracted,515,32594654,93.9071057419,_100,10,>100
5022,regulations,515,32595169,93.908589487,_100,11,>100
5023,shaking,515,32595684,93.9100732322,_100,7,>100
5024,simmer,515,32596199,93.9115569773,_100,6,>100
5025,reception,515,32596714,93.9130407225,_100,9,>100
5026,quoted,515,32597229,93.9145244676,_100,6,>100
5027,bomb,514,32597743,93.9160053317,_100,4,>100
5028,temperatures,514,32598257,93.9174861958,_100,12,>100
5029,extend,514,32598771,93.9189670598,_100,6,>100
5030,peppers,514,32599285,93.9204479239,_100,7,>100
5031,potter,514,32599799,93.921928788,_100,6,>100
5032,wandering,514,32600313,93.9234096521,_100,9,>100
5033,technically,514,32600827,93.9248905162,_100,11,>100
5034,repair,514,32601341,93.9263713803,_100,6,>100
5035,toronto,514,32601855,93.9278522443,_100,7,>100
5036,substance,514,32602369,93.9293331084,_100,9,>100
5037,anytime,514,32602883,93.9308139725,_100,7,>100
5038,manhattan,514,32603397,93.9322948366,_100,9,>100
5039,jonathan,514,32603911,93.9337757007,_100,8,>100
5040,monkey,514,32604425,93.9352565647,_100,6,>100
5041,holder,514,32604939,93.9367374288,_100,6,>100
5042,folder,513,32605452,93.9382154118,_100,6,>100
5043,boot,513,32605965,93.9396933949,_100,4,>100
5044,jon,513,32606478,93.9411713779,_100,3,>100
5045,displayed,513,32606991,93.9426493609,_100,9,>100
5046,threatening,513,32607504,93.9441273439,_100,11,>100
5047,longest,512,32608016,93.9456024459,_100,7,>100
5048,manages,512,32608528,93.9470775479,_100,7,>100
5049,stared,512,32609040,93.9485526498,_100,6,>100
5050,strategies,512,32609552,93.9500277518,_100,10,>100
5051,precisely,512,32610064,93.9515028538,_100,9,>100
5052,sue,512,32610576,93.9529779557,_100,3,>100
5053,transformed,512,32611088,93.9544530577,_100,11,>100
5054,separated,512,32611600,93.9559281597,_100,9,>100
5055,homeless,512,32612112,93.9574032616,_100,8,>100
5056,siblings,511,32612623,93.9588754825,_100,8,>100
5057,promotion,511,32613134,93.9603477034,_100,9,>100
5058,removal,511,32613645,93.9618199243,_100,7,>100
5059,peoples,511,32614156,93.9632921452,_100,7,>100
5060,intriguing,511,32614667,93.9647643661,_100,10,>100
5061,simultaneously,511,32615178,93.9662365871,_100,14,>100
5062,invitation,511,32615689,93.967708808,_100,10,>100
5063,establishment,511,32616200,93.9691810289,_100,13,>100
5064,lawn,510,32616710,93.9706503687,_100,4,>100
5065,sends,510,32617220,93.9721197086,_100,5,>100
5066,refers,510,32617730,93.9735890484,_100,6,>100
5067,lecture,510,32618240,93.9750583883,_100,7,>100
5068,containing,509,32618749,93.976524847,_100,10,>100
5069,lion,509,32619258,93.9779913058,_100,4,>100
5070,cousins,509,32619767,93.9794577646,_100,7,>100
5071,justify,509,32620276,93.9809242234,_100,7,>100
5072,representatives,509,32620785,93.9823906822,_100,15,>100
5073,allen,509,32621294,93.983857141,_100,5,>100
5074,collapse,509,32621803,93.9853235998,_100,8,>100
5075,puppy,509,32622312,93.9867900586,_100,5,>100
5076,trusted,509,32622821,93.9882565174,_100,7,>100
5077,icing,509,32623330,93.9897229761,_100,5,>100
5078,monitor,508,32623838,93.9911865539,_100,7,>100
5079,regards,508,32624346,93.9926501316,_100,7,>100
5080,engagement,508,32624854,93.9941137093,_100,10,>100
5081,patch,508,32625362,93.9955772871,_100,5,>100
5082,scope,508,32625870,93.9970408648,_100,5,>100
5083,madness,508,32626378,93.9985044425,_100,7,>100
5084,anthony,508,32626886,93.9999680203,_100,7,>100
5085,carter,508,32627394,94.001431598,_100,6,>100
5086,nama,508,32627902,94.0028951757,_100,4,>100
5087,threats,508,32628410,94.0043587534,_100,7,>100
5088,twisted,508,32628918,94.0058223312,_100,7,>100
5089,trends,508,32629426,94.0072859089,_100,6,>100
5090,dozens,507,32629933,94.0087466056,_100,6,>100
5091,findings,507,32630440,94.0102073022,_100,8,>100
5092,rides,507,32630947,94.0116679989,_100,5,>100
5093,corporations,507,32631454,94.0131286956,_100,12,>100
5094,liking,507,32631961,94.0145893923,_100,6,>100
5095,practicing,507,32632468,94.0160500889,_100,10,>100
5096,nope,507,32632975,94.0175107856,_100,4,>100
5097,infrastructure,506,32633481,94.0189686012,_100,14,>100
5098,idiot,506,32633987,94.0204264168,_100,5,>100
5099,registration,506,32634493,94.0218842324,_100,12,>100
5100,removing,506,32634999,94.0233420481,_100,8,>100
5101,digging,506,32635505,94.0247998637,_100,7,>100
5102,creepy,506,32636011,94.0262576793,_100,6,>100
5103,arrives,506,32636517,94.0277154949,_100,7,>100
5104,kindly,506,32637023,94.0291733105,_100,6,>100
5105,tourist,505,32637528,94.0306282451,_100,7,>100
5106,pine,505,32638033,94.0320831796,_100,4,>100
5107,portland,505,32638538,94.0335381142,_100,8,>100
5108,skillet,505,32639043,94.0349930487,_100,7,>100
5109,rally,505,32639548,94.0364479833,_100,5,>100
5110,justin,504,32640052,94.0379000368,_100,6,>100
5111,cared,504,32640556,94.0393520903,_100,5,>100
5112,peek,504,32641060,94.0408041438,_100,4,>100
5113,structures,504,32641564,94.0422561973,_100,10,>100
5114,nest,504,32642068,94.0437082508,_100,4,>100
5115,witnessed,503,32642571,94.0451574232,_100,9,>100
5116,protecting,503,32643074,94.0466065956,_100,10,>100
5117,enforcement,503,32643577,94.0480557681,_100,11,>100
5118,packaging,503,32644080,94.0495049405,_100,9,>100
5119,insisted,503,32644583,94.0509541129,_100,8,>100
5120,transport,502,32645085,94.0524004043,_100,9,>100
5121,wheels,502,32645587,94.0538466957,_100,6,>100
5122,significance,502,32646089,94.0552929871,_100,12,>100
5123,rhythm,502,32646591,94.0567392785,_100,6,>100
5124,versus,502,32647093,94.0581855698,_100,6,>100
5125,mature,502,32647595,94.0596318612,_100,6,>100
5126,marvel,502,32648097,94.0610781526,_100,6,>100
5127,injuries,502,32648599,94.062524444,_100,8,>100
5128,weakness,502,32649101,94.0639707354,_100,8,>100
5129,controversial,502,32649603,94.0654170267,_100,13,>100
5130,politically,501,32650104,94.0668604371,_100,11,>100
5131,grip,501,32650605,94.0683038474,_100,4,>100
5132,tissue,501,32651106,94.0697472577,_100,6,>100
5133,unnecessary,501,32651607,94.071190668,_100,11,>100
5134,laden,500,32652107,94.0726311973,_100,5,>100
5135,disturbing,500,32652607,94.0740717265,_100,10,>100
5136,rocky,500,32653107,94.0755122558,_100,5,>100
5137,josh,500,32653607,94.0769527851,_100,4,>100
5138,exhibit,500,32654107,94.0783933143,_100,7,>100
5139,tempted,500,32654607,94.0798338436,_100,7,>100
5140,500,500,32655107,94.0812743729,_100,3,>100
5141,porter,500,32655607,94.0827149021,_100,6,>100
5142,printing,499,32656106,94.0841525503,_100,8,>100
5143,indicate,499,32656605,94.0855901985,_100,8,>100
5144,brains,499,32657104,94.0870278467,_100,6,>100
5145,diary,499,32657603,94.0884654949,_100,5,>100
5146,romans,499,32658102,94.0899031431,_100,6,>100
5147,pig,499,32658601,94.0913407913,_100,3,>100
5148,loyal,499,32659100,94.0927784395,_100,5,>100
5149,reactions,498,32659598,94.0942132067,_100,9,>100
5150,concluded,498,32660096,94.0956479738,_100,9,>100
5151,sandwiches,498,32660594,94.097082741,_100,10,>100
5152,expenses,498,32661092,94.0985175081,_100,8,>100
5153,acted,498,32661590,94.0999522753,_100,5,>100
5154,diagnosed,498,32662088,94.1013870424,_100,9,>100
5155,velvet,498,32662586,94.1028218096,_100,6,>100
5156,pose,498,32663084,94.1042565767,_100,4,>100
5157,purely,498,32663582,94.1056913438,_100,6,>100
5158,em,498,32664080,94.107126111,_100,2,>100
5159,pause,498,32664578,94.1085608781,_100,5,>100
5160,deputy,498,32665076,94.1099956453,_100,6,>100
5161,russell,497,32665573,94.1114275314,_100,7,>100
5162,vegetarian,497,32666070,94.1128594175,_100,10,>100
5163,innovative,497,32666567,94.1142913035,_100,10,>100
5164,twilight,497,32667064,94.1157231896,_100,8,>100
5165,ham,497,32667561,94.1171550757,_100,3,>100
5166,invest,497,32668058,94.1185869618,_100,6,>100
5167,jamie,496,32668554,94.1200159668,_100,5,>100
5168,perfection,496,32669050,94.1214449719,_100,10,>100
5169,steven,496,32669546,94.1228739769,_100,6,>100
5170,elementary,496,32670042,94.1243029819,_100,10,>100
5171,consumed,496,32670538,94.1257319869,_100,8,>100
5172,travels,496,32671034,94.127160992,_100,7,>100
5173,burger,496,32671530,94.128589997,_100,6,>100
5174,crowded,496,32672026,94.130019002,_100,7,>100
5175,motor,495,32672521,94.131445126,_100,5,>100
5176,neutral,495,32673016,94.13287125,_100,7,>100
5177,sole,495,32673511,94.1342973739,_100,4,>100
5178,tucked,495,32674006,94.1357234979,_100,6,>100
5179,contribution,495,32674501,94.1371496219,_100,12,>100
5180,shout,495,32674996,94.1385757458,_100,5,>100
5181,proceeded,495,32675491,94.1400018698,_100,9,>100
5182,researchers,495,32675986,94.1414279938,_100,11,>100
5183,steak,494,32676480,94.1428512367,_100,5,>100
5184,suggesting,494,32676974,94.1442744796,_100,10,>100
5185,bent,494,32677468,94.1456977225,_100,4,>100
5186,syndrome,494,32677962,94.1471209654,_100,8,>100
5187,trials,494,32678456,94.1485442083,_100,6,>100
5188,recover,494,32678950,94.1499674512,_100,7,>100
5189,testimony,493,32679443,94.1513878131,_100,9,>100
5190,circus,493,32679936,94.1528081749,_100,6,>100
5191,cruel,493,32680429,94.1542285368,_100,5,>100
5192,jessica,493,32680922,94.1556488987,_100,7,>100
5193,communist,493,32681415,94.1570692605,_100,9,>100
5194,senate,493,32681908,94.1584896224,_100,6,>100
5195,strict,493,32682401,94.1599099842,_100,6,>100
5196,reverse,492,32682893,94.161327465,_100,7,>100
5197,zoo,492,32683385,94.1627449458,_100,3,>100
5198,battery,492,32683877,94.1641624266,_100,7,>100
5199,membership,492,32684369,94.1655799074,_100,10,>100
5200,networks,492,32684861,94.1669973882,_100,8,>100
5201,whisper,492,32685353,94.168414869,_100,7,>100
5202,learnt,492,32685845,94.1698323498,_100,6,>100
5203,measured,491,32686336,94.1712469495,_100,8,>100
5204,wives,491,32686827,94.1726615492,_100,5,>100
5205,diapers,491,32687318,94.174076149,_100,7,>100
5206,jeremy,491,32687809,94.1754907487,_100,6,>100
5207,abortion,491,32688300,94.1769053484,_100,8,>100
5208,freaking,491,32688791,94.1783199482,_100,8,>100
5209,emerged,491,32689282,94.1797345479,_100,7,>100
5210,cleared,490,32689772,94.1811462666,_100,7,>100
5211,lobby,490,32690262,94.1825579853,_100,5,>100
5212,ex,490,32690752,94.1839697039,_100,2,>100
5213,processor,490,32691242,94.1853814226,_100,9,>100
5214,log,490,32691732,94.1867931413,_100,3,>100
5215,questioning,490,32692222,94.18820486,_100,11,>100
5216,difficulties,490,32692712,94.1896165786,_100,12,>100
5217,rabbit,490,32693202,94.1910282973,_100,6,>100
5218,educated,489,32693691,94.1924371349,_100,8,>100
5219,allah,489,32694180,94.1938459726,_100,5,>100
5220,legacy,489,32694669,94.1952548102,_100,6,>100
5221,randomly,489,32695158,94.1966636478,_100,8,>100
5222,legitimate,489,32695647,94.1980724854,_100,10,>100
5223,floors,489,32696136,94.199481323,_100,6,>100
5224,pissed,489,32696625,94.2008901607,_100,6,>100
5225,seal,489,32697114,94.2022989983,_100,4,>100
5226,skinny,488,32697602,94.2037049548,_100,6,>100
5227,remembering,488,32698090,94.2051109114,_100,11,>100
5228,installed,488,32698578,94.2065168679,_100,9,>100
5229,mint,488,32699066,94.2079228245,_100,4,>100
5230,frames,488,32699554,94.2093287811,_100,6,>100
5231,exam,488,32700042,94.2107347376,_100,4,>100
5232,arthur,488,32700530,94.2121406942,_100,6,>100
5233,mud,488,32701018,94.2135466507,_100,3,>100
5234,organisation,488,32701506,94.2149526073,_100,12,>100
5235,fond,488,32701994,94.2163585639,_100,4,>100
5236,cart,487,32702481,94.2177616394,_100,4,>100
5237,purchasing,487,32702968,94.2191647149,_100,10,>100
5238,coalition,487,32703455,94.2205677904,_100,9,>100
5239,consists,487,32703942,94.2219708659,_100,8,>100
5240,unfair,487,32704429,94.2233739414,_100,6,>100
5241,characteristics,487,32704916,94.2247770169,_100,15,>100
5242,snacks,487,32705403,94.2261800924,_100,6,>100
5243,chatting,487,32705890,94.2275831679,_100,8,>100
5244,applying,487,32706377,94.2289862434,_100,8,>100
5245,appointed,486,32706863,94.2303864378,_100,9,>100
5246,layered,486,32707349,94.2317866323,_100,7,>100
5247,concentrate,486,32707835,94.2331868267,_100,11,>100
5248,logo,486,32708321,94.2345870211,_100,4,>100
5249,footage,486,32708807,94.2359872156,_100,7,>100
5250,depressed,486,32709293,94.23738741,_100,9,>100
5251,involvement,485,32709778,94.2387847234,_100,11,>100
5252,tragic,485,32710263,94.2401820368,_100,6,>100
5253,witch,484,32710747,94.2415764691,_100,5,>100
5254,fabrics,484,32711231,94.2429709015,_100,7,>100
5255,sequel,484,32711715,94.2443653338,_100,6,>100
5256,excuses,484,32712199,94.2457597661,_100,7,>100
5257,refrigerator,484,32712683,94.2471541984,_100,12,>100
5258,viewers,484,32713167,94.2485486308,_100,7,>100
5259,dreaming,484,32713651,94.2499430631,_100,8,>100
5260,contents,484,32714135,94.2513374954,_100,8,>100
5261,watches,484,32714619,94.2527319277,_100,7,>100
5262,channels,484,32715103,94.2541263601,_100,8,>100
5263,roger,483,32715586,94.2555179113,_100,5,>100
5264,margaret,483,32716069,94.2569094626,_100,8,>100
5265,uncovered,483,32716552,94.2583010139,_100,9,>100
5266,slave,483,32717035,94.2596925651,_100,5,>100
5267,moses,483,32717518,94.2610841164,_100,5,>100
5268,collections,483,32718001,94.2624756677,_100,11,>100
5269,arriving,483,32718484,94.2638672189,_100,8,>100
5270,guessing,483,32718967,94.2652587702,_100,8,>100
5271,evident,483,32719450,94.2666503215,_100,7,>100
5272,ip,483,32719933,94.2680418727,_100,2,>100
5273,organizing,483,32720416,94.269433424,_100,10,>100
5274,continually,482,32720898,94.2708220942,_100,11,>100
5275,exit,482,32721380,94.2722107644,_100,4,>100
5276,handsome,482,32721862,94.2735994346,_100,8,>100
5277,pays,482,32722344,94.2749881048,_100,4,>100
5278,striking,482,32722826,94.276376775,_100,8,>100
5279,touches,482,32723308,94.2777654452,_100,7,>100
5280,er,481,32723789,94.2791512344,_100,2,>100
5281,describing,481,32724270,94.2805370235,_100,10,>100
5282,rub,481,32724751,94.2819228127,_100,3,>100
5283,encountered,481,32725232,94.2833086018,_100,11,>100
5284,complaints,480,32725712,94.2846915099,_100,10,>100
5285,healthier,480,32726192,94.286074418,_100,9,>100
5286,retreat,480,32726672,94.2874573261,_100,7,>100
5287,battles,480,32727152,94.2888402342,_100,7,>100
5288,cope,480,32727632,94.2902231423,_100,4,>100
5289,vietnam,480,32728112,94.2916060504,_100,7,>100
5290,athletes,480,32728592,94.2929889585,_100,8,>100
5291,freeze,479,32729071,94.2943689855,_100,6,>100
5292,moore,479,32729550,94.2957490126,_100,5,>100
5293,en,479,32730029,94.2971290396,_100,2,>100
5294,payments,479,32730508,94.2985090666,_100,8,>100
5295,summary,479,32730987,94.2998890937,_100,7,>100
5296,speakers,479,32731466,94.3012691207,_100,8,>100
5297,hurting,479,32731945,94.3026491477,_100,7,>100
5298,accessible,479,32732424,94.3040291748,_100,10,>100
5299,freak,479,32732903,94.3054092018,_100,5,>100
5300,tricky,478,32733381,94.3067863478,_100,6,>100
5301,pressing,478,32733859,94.3081634937,_100,8,>100
5302,maintenance,478,32734337,94.3095406397,_100,11,>100
5303,slipped,478,32734815,94.3109177857,_100,7,>100
5304,stack,478,32735293,94.3122949317,_100,5,>100
5305,decor,478,32735771,94.3136720776,_100,5,>100
5306,owns,478,32736249,94.3150492236,_100,4,>100
5307,pit,477,32736726,94.3164234885,_100,3,>100
5308,ban,477,32737203,94.3177977534,_100,3,>100
5309,partnership,477,32737680,94.3191720184,_100,11,>100
5310,deadly,477,32738157,94.3205462833,_100,6,>100
5311,overseas,477,32738634,94.3219205482,_100,8,>100
5312,cottage,477,32739111,94.3232948131,_100,7,>100
5313,nursery,477,32739588,94.324669078,_100,7,>100
5314,hurry,477,32740065,94.3260433429,_100,5,>100
5315,abc,477,32740542,94.3274176078,_100,3,>100
5316,backed,477,32741019,94.3287918728,_100,6,>100
5317,packages,477,32741496,94.3301661377,_100,8,>100
5318,courtesy,476,32741972,94.3315375215,_100,8,>100
5319,needle,476,32742448,94.3329089054,_100,6,>100
5320,draws,476,32742924,94.3342802893,_100,5,>100
5321,columbia,476,32743400,94.3356516731,_100,8,>100
5322,supports,476,32743876,94.337023057,_100,8,>100
5323,hates,476,32744352,94.3383944408,_100,5,>100
5324,exercises,476,32744828,94.3397658247,_100,9,>100
5325,tray,476,32745304,94.3411372085,_100,4,>100
5326,sausage,476,32745780,94.3425085924,_100,7,>100
5327,jerry,476,32746256,94.3438799763,_100,5,>100
5328,understands,475,32746731,94.3452484791,_100,11,>100
5329,sydney,475,32747206,94.3466169819,_100,6,>100
5330,transformation,475,32747681,94.3479854847,_100,14,>100
5331,victorian,475,32748156,94.3493539874,_100,9,>100
5332,knight,475,32748631,94.3507224902,_100,6,>100
5333,honesty,475,32749106,94.352090993,_100,7,>100
5334,awe,474,32749580,94.3534566148,_100,3,>100
5335,apps,474,32750054,94.3548222365,_100,4,>100
5336,sophisticated,474,32750528,94.3561878583,_100,13,>100
5337,bid,474,32751002,94.35755348,_100,3,>100
5338,depend,474,32751476,94.3589191017,_100,6,>100
5339,sunset,474,32751950,94.3602847235,_100,6,>100
5340,guessed,474,32752424,94.3616503452,_100,7,>100
5341,dislike,474,32752898,94.363015967,_100,7,>100
5342,wales,474,32753372,94.3643815887,_100,5,>100
5343,embossed,474,32753846,94.3657472105,_100,8,>100
5344,tiger,474,32754320,94.3671128322,_100,5,>100
5345,cheer,474,32754794,94.3684784539,_100,5,>100
5346,verses,474,32755268,94.3698440757,_100,6,>100
5347,ripped,473,32755741,94.3712068164,_100,6,>100
5348,duke,473,32756214,94.372569557,_100,4,>100
5349,evenly,473,32756687,94.3739322977,_100,6,>100
5350,translation,473,32757160,94.3752950384,_100,11,>100
5351,horizon,473,32757633,94.3766577791,_100,7,>100
5352,tossed,472,32758105,94.3780176387,_100,6,>100
5353,darling,472,32758577,94.3793774983,_100,7,>100
5354,stove,472,32759049,94.380737358,_100,5,>100
5355,punched,472,32759521,94.3820972176,_100,7,>100
5356,squash,472,32759993,94.3834570772,_100,6,>100
5357,networking,472,32760465,94.3848169368,_100,10,>100
5358,improving,472,32760937,94.3861767964,_100,9,>100
5359,kitty,471,32761408,94.387533775,_100,5,>100
5360,nightmare,471,32761879,94.3888907536,_100,9,>100
5361,accidentally,471,32762350,94.3902477321,_100,12,>100
5362,diaper,471,32762821,94.3916047107,_100,6,>100
5363,stressful,471,32763292,94.3929616893,_100,9,>100
5364,downstairs,471,32763763,94.3943186678,_100,10,>100
5365,convenient,470,32764233,94.3956727653,_100,10,>100
5366,bulk,470,32764703,94.3970268628,_100,4,>100
5367,extension,470,32765173,94.3983809604,_100,9,>100
5368,minimal,470,32765643,94.3997350579,_100,7,>100
5369,ownership,470,32766113,94.4010891554,_100,9,>100
5370,certificate,469,32766582,94.4024403718,_100,11,>100
5371,ruin,469,32767051,94.4037915883,_100,4,>100
5372,terrorists,469,32767520,94.4051428047,_100,10,>100
5373,loaf,469,32767989,94.4064940212,_100,4,>100
5374,karen,469,32768458,94.4078452376,_100,5,>100
5375,poorly,469,32768927,94.4091964541,_100,6,>100
5376,vague,469,32769396,94.4105476705,_100,5,>100
5377,helen,469,32769865,94.4118988869,_100,5,>100
5378,cruise,469,32770334,94.4132501034,_100,6,>100
5379,teaches,469,32770803,94.4146013198,_100,7,>100
5380,ebay,469,32771272,94.4159525363,_100,4,>100
5381,su,468,32771740,94.4173008717,_100,2,>100
5382,observe,468,32772208,94.4186492071,_100,7,>100
5383,replacement,468,32772676,94.4199975425,_100,11,>100
5384,upside,468,32773144,94.4213458778,_100,6,>100
5385,booth,467,32773611,94.4226913322,_100,5,>100
5386,gig,467,32774078,94.4240367865,_100,3,>100
5387,kong,467,32774545,94.4253822408,_100,4,>100
5388,founder,467,32775012,94.4267276952,_100,7,>100
5389,recommendations,467,32775479,94.4280731495,_100,15,>100
5390,domain,467,32775946,94.4294186038,_100,6,>100
5391,orleans,467,32776413,94.4307640582,_100,7,>100
5392,anticipation,466,32776879,94.4321066314,_100,12,>100
5393,managing,466,32777345,94.4334492047,_100,8,>100
5394,patterned,466,32777811,94.434791778,_100,9,>100
5395,rows,466,32778277,94.4361343512,_100,4,>100
5396,stadium,465,32778742,94.4374740435,_100,7,>100
5397,maintaining,465,32779207,94.4388137357,_100,11,>100
5398,bearing,465,32779672,94.4401534279,_100,7,>100
5399,jealous,465,32780137,94.4414931201,_100,7,>100
5400,premise,465,32780602,94.4428328123,_100,7,>100
5401,actress,465,32781067,94.4441725045,_100,7,>100
5402,acid,465,32781532,94.4455121967,_100,4,>100
5403,spectrum,465,32781997,94.446851889,_100,8,>100
5404,candle,464,32782461,94.4481887001,_100,6,>100
5405,gardening,464,32782925,94.4495255113,_100,9,>100
5406,bobby,464,32783389,94.4508623224,_100,5,>100
5407,chemical,464,32783853,94.4521991336,_100,8,>100
5408,gordon,464,32784317,94.4535359447,_100,6,>100
5409,curse,464,32784781,94.4548727559,_100,5,>100
5410,reflected,464,32785245,94.456209567,_100,9,>100
5411,nonsense,464,32785709,94.4575463782,_100,8,>100
5412,preserve,464,32786173,94.4588831894,_100,8,>100
5413,edit,464,32786637,94.4602200005,_100,4,>100
5414,julie,464,32787101,94.4615568117,_100,5,>100
5415,chasing,464,32787565,94.4628936228,_100,7,>100
5416,firstly,463,32788028,94.4642275529,_100,7,>100
5417,vocal,463,32788491,94.465561483,_100,5,>100
5418,arrangement,463,32788954,94.4668954131,_100,11,>100
5419,loop,463,32789417,94.4682293432,_100,4,>100
5420,scores,463,32789880,94.4695632733,_100,6,>100
5421,outfits,463,32790343,94.4708972034,_100,7,>100
5422,betty,462,32790805,94.4722282524,_100,5,>100
5423,produces,462,32791267,94.4735593015,_100,8,>100
5424,indie,462,32791729,94.4748903505,_100,5,>100
5425,popularity,462,32792191,94.4762213996,_100,10,>100
5426,celebrity,462,32792653,94.4775524486,_100,9,>100
5427,shrimp,462,32793115,94.4788834976,_100,6,>100
5428,decorate,462,32793577,94.4802145467,_100,8,>100
5429,revenue,461,32794038,94.4815427146,_100,7,>100
5430,ignorance,461,32794499,94.4828708826,_100,9,>100
5431,taxi,461,32794960,94.4841990506,_100,4,>100
5432,anticipated,461,32795421,94.4855272186,_100,11,>100
5433,candles,460,32795881,94.4868525055,_100,7,>100
5434,confess,460,32796341,94.4881777924,_100,7,>100
5435,stepping,460,32796801,94.4895030793,_100,8,>100
5436,barry,460,32797261,94.4908283663,_100,5,>100
5437,floral,460,32797721,94.4921536532,_100,6,>100
5438,adopt,460,32798181,94.4934789401,_100,5,>100
5439,greens,460,32798641,94.494804227,_100,6,>100
5440,wisconsin,460,32799101,94.496129514,_100,9,>100
5441,charts,460,32799561,94.4974548009,_100,6,>100
5442,ritual,460,32800021,94.4987800878,_100,6,>100
5443,stretched,459,32800480,94.5001024937,_100,9,>100
5444,deemed,459,32800939,94.5014248995,_100,6,>100
5445,brad,459,32801398,94.5027473054,_100,4,>100
5446,pc,458,32801856,94.5040668302,_100,2,>100
5447,backwards,458,32802314,94.505386355,_100,9,>100
5448,respected,458,32802772,94.5067058798,_100,9,>100
5449,soldier,458,32803230,94.5080254046,_100,7,>100
5450,lincoln,458,32803688,94.5093449294,_100,7,>100
5451,realization,458,32804146,94.5106644542,_100,11,>100
5452,boiling,458,32804604,94.511983979,_100,7,>100
5453,flood,458,32805062,94.5133035038,_100,5,>100
5454,yelling,458,32805520,94.5146230286,_100,7,>100
5455,adams,457,32805977,94.5159396724,_100,5,>100
5456,spends,457,32806434,94.5172563161,_100,6,>100
5457,ted,457,32806891,94.5185729599,_100,3,>100
5458,cow,457,32807348,94.5198896036,_100,3,>100
5459,approaches,457,32807805,94.5212062473,_100,10,>100
5460,rude,457,32808262,94.5225228911,_100,4,>100
5461,terrified,457,32808719,94.5238395348,_100,9,>100
5462,cans,457,32809176,94.5251561786,_100,4,>100
5463,lawyers,457,32809633,94.5264728223,_100,7,>100
5464,centers,457,32810090,94.5277894661,_100,7,>100
5465,targeted,456,32810546,94.5291032288,_100,8,>100
5466,satisfaction,456,32811002,94.5304169914,_100,12,>100
5467,atlanta,456,32811458,94.5317307541,_100,7,>100
5468,determination,456,32811914,94.5330445168,_100,13,>100
5469,signature,456,32812370,94.5343582795,_100,9,>100
5470,dot,456,32812826,94.5356720422,_100,3,>100
5471,alot,456,32813282,94.5369858049,_100,4,>100
5472,telephone,456,32813738,94.5382995676,_100,9,>100
5473,saints,456,32814194,94.5396133303,_100,6,>100
5474,emerging,455,32814649,94.5409242119,_100,8,>100
5475,almond,455,32815104,94.5422350935,_100,6,>100
5476,nowadays,455,32815559,94.5435459751,_100,8,>100
5477,profession,455,32816014,94.5448568568,_100,10,>100
5478,typing,455,32816469,94.5461677384,_100,6,>100
5479,openly,455,32816924,94.54747862,_100,6,>100
5480,stored,455,32817379,94.5487895017,_100,6,>100
5481,peers,455,32817834,94.5501003833,_100,5,>100
5482,sells,455,32818289,94.5514112649,_100,5,>100
5483,learns,455,32818744,94.5527221465,_100,6,>100
5484,duties,454,32819198,94.5540301471,_100,6,>100
5485,annoyed,454,32819652,94.5553381477,_100,7,>100
5486,microsoft,454,32820106,94.5566461482,_100,9,>100
5487,pilot,454,32820560,94.5579541488,_100,5,>100
5488,brewed,454,32821014,94.5592621494,_100,6,>100
5489,consuming,454,32821468,94.56057015,_100,9,>100
5490,clinton,454,32821922,94.5618781505,_100,7,>100
5491,anonymous,454,32822376,94.5631861511,_100,9,>100
5492,gaining,454,32822830,94.5644941517,_100,7,>100
5493,incorporate,454,32823284,94.5658021522,_100,11,>100
5494,copics,453,32823737,94.5671072717,_100,6,>100
5495,alliance,453,32824190,94.5684123913,_100,8,>100
5496,ken,453,32824643,94.5697175108,_100,3,>100
5497,thai,453,32825096,94.5710226303,_100,4,>100
5498,tart,453,32825549,94.5723277498,_100,4,>100
5499,squares,453,32826002,94.5736328693,_100,7,>100
5500,partially,453,32826455,94.5749379888,_100,9,>100
5501,spreading,453,32826908,94.5762431083,_100,9,>100
5502,stampin,453,32827361,94.5775482278,_100,7,>100
5503,spouse,453,32827814,94.5788533474,_100,6,>100
5504,fluid,453,32828267,94.5801584669,_100,5,>100
5505,monsters,452,32828719,94.5814607053,_100,8,>100
5506,freshly,452,32829171,94.5827629438,_100,7,>100
5507,robin,452,32829623,94.5840651822,_100,5,>100
5508,springs,452,32830075,94.5853674207,_100,7,>100
5509,noon,452,32830527,94.5866696591,_100,4,>100
5510,responsibilities,452,32830979,94.5879718976,_100,16,>100
5511,coupon,452,32831431,94.589274136,_100,6,>100
5512,audiences,452,32831883,94.5905763745,_100,9,>100
5513,revealing,452,32832335,94.5918786129,_100,9,>100
5514,rainy,451,32832786,94.5931779703,_100,5,>100
5515,morgan,451,32833237,94.5944773277,_100,6,>100
5516,honour,451,32833688,94.5957766851,_100,6,>100
5517,wipe,451,32834139,94.5970760425,_100,4,>100
5518,ashamed,451,32834590,94.5983753999,_100,7,>100
5519,sixth,451,32835041,94.5996747573,_100,5,>100
5520,lasting,451,32835492,94.6009741147,_100,7,>100
5521,fifty,450,32835942,94.602270591,_100,5,>100
5522,elephant,450,32836392,94.6035670674,_100,8,>100
5523,julia,450,32836842,94.6048635437,_100,5,>100
5524,yourselves,450,32837292,94.60616002,_100,10,>100
5525,jay,450,32837742,94.6074564964,_100,3,>100
5526,450,450,32838192,94.6087529727,_100,3,>100
5527,dimension,450,32838642,94.610049449,_100,9,>100
5528,surprises,450,32839092,94.6113459254,_100,9,>100
5529,mortgage,450,32839542,94.6126424017,_100,8,>100
5530,promising,449,32839991,94.613935997,_100,9,>100
5531,fights,449,32840440,94.6152295923,_100,6,>100
5532,protagonist,449,32840889,94.6165231876,_100,11,>100
5533,translated,449,32841338,94.6178167828,_100,10,>100
5534,thoughtful,449,32841787,94.6191103781,_100,10,>100
5535,counted,449,32842236,94.6204039734,_100,7,>100
5536,broth,449,32842685,94.6216975687,_100,5,>100
5537,generate,449,32843134,94.6229911639,_100,8,>100
5538,pa,449,32843583,94.6242847592,_100,2,>100
5539,altered,449,32844032,94.6255783545,_100,7,>100
5540,vibrant,448,32844480,94.6268690687,_100,7,>100
5541,judging,448,32844928,94.6281597829,_100,7,>100
5542,magnificent,447,32845375,94.6294476161,_100,11,>100
5543,snapped,447,32845822,94.6307354492,_100,7,>100
5544,cookbook,447,32846269,94.6320232824,_100,8,>100
5545,whatsoever,447,32846716,94.6333111156,_100,10,>100
5546,laughs,447,32847163,94.6345989487,_100,6,>100
5547,charlotte,447,32847610,94.6358867819,_100,9,>100
5548,deadline,447,32848057,94.6371746151,_100,8,>100
5549,tablespoon,447,32848504,94.6384624482,_100,10,>100
5550,reasonably,447,32848951,94.6397502814,_100,10,>100
5551,medication,446,32849397,94.6410352335,_100,10,>100
5552,dependent,446,32849843,94.6423201856,_100,9,>100
5553,occupied,446,32850289,94.6436051377,_100,8,>100
5554,folded,446,32850735,94.6448900898,_100,6,>100
5555,lucy,446,32851181,94.6461750419,_100,4,>100
5556,utter,445,32851626,94.6474571129,_100,5,>100
5557,philip,445,32852071,94.648739184,_100,6,>100
5558,interact,445,32852516,94.650021255,_100,8,>100
5559,examine,445,32852961,94.6513033261,_100,7,>100
5560,circuit,445,32853406,94.6525853971,_100,7,>100
5561,rational,445,32853851,94.6538674681,_100,8,>100
5562,tribute,444,32854295,94.6551466581,_100,7,>100
5563,defeated,444,32854739,94.6564258481,_100,8,>100
5564,belongs,444,32855183,94.6577050381,_100,7,>100
5565,cracked,444,32855627,94.6589842281,_100,7,>100
5566,inks,444,32856071,94.6602634181,_100,4,>100
5567,easiest,444,32856515,94.661542608,_100,7,>100
5568,hockey,444,32856959,94.662821798,_100,6,>100
5569,firms,444,32857403,94.664100988,_100,5,>100
5570,terrific,444,32857847,94.665380178,_100,8,>100
5571,purchases,444,32858291,94.666659368,_100,9,>100
5572,cops,443,32858734,94.6679356769,_100,4,>100
5573,propaganda,443,32859177,94.6692119858,_100,10,>100
5574,wears,443,32859620,94.6704882948,_100,5,>100
5575,digi,443,32860063,94.6717646037,_100,4,>100
5576,waist,443,32860506,94.6730409126,_100,5,>100
5577,forcing,443,32860949,94.6743172215,_100,7,>100
5578,shakespeare,442,32861391,94.6755906494,_100,11,>100
5579,copic,442,32861833,94.6768640773,_100,5,>100
5580,possession,442,32862275,94.6781375051,_100,10,>100
5581,hike,442,32862717,94.679410933,_100,4,>100
5582,darn,442,32863159,94.6806843609,_100,4,>100
5583,commentary,442,32863601,94.6819577887,_100,10,>100
5584,annie,441,32864042,94.6832283356,_100,5,>100
5585,stating,441,32864483,94.6844988824,_100,7,>100
5586,evolved,441,32864924,94.6857694292,_100,7,>100
5587,wax,441,32865365,94.687039976,_100,3,>100
5588,participation,441,32865806,94.6883105228,_100,13,>100
5589,upload,441,32866247,94.6895810696,_100,6,>100
5590,behave,441,32866688,94.6908516164,_100,6,>100
5591,artificial,441,32867129,94.6921221632,_100,10,>100
5592,suspended,441,32867570,94.69339271,_100,9,>100
5593,query,441,32868011,94.6946632568,_100,5,>100
5594,iii,441,32868452,94.6959338036,_100,3,>100
5595,chop,440,32868892,94.6972014694,_100,4,>100
5596,conscience,440,32869332,94.6984691351,_100,10,>100
5597,zealand,440,32869772,94.6997368009,_100,7,>100
5598,noodles,440,32870212,94.7010044666,_100,7,>100
5599,raining,440,32870652,94.7022721324,_100,7,>100
5600,switched,439,32871091,94.7035369171,_100,8,>100
5601,pipe,439,32871530,94.7048017018,_100,4,>100
5602,representation,439,32871969,94.7060664865,_100,14,>100
5603,seasonal,439,32872408,94.7073312712,_100,8,>100
5604,flame,439,32872847,94.7085960559,_100,5,>100
5605,bullying,439,32873286,94.7098608406,_100,8,>100
5606,economics,439,32873725,94.7111256252,_100,9,>100
5607,con,439,32874164,94.7123904099,_100,3,>100
5608,jan,439,32874603,94.7136551946,_100,3,>100
5609,dragged,439,32875042,94.7149199793,_100,7,>100
5610,trains,439,32875481,94.716184764,_100,6,>100
5611,soviet,438,32875919,94.7174466676,_100,6,>100
5612,rejection,438,32876357,94.7187085713,_100,9,>100
5613,soy,438,32876795,94.7199704749,_100,3,>100
5614,incorporated,438,32877233,94.7212323785,_100,12,>100
5615,delay,438,32877671,94.7224942822,_100,5,>100
5616,handling,438,32878109,94.7237561858,_100,8,>100
5617,despair,438,32878547,94.7250180894,_100,7,>100
5618,manufacturing,438,32878985,94.7262799931,_100,13,>100
5619,enjoys,438,32879423,94.7275418967,_100,6,>100
5620,allegedly,437,32879860,94.7288009193,_100,9,>100
5621,perry,437,32880297,94.7300599419,_100,5,>100
5622,studios,437,32880734,94.7313189644,_100,7,>100
5623,alter,437,32881171,94.732577987,_100,5,>100
5624,instruments,437,32881608,94.7338370096,_100,11,>100
5625,descriptions,437,32882045,94.7350960322,_100,12,>100
5626,isolated,437,32882482,94.7363550547,_100,8,>100
5627,ratio,437,32882919,94.7376140773,_100,5,>100
5628,skies,437,32883356,94.7388730999,_100,5,>100
5629,portrait,437,32883793,94.7401321225,_100,8,>100
5630,outline,436,32884229,94.741388264,_100,7,>100
5631,answering,436,32884665,94.7426444055,_100,9,>100
5632,drawer,436,32885101,94.743900547,_100,6,>100
5633,sponsored,436,32885537,94.7451566885,_100,9,>100
5634,stickers,436,32885973,94.74641283,_100,8,>100
5635,varieties,436,32886409,94.7476689716,_100,9,>100
5636,fork,435,32886844,94.748922232,_100,4,>100
5637,arrangements,435,32887279,94.7501754925,_100,12,>100
5638,pets,435,32887714,94.7514287529,_100,4,>100
5639,wander,435,32888149,94.7526820134,_100,6,>100
5640,backs,435,32888584,94.7539352739,_100,5,>100
5641,achievement,435,32889019,94.7551885343,_100,11,>100
5642,affects,435,32889454,94.7564417948,_100,7,>100
5643,graduated,435,32889889,94.7576950552,_100,9,>100
5644,emerge,435,32890324,94.7589483157,_100,6,>100
5645,locals,435,32890759,94.7602015761,_100,6,>100
5646,meditation,435,32891194,94.7614548366,_100,10,>100
5647,organised,435,32891629,94.7627080971,_100,9,>100
5648,cheek,434,32892063,94.7639584765,_100,5,>100
5649,trap,433,32892496,94.7652059748,_100,4,>100
5650,carbon,433,32892929,94.7664534731,_100,6,>100
5651,thumb,433,32893362,94.7677009715,_100,5,>100
5652,planting,433,32893795,94.7689484698,_100,8,>100
5653,baker,433,32894228,94.7701959682,_100,5,>100
5654,maria,433,32894661,94.7714434665,_100,5,>100
5655,innovation,433,32895094,94.7726909648,_100,10,>100
5656,tub,433,32895527,94.7739384632,_100,3,>100
5657,breasts,433,32895960,94.7751859615,_100,7,>100
5658,sustainable,433,32896393,94.7764334599,_100,11,>100
5659,scriptures,433,32896826,94.7776809582,_100,10,>100
5660,abundance,433,32897259,94.7789284565,_100,9,>100
5661,intensity,433,32897692,94.7801759549,_100,9,>100
5662,wreath,433,32898125,94.7814234532,_100,6,>100
5663,merry,433,32898558,94.7826709516,_100,5,>100
5664,curiosity,433,32898991,94.7839184499,_100,9,>100
5665,pursuit,432,32899423,94.7851630672,_100,7,>100
5666,albeit,432,32899855,94.7864076845,_100,6,>100
5667,welcomed,432,32900287,94.7876523018,_100,8,>100
5668,demanded,432,32900719,94.788896919,_100,8,>100
5669,popcorn,432,32901151,94.7901415363,_100,7,>100
5670,thats,432,32901583,94.7913861536,_100,5,>100
5671,default,432,32902015,94.7926307709,_100,7,>100
5672,goddess,432,32902447,94.7938753882,_100,7,>100
5673,handmade,432,32902879,94.7951200055,_100,8,>100
5674,lungs,432,32903311,94.7963646227,_100,5,>100
5675,avoided,432,32903743,94.79760924,_100,7,>100
5676,inviting,432,32904175,94.7988538573,_100,8,>100
5677,lightning,431,32904606,94.8000955935,_100,9,>100
5678,flies,431,32905037,94.8013373297,_100,5,>100
5679,investigate,431,32905468,94.802579066,_100,11,>100
5680,paradise,431,32905899,94.8038208022,_100,8,>100
5681,reserved,431,32906330,94.8050625384,_100,8,>100
5682,reliable,431,32906761,94.8063042746,_100,8,>100
5683,participated,431,32907192,94.8075460109,_100,12,>100
5684,listing,431,32907623,94.8087877471,_100,7,>100
5685,organize,431,32908054,94.8100294833,_100,8,>100
5686,furthermore,431,32908485,94.8112712195,_100,11,>100
5687,heated,431,32908916,94.8125129558,_100,6,>100
5688,trainer,431,32909347,94.813754692,_100,7,>100
5689,vary,430,32909777,94.8149935471,_100,4,>100
5690,enable,430,32910207,94.8162324023,_100,6,>100
5691,inevitably,430,32910637,94.8174712575,_100,10,>100
5692,protests,430,32911067,94.8187101126,_100,8,>100
5693,keith,430,32911497,94.8199489678,_100,5,>100
5694,abv,430,32911927,94.821187823,_100,3,>100
5695,lastly,430,32912357,94.8224266781,_100,6,>100
5696,array,430,32912787,94.8236655333,_100,5,>100
5697,reflects,429,32913216,94.8249015074,_100,8,>100
5698,ignoring,429,32913645,94.8261374815,_100,8,>100
5699,observation,429,32914074,94.8273734556,_100,11,>100
5700,opted,429,32914503,94.8286094297,_100,5,>100
5701,popping,429,32914932,94.8298454038,_100,7,>100
5702,equality,429,32915361,94.8310813779,_100,8,>100
5703,pairs,429,32915790,94.8323173521,_100,5,>100
5704,crowds,429,32916219,94.8335533262,_100,6,>100
5705,echo,429,32916648,94.8347893003,_100,4,>100
5706,adapted,429,32917077,94.8360252744,_100,7,>100
5707,feminine,428,32917505,94.8372583674,_100,8,>100
5708,walker,428,32917933,94.8384914605,_100,6,>100
5709,wrapping,428,32918361,94.8397245535,_100,8,>100
5710,dj,428,32918789,94.8409576466,_100,2,>100
5711,ships,428,32919217,94.8421907396,_100,5,>100
5712,intervention,428,32919645,94.8434238327,_100,12,>100
5713,microwave,428,32920073,94.8446569257,_100,9,>100
5714,qualified,428,32920501,94.8458900188,_100,9,>100
5715,fred,428,32920929,94.8471231118,_100,4,>100
5716,contracts,428,32921357,94.8483562049,_100,9,>100
5717,template,428,32921785,94.8495892979,_100,8,>100
5718,sponsor,428,32922213,94.850822391,_100,7,>100
5719,freezing,427,32922640,94.8520526029,_100,8,>100
5720,amp,427,32923067,94.8532828149,_100,3,>100
5721,fulfill,427,32923494,94.8545130269,_100,7,>100
5722,profits,427,32923921,94.8557432389,_100,7,>100
5723,believers,427,32924348,94.8569734509,_100,9,>100
5724,chamber,427,32924775,94.8582036629,_100,7,>100
5725,resolve,427,32925202,94.8594338749,_100,7,>100
5726,corrupt,427,32925629,94.8606640869,_100,7,>100
5727,na,427,32926056,94.8618942989,_100,2,>100
5728,throws,427,32926483,94.8631245109,_100,6,>100
5729,dose,427,32926910,94.8643547228,_100,4,>100
5730,jars,427,32927337,94.8655849348,_100,4,>100
5731,mist,427,32927764,94.8668151468,_100,4,>100
5732,buzz,427,32928191,94.8680453588,_100,4,>100
5733,exotic,427,32928618,94.8692755708,_100,6,>100
5734,raises,427,32929045,94.8705057828,_100,6,>100
5735,leftover,426,32929471,94.8717331137,_100,8,>100
5736,disappointing,426,32929897,94.8729604447,_100,13,>100
5737,husbands,426,32930323,94.8741877756,_100,8,>100
5738,unhappy,426,32930749,94.8754151065,_100,7,>100
5739,premium,426,32931175,94.8766424374,_100,7,>100
5740,bucks,426,32931601,94.8778697684,_100,5,>100
5741,avengers,426,32932027,94.8790970993,_100,8,>100
5742,crush,426,32932453,94.8803244302,_100,5,>100
5743,signal,426,32932879,94.8815517612,_100,6,>100
5744,peas,426,32933305,94.8827790921,_100,4,>100
5745,marker,426,32933731,94.884006423,_100,6,>100
5746,honored,426,32934157,94.885233754,_100,7,>100
5747,finest,426,32934583,94.8864610849,_100,6,>100
5748,sa,425,32935008,94.8876855348,_100,2,>100
5749,humour,425,32935433,94.8889099846,_100,6,>100
5750,amusing,425,32935858,94.8901344345,_100,7,>100
5751,clarity,425,32936283,94.8913588844,_100,7,>100
5752,owe,424,32936707,94.8925804532,_100,3,>100
5753,follower,424,32937131,94.893802022,_100,8,>100
5754,decorations,424,32937555,94.8950235908,_100,11,>100
5755,rope,424,32937979,94.8962451596,_100,4,>100
5756,ford,424,32938403,94.8974667285,_100,4,>100
5757,forming,423,32938826,94.8986854162,_100,7,>100
5758,costumes,423,32939249,94.899904104,_100,8,>100
5759,theirs,423,32939672,94.9011227917,_100,6,>100
5760,oklahoma,423,32940095,94.9023414795,_100,8,>100
5761,jungle,423,32940518,94.9035601672,_100,6,>100
5762,dignity,423,32940941,94.904778855,_100,7,>100
5763,showcase,423,32941364,94.9059975427,_100,8,>100
5764,intrigued,423,32941787,94.9072162305,_100,9,>100
5765,mutual,423,32942210,94.9084349183,_100,6,>100
5766,cliff,423,32942633,94.909653606,_100,5,>100
5767,rode,422,32943055,94.9108694127,_100,4,>100
5768,cooler,422,32943477,94.9120852194,_100,6,>100
5769,losses,422,32943899,94.9133010261,_100,6,>100
5770,reviewed,422,32944321,94.9145168328,_100,8,>100
5771,poll,422,32944743,94.9157326395,_100,4,>100
5772,pump,422,32945165,94.9169484462,_100,4,>100
5773,ch,422,32945587,94.9181642529,_100,2,>100
5774,breweries,421,32946008,94.9193771785,_100,9,>100
5775,brazil,421,32946429,94.9205901042,_100,6,>100
5776,packs,421,32946850,94.9218030298,_100,5,>100
5777,arguing,420,32947270,94.9230130744,_100,7,>100
5778,leap,420,32947690,94.924223119,_100,4,>100
5779,spinning,420,32948110,94.9254331635,_100,8,>100
5780,pete,420,32948530,94.9266432081,_100,4,>100
5781,legendary,420,32948950,94.9278532527,_100,9,>100
5782,servant,420,32949370,94.9290632973,_100,7,>100
5783,guaranteed,420,32949790,94.9302733419,_100,10,>100
5784,collins,420,32950210,94.9314833864,_100,7,>100
5785,loses,420,32950630,94.932693431,_100,5,>100
5786,influences,419,32951049,94.9339005945,_100,10,>100
5787,outlet,419,32951468,94.9351077581,_100,6,>100
5788,theories,419,32951887,94.9363149216,_100,8,>100
5789,flaws,419,32952306,94.9375220851,_100,5,>100
5790,consume,419,32952725,94.9387292486,_100,7,>100
5791,pennsylvania,419,32953144,94.9399364122,_100,12,>100
5792,phrases,418,32953562,94.9411406946,_100,7,>100
5793,necessity,418,32953980,94.9423449771,_100,9,>100
5794,alert,418,32954398,94.9435492595,_100,5,>100
5795,invented,418,32954816,94.944753542,_100,8,>100
5796,jenny,418,32955234,94.9459578245,_100,5,>100
5797,collaboration,418,32955652,94.9471621069,_100,13,>100
5798,nurses,418,32956070,94.9483663894,_100,6,>100
5799,conviction,418,32956488,94.9495706719,_100,10,>100
5800,satisfy,418,32956906,94.9507749543,_100,7,>100
5801,resident,418,32957324,94.9519792368,_100,8,>100
5802,oxford,418,32957742,94.9531835193,_100,6,>100
5803,programmes,418,32958160,94.9543878017,_100,10,>100
5804,cricut,418,32958578,94.9555920842,_100,6,>100
5805,hardware,418,32958996,94.9567963666,_100,8,>100
5806,virus,418,32959414,94.9580006491,_100,5,>100
5807,participant,418,32959832,94.9592049316,_100,11,>100
5808,handled,417,32960249,94.960406333,_100,7,>100
5809,kills,417,32960666,94.9616077344,_100,5,>100
5810,fur,417,32961083,94.9628091358,_100,3,>100
5811,sean,417,32961500,94.9640105372,_100,4,>100
5812,binding,417,32961917,94.9652119386,_100,7,>100
5813,sofa,416,32962333,94.9664104589,_100,4,>100
5814,greg,416,32962749,94.9676089793,_100,4,>100
5815,controls,416,32963165,94.9688074996,_100,8,>100
5816,advised,416,32963581,94.97000602,_100,7,>100
5817,sounding,416,32963997,94.9712045403,_100,8,>100
5818,runners,416,32964413,94.9724030607,_100,7,>100
5819,escaped,416,32964829,94.973601581,_100,7,>100
5820,lamp,416,32965245,94.9748001014,_100,4,>100
5821,marine,416,32965661,94.9759986217,_100,6,>100
5822,banned,416,32966077,94.977197142,_100,6,>100
5823,investors,416,32966493,94.9783956624,_100,9,>100
5824,vet,416,32966909,94.9795941827,_100,3,>100
5825,interviewed,416,32967325,94.9807927031,_100,11,>100
5826,requirement,416,32967741,94.9819912234,_100,11,>100
5827,landing,415,32968156,94.9831868627,_100,7,>100
5828,whip,415,32968571,94.984382502,_100,4,>100
5829,dreamed,415,32968986,94.9855781413,_100,7,>100
5830,jury,415,32969401,94.9867737806,_100,4,>100
5831,glow,415,32969816,94.9879694199,_100,4,>100
5832,driveway,415,32970231,94.9891650592,_100,8,>100
5833,cole,415,32970646,94.9903606984,_100,4,>100
5834,maple,415,32971061,94.9915563377,_100,5,>100
5835,likewise,415,32971476,94.992751977,_100,8,>100
5836,eliminate,414,32971890,94.9939447352,_100,9,>100
5837,notebook,414,32972304,94.9951374935,_100,8,>100
5838,nancy,414,32972718,94.9963302517,_100,5,>100
5839,envelope,414,32973132,94.9975230099,_100,8,>100
5840,edited,414,32973546,94.9987157682,_100,6,>100
5841,processing,414,32973960,94.9999085264,_100,10,>100
5842,abstract,414,32974374,95.0011012846,_100,8,>100
5843,farms,414,32974788,95.0022940428,_100,5,>100
5844,parked,414,32975202,95.0034868011,_100,6,>100
5845,supermarket,413,32975615,95.0046766782,_100,11,>100
5846,instrument,413,32976028,95.0058665554,_100,10,>100
5847,tooth,413,32976441,95.0070564326,_100,5,>100
5848,remarks,413,32976854,95.0082463098,_100,7,>100
5849,muffin,413,32977267,95.0094361869,_100,6,>100
5850,checks,413,32977680,95.0106260641,_100,6,>100
5851,convincing,413,32978093,95.0118159413,_100,10,>100
5852,regarded,413,32978506,95.0130058184,_100,8,>100
5853,component,413,32978919,95.0141956956,_100,9,>100
5854,deserved,413,32979332,95.0153855728,_100,8,>100
5855,pinch,413,32979745,95.01657545,_100,5,>100
5856,neglected,412,32980157,95.0177624461,_100,9,>100
5857,polite,412,32980569,95.0189494422,_100,6,>100
5858,critique,412,32980981,95.0201364383,_100,8,>100
5859,bee,412,32981393,95.0213234344,_100,3,>100
5860,clicking,412,32981805,95.0225104305,_100,8,>100
5861,cop,412,32982217,95.0236974266,_100,3,>100
5862,ranks,412,32982629,95.0248844227,_100,5,>100
5863,sidebar,412,32983041,95.0260714188,_100,7,>100
5864,beats,412,32983453,95.027258415,_100,5,>100
5865,terrorism,411,32983864,95.02844253,_100,9,>100
5866,scare,411,32984275,95.0296266451,_100,5,>100
5867,drum,411,32984686,95.0308107601,_100,4,>100
5868,illustrations,411,32985097,95.0319948752,_100,13,>100
5869,amanda,411,32985508,95.0331789902,_100,6,>100
5870,momentum,411,32985919,95.0343631053,_100,8,>100
5871,chemicals,411,32986330,95.0355472203,_100,9,>100
5872,possess,411,32986741,95.0367313354,_100,7,>100
5873,composed,411,32987152,95.0379154504,_100,8,>100
5874,scientist,410,32987562,95.0390966844,_100,9,>100
5875,sympathy,410,32987972,95.0402779184,_100,8,>100
5876,expanded,410,32988382,95.0414591524,_100,8,>100
5877,glued,410,32988792,95.0426403864,_100,5,>100
5878,expertise,410,32989202,95.0438216204,_100,9,>100
5879,reporter,410,32989612,95.0450028544,_100,8,>100
5880,scarf,410,32990022,95.0461840884,_100,5,>100
5881,indiana,410,32990432,95.0473653224,_100,7,>100
5882,lowest,410,32990842,95.0485465564,_100,6,>100
5883,blended,410,32991252,95.0497277904,_100,7,>100
5884,avoiding,410,32991662,95.0509090244,_100,8,>100
5885,mankind,410,32992072,95.0520902584,_100,7,>100
5886,glaze,409,32992481,95.0532686113,_100,5,>100
5887,wounds,409,32992890,95.0544469643,_100,6,>100
5888,swap,409,32993299,95.0556253172,_100,4,>100
5889,inclined,409,32993708,95.0568036701,_100,8,>100
5890,components,409,32994117,95.0579820231,_100,10,>100
5891,bullet,409,32994526,95.059160376,_100,6,>100
5892,anderson,409,32994935,95.0603387289,_100,8,>100
5893,confirm,409,32995344,95.0615170819,_100,7,>100
5894,mill,409,32995753,95.0626954348,_100,4,>100
5895,competing,409,32996162,95.0638737877,_100,9,>100
5896,bliss,409,32996571,95.0650521407,_100,5,>100
5897,phil,409,32996980,95.0662304936,_100,4,>100
5898,triple,409,32997389,95.0674088465,_100,6,>100
5899,fraud,409,32997798,95.0685871995,_100,5,>100
5900,graduation,408,32998206,95.0697626714,_100,10,>100
5901,championship,408,32998614,95.0709381432,_100,12,>100
5902,roy,408,32999022,95.0721136151,_100,3,>100
5903,auction,408,32999430,95.073289087,_100,7,>100
5904,regions,408,32999838,95.0744645589,_100,7,>100
5905,ideology,408,33000246,95.0756400308,_100,8,>100
5906,zombies,408,33000654,95.0768155026,_100,7,>100
5907,forty,408,33001062,95.0779909745,_100,5,>100
5908,paired,408,33001470,95.0791664464,_100,6,>100
5909,contributed,408,33001878,95.0803419183,_100,11,>100
5910,resume,408,33002286,95.0815173901,_100,6,>100
5911,affection,407,33002693,95.082689981,_100,9,>100
5912,sensation,407,33003100,95.0838625718,_100,9,>100
5913,eternity,407,33003507,95.0850351626,_100,8,>100
5914,shallow,407,33003914,95.0862077534,_100,7,>100
5915,demonstrated,407,33004321,95.0873803442,_100,12,>100
5916,arsenal,407,33004728,95.0885529351,_100,7,>100
5917,ignorant,407,33005135,95.0897255259,_100,8,>100
5918,endure,407,33005542,95.0908981167,_100,6,>100
5919,shouting,406,33005948,95.0920678265,_100,8,>100
5920,gloves,406,33006354,95.0932375362,_100,6,>100
5921,addresses,406,33006760,95.094407246,_100,9,>100
5922,wage,406,33007166,95.0955769557,_100,4,>100
5923,warrior,406,33007572,95.0967466655,_100,7,>100
5924,dense,406,33007978,95.0979163753,_100,5,>100
5925,precise,406,33008384,95.099086085,_100,7,>100
5926,maintained,406,33008790,95.1002557948,_100,10,>100
5927,processed,406,33009196,95.1014255045,_100,9,>100
5928,combo,406,33009602,95.1025952143,_100,5,>100
5929,researching,406,33010008,95.1037649241,_100,11,>100
5930,oliver,406,33010414,95.1049346338,_100,6,>100
5931,employer,405,33010819,95.1061014625,_100,8,>100
5932,activists,405,33011224,95.1072682912,_100,9,>100
5933,grandpa,405,33011629,95.1084351199,_100,7,>100
5934,gentleman,405,33012034,95.1096019486,_100,9,>100
5935,reject,405,33012439,95.1107687773,_100,6,>100
5936,fr,405,33012844,95.111935606,_100,2,>100
5937,concentration,405,33013249,95.1131024347,_100,13,>100
5938,barbara,405,33013654,95.1142692634,_100,7,>100
5939,enhance,405,33014059,95.1154360921,_100,7,>100
5940,managers,405,33014464,95.1166029208,_100,8,>100
5941,picnic,405,33014869,95.1177697495,_100,6,>100
5942,booked,405,33015274,95.1189365783,_100,6,>100
5943,danced,405,33015679,95.120103407,_100,6,>100
5944,moderate,404,33016083,95.1212673546,_100,8,>100
5945,savior,404,33016487,95.1224313022,_100,6,>100
5946,wines,404,33016891,95.1235952499,_100,5,>100
5947,soak,404,33017295,95.1247591975,_100,4,>100
5948,claire,404,33017699,95.1259231452,_100,6,>100
5949,pots,404,33018103,95.1270870928,_100,4,>100
5950,vitamin,404,33018507,95.1282510405,_100,7,>100
5951,dallas,404,33018911,95.1294149881,_100,6,>100
5952,steep,404,33019315,95.1305789357,_100,5,>100
5953,drums,403,33019718,95.1317400023,_100,5,>100
5954,gaming,403,33020121,95.1329010689,_100,6,>100
5955,tango,403,33020524,95.1340621355,_100,5,>100
5956,lounge,403,33020927,95.1352232021,_100,6,>100
5957,considerable,403,33021330,95.1363842687,_100,12,>100
5958,searched,403,33021733,95.1375453353,_100,8,>100
5959,hopeful,403,33022136,95.1387064018,_100,7,>100
5960,dated,403,33022539,95.1398674684,_100,5,>100
5961,burns,403,33022942,95.141028535,_100,5,>100
5962,appearing,403,33023345,95.1421896016,_100,9,>100
5963,ancestors,402,33023747,95.1433477871,_100,9,>100
5964,aging,402,33024149,95.1445059727,_100,5,>100
5965,dean,402,33024551,95.1456641582,_100,4,>100
5966,deer,402,33024953,95.1468223437,_100,4,>100
5967,cozy,402,33025355,95.1479805292,_100,4,>100
5968,gaze,402,33025757,95.1491387148,_100,4,>100
5969,hawaii,401,33026158,95.1502940192,_100,6,>100
5970,flexible,401,33026559,95.1514493237,_100,8,>100
5971,kentucky,401,33026960,95.1526046282,_100,8,>100
5972,treatments,401,33027361,95.1537599326,_100,10,>100
5973,deliberately,401,33027762,95.1549152371,_100,12,>100
5974,judged,401,33028163,95.1560705416,_100,6,>100
5975,cardboard,401,33028564,95.157225846,_100,9,>100
5976,conventional,401,33028965,95.1583811505,_100,12,>100
5977,penalty,401,33029366,95.159536455,_100,7,>100
5978,tones,401,33029767,95.1606917594,_100,5,>100
5979,recordings,400,33030167,95.1618441828,_100,10,>100
5980,pity,400,33030567,95.1629966063,_100,4,>100
5981,elaborate,400,33030967,95.1641490297,_100,9,>100
5982,panels,400,33031367,95.1653014531,_100,6,>100
5983,implications,400,33031767,95.1664538765,_100,12,>100
5984,cemetery,400,33032167,95.1676062999,_100,8,>100
5985,cant,400,33032567,95.1687587233,_100,4,>100
5986,prophet,400,33032967,95.1699111467,_100,7,>100
5987,cents,400,33033367,95.1710635701,_100,5,>100
5988,400,400,33033767,95.1722159935,_100,3,>100
5989,chuck,400,33034167,95.1733684169,_100,5,>100
5990,treating,400,33034567,95.1745208404,_100,8,>100
5991,tightly,399,33034966,95.1756703827,_100,7,>100
5992,observations,399,33035365,95.1768199251,_100,12,>100
5993,bishop,399,33035764,95.1779694674,_100,6,>100
5994,thunder,399,33036163,95.1791190098,_100,7,>100
5995,targets,399,33036562,95.1802685521,_100,7,>100
5996,chic,399,33036961,95.1814180945,_100,4,>100
5997,lawrence,399,33037360,95.1825676368,_100,8,>100
5998,distributed,399,33037759,95.1837171792,_100,11,>100
5999,awarded,399,33038158,95.1848667215,_100,7,>100
6000,quirky,399,33038557,95.1860162639,_100,6,>100
6001,quarters,399,33038956,95.1871658062,_100,8,>100
6002,philadelphia,398,33039354,95.1883124675,_100,12,>100
6003,tommy,398,33039752,95.1894591288,_100,5,>100
6004,dive,398,33040150,95.1906057901,_100,4,>100
6005,musician,398,33040548,95.1917524514,_100,8,>100
6006,criteria,398,33040946,95.1928991127,_100,8,>100
6007,constructed,398,33041344,95.194045774,_100,11,>100
6008,donated,398,33041742,95.1951924353,_100,7,>100
6009,casting,398,33042140,95.1963390966,_100,7,>100
6010,warmer,398,33042538,95.1974857578,_100,6,>100
6011,jonah,398,33042936,95.1986324191,_100,5,>100
6012,secondly,398,33043334,95.1997790804,_100,8,>100
6013,cereal,398,33043732,95.2009257417,_100,6,>100
6014,hong,398,33044130,95.202072403,_100,4,>100
6015,delivering,398,33044528,95.2032190643,_100,10,>100
6016,span,398,33044926,95.2043657256,_100,4,>100
6017,beneficial,398,33045324,95.2055123869,_100,10,>100
6018,nearest,398,33045722,95.2066590482,_100,7,>100
6019,suspected,397,33046119,95.2078028284,_100,9,>100
6020,focuses,397,33046516,95.2089466087,_100,7,>100
6021,industries,397,33046913,95.2100903889,_100,10,>100
6022,obtained,397,33047310,95.2112341691,_100,8,>100
6023,destroying,397,33047707,95.2123779494,_100,10,>100
6024,diego,397,33048104,95.2135217296,_100,5,>100
6025,maps,397,33048501,95.2146655098,_100,4,>100
6026,mins,397,33048898,95.2158092901,_100,4,>100
6027,progressive,397,33049295,95.2169530703,_100,11,>100
6028,hammer,397,33049692,95.2180968505,_100,6,>100
6029,climbed,397,33050089,95.2192406308,_100,7,>100
6030,hints,397,33050486,95.220384411,_100,5,>100
6031,z,397,33050883,95.2215281912,_100,1,>100
6032,ruined,397,33051280,95.2226719715,_100,6,>100
6033,bbq,397,33051677,95.2238157517,_100,3,>100
6034,oscar,397,33052074,95.2249595319,_100,5,>100
6035,admittedly,396,33052470,95.2261004311,_100,10,>100
6036,mentions,396,33052866,95.2272413303,_100,8,>100
6037,reducing,396,33053262,95.2283822295,_100,8,>100
6038,servants,396,33053658,95.2295231286,_100,8,>100
6039,colleague,396,33054054,95.2306640278,_100,9,>100
6040,fascinated,395,33054449,95.2318020459,_100,10,>100
6041,vivid,395,33054844,95.232940064,_100,5,>100
6042,comforting,395,33055239,95.2340780822,_100,10,>100
6043,seeks,395,33055634,95.2352161003,_100,5,>100
6044,irony,395,33056029,95.2363541184,_100,5,>100
6045,sweater,395,33056424,95.2374921365,_100,7,>100
6046,psalm,395,33056819,95.2386301546,_100,5,>100
6047,errors,395,33057214,95.2397681727,_100,6,>100
6048,joshua,395,33057609,95.2409061909,_100,6,>100
6049,dominant,395,33058004,95.242044209,_100,8,>100
6050,secretly,395,33058399,95.2431822271,_100,8,>100
6051,eats,395,33058794,95.2443202452,_100,4,>100
6052,curriculum,395,33059189,95.2454582633,_100,10,>100
6053,parallel,395,33059584,95.2465962814,_100,8,>100
6054,phoenix,395,33059979,95.2477342996,_100,7,>100
6055,drawings,395,33060374,95.2488723177,_100,8,>100
6056,pulse,394,33060768,95.2500074547,_100,5,>100
6057,scraps,394,33061162,95.2511425918,_100,6,>100
6058,indicated,394,33061556,95.2522777289,_100,9,>100
6059,transferred,394,33061950,95.2534128659,_100,11,>100
6060,doctrine,394,33062344,95.254548003,_100,8,>100
6061,compromise,394,33062738,95.25568314,_100,10,>100
6062,ordering,393,33063131,95.256815396,_100,8,>100
6063,bonds,393,33063524,95.257947652,_100,5,>100
6064,civilization,393,33063917,95.259079908,_100,12,>100
6065,peach,393,33064310,95.260212164,_100,5,>100
6066,til,393,33064703,95.26134442,_100,3,>100
6067,discovering,393,33065096,95.262476676,_100,11,>100
6068,twins,393,33065489,95.263608932,_100,5,>100
6069,buffalo,393,33065882,95.264741188,_100,7,>100
6070,euro,393,33066275,95.265873444,_100,4,>100
6071,saucepan,393,33066668,95.2670057,_100,8,>100
6072,revenge,392,33067060,95.268135075,_100,7,>100
6073,dug,392,33067452,95.2692644499,_100,3,>100
6074,hannah,392,33067844,95.2703938249,_100,6,>100
6075,basil,392,33068236,95.2715231998,_100,5,>100
6076,indians,392,33068628,95.2726525747,_100,7,>100
6077,batman,392,33069020,95.2737819497,_100,6,>100
6078,beth,392,33069412,95.2749113246,_100,4,>100
6079,detroit,392,33069804,95.2760406996,_100,7,>100
6080,scan,392,33070196,95.2771700745,_100,4,>100
6081,snake,391,33070587,95.2782965684,_100,5,>100
6082,pretending,391,33070978,95.2794230623,_100,10,>100
6083,questioned,391,33071369,95.2805495562,_100,10,>100
6084,supernatural,391,33071760,95.28167605,_100,12,>100
6085,priced,391,33072151,95.2828025439,_100,6,>100
6086,ingredient,391,33072542,95.2839290378,_100,10,>100
6087,canned,391,33072933,95.2850555317,_100,6,>100
6088,respective,391,33073324,95.2861820256,_100,10,>100
6089,depths,391,33073715,95.2873085194,_100,6,>100
6090,strategic,391,33074106,95.2884350133,_100,9,>100
6091,grease,391,33074497,95.2895615072,_100,6,>100
6092,loyalty,391,33074888,95.2906880011,_100,7,>100
6093,bleeding,390,33075278,95.2918116139,_100,8,>100
6094,instruction,390,33075668,95.2929352267,_100,11,>100
6095,ol,390,33076058,95.2940588396,_100,2,>100
6096,greeted,390,33076448,95.2951824524,_100,7,>100
6097,cabin,390,33076838,95.2963060652,_100,5,>100
6098,aircraft,390,33077228,95.297429678,_100,8,>100
6099,stake,390,33077618,95.2985532909,_100,5,>100
6100,reminding,390,33078008,95.2996769037,_100,9,>100
6101,slavery,390,33078398,95.3008005165,_100,7,>100
6102,smoked,390,33078788,95.3019241293,_100,6,>100
6103,pancakes,390,33079178,95.3030477422,_100,8,>100
6104,oatmeal,390,33079568,95.304171355,_100,7,>100
6105,fitted,390,33079958,95.3052949678,_100,6,>100
6106,virtue,389,33080347,95.3064156996,_100,6,>100
6107,soundtrack,389,33080736,95.3075364313,_100,10,>100
6108,aka,389,33081125,95.3086571631,_100,3,>100
6109,gravity,389,33081514,95.3097778949,_100,7,>100
6110,starbucks,389,33081903,95.3108986266,_100,9,>100
6111,stiff,389,33082292,95.3120193584,_100,5,>100
6112,instances,389,33082681,95.3131400902,_100,9,>100
6113,playground,389,33083070,95.3142608219,_100,10,>100
6114,retain,389,33083459,95.3153815537,_100,6,>100
6115,journalism,389,33083848,95.3165022855,_100,10,>100
6116,rental,389,33084237,95.3176230172,_100,6,>100
6117,declined,389,33084626,95.318743749,_100,8,>100
6118,lesser,389,33085015,95.3198644808,_100,6,>100
6119,exclusively,388,33085403,95.3209823315,_100,11,>100
6120,pantry,388,33085791,95.3221001822,_100,6,>100
6121,notable,388,33086179,95.3232180329,_100,7,>100
6122,olympic,388,33086567,95.3243358836,_100,7,>100
6123,craig,388,33086955,95.3254537343,_100,5,>100
6124,camps,388,33087343,95.326571585,_100,5,>100
6125,doubts,388,33087731,95.3276894357,_100,6,>100
6126,fries,388,33088119,95.3288072864,_100,5,>100
6127,tad,388,33088507,95.3299251371,_100,3,>100
6128,burnt,388,33088895,95.3310429878,_100,5,>100
6129,presenting,387,33089282,95.3321579575,_100,10,>100
6130,themed,387,33089669,95.3332729271,_100,6,>100
6131,rep,387,33090056,95.3343878968,_100,3,>100
6132,advocate,387,33090443,95.3355028664,_100,8,>100
6133,duration,387,33090830,95.3366178361,_100,8,>100
6134,evenings,387,33091217,95.3377328057,_100,8,>100
6135,hallway,387,33091604,95.3388477754,_100,7,>100
6136,berlin,387,33091991,95.339962745,_100,6,>100
6137,nelson,387,33092378,95.3410777147,_100,6,>100
6138,stretching,387,33092765,95.3421926843,_100,10,>100
6139,bargain,387,33093152,95.343307654,_100,7,>100
6140,inform,387,33093539,95.3444226236,_100,6,>100
6141,cigarette,387,33093926,95.3455375933,_100,9,>100
6142,curtains,387,33094313,95.3466525629,_100,8,>100
6143,converted,386,33094699,95.3477646515,_100,9,>100
6144,oddly,386,33095085,95.3488767401,_100,5,>100
6145,brewer,386,33095471,95.3499888287,_100,6,>100
6146,varied,386,33095857,95.3511009173,_100,6,>100
6147,generated,386,33096243,95.3522130059,_100,9,>100
6148,dominated,386,33096629,95.3533250945,_100,9,>100
6149,socialist,386,33097015,95.3544371831,_100,9,>100
6150,neil,386,33097401,95.3555492716,_100,4,>100
6151,craving,386,33097787,95.3566613602,_100,7,>100
6152,unaware,386,33098173,95.3577734488,_100,7,>100
6153,paperwork,386,33098559,95.3588855374,_100,9,>100
6154,eligible,386,33098945,95.359997626,_100,8,>100
6155,nazi,386,33099331,95.3611097146,_100,4,>100
6156,ebook,385,33099716,95.3622189221,_100,5,>100
6157,sunlight,385,33100101,95.3633281297,_100,8,>100
6158,rushing,385,33100486,95.3644373372,_100,7,>100
6159,ironic,385,33100871,95.3655465447,_100,6,>100
6160,wandered,385,33101256,95.3666557523,_100,8,>100
6161,expanding,385,33101641,95.3677649598,_100,9,>100
6162,gifted,385,33102026,95.3688741673,_100,6,>100
6163,tweet,385,33102411,95.3699833749,_100,5,>100
6164,kindergarten,385,33102796,95.3710925824,_100,12,>100
6165,linda,384,33103180,95.3721989089,_100,5,>100
6166,complained,384,33103564,95.3733052353,_100,10,>100
6167,underlying,384,33103948,95.3744115618,_100,10,>100
6168,pins,384,33104332,95.3755178883,_100,4,>100
6169,executed,384,33104716,95.3766242147,_100,8,>100
6170,jean,384,33105100,95.3777305412,_100,4,>100
6171,finely,384,33105484,95.3788368677,_100,6,>100
6172,sleeves,384,33105868,95.3799431942,_100,7,>100
6173,yelled,384,33106252,95.3810495206,_100,6,>100
6174,palestinian,383,33106635,95.3821529661,_100,11,>100
6175,chores,383,33107018,95.3832564115,_100,6,>100
6176,qualify,383,33107401,95.3843598569,_100,7,>100
6177,wikipedia,383,33107784,95.3854633023,_100,9,>100
6178,las,383,33108167,95.3865667477,_100,3,>100
6179,abraham,383,33108550,95.3876701931,_100,7,>100
6180,hath,383,33108933,95.3887736385,_100,4,>100
6181,warn,383,33109316,95.389877084,_100,4,>100
6182,whiskey,383,33109699,95.3909805294,_100,7,>100
6183,pathetic,383,33110082,95.3920839748,_100,8,>100
6184,moist,383,33110465,95.3931874202,_100,5,>100
6185,consequence,383,33110848,95.3942908656,_100,11,>100
6186,promptly,383,33111231,95.395394311,_100,8,>100
6187,murders,382,33111613,95.3964948754,_100,7,>100
6188,miami,382,33111995,95.3975954397,_100,5,>100
6189,terrifying,382,33112377,95.3986960041,_100,10,>100
6190,invested,382,33112759,95.3997965685,_100,8,>100
6191,jelly,382,33113141,95.4008971328,_100,5,>100
6192,composition,382,33113523,95.4019976972,_100,11,>100
6193,pictured,382,33113905,95.4030982615,_100,8,>100
6194,puzzle,382,33114287,95.4041988259,_100,6,>100
6195,resting,382,33114669,95.4052993902,_100,7,>100
6196,summit,382,33115051,95.4063999546,_100,6,>100
6197,jet,382,33115433,95.407500519,_100,3,>100
6198,prose,382,33115815,95.4086010833,_100,5,>100
6199,se,382,33116197,95.4097016477,_100,2,>100
6200,gut,382,33116579,95.410802212,_100,3,>100
6201,reduction,381,33116960,95.4118998953,_100,9,>100
6202,defensive,381,33117341,95.4129975786,_100,9,>100
6203,proves,381,33117722,95.4140952619,_100,6,>100
6204,representing,381,33118103,95.4151929452,_100,12,>100
6205,tracking,381,33118484,95.4162906285,_100,8,>100
6206,blender,381,33118865,95.4173883118,_100,7,>100
6207,nodded,381,33119246,95.4184859951,_100,6,>100
6208,devastating,381,33119627,95.4195836784,_100,11,>100
6209,sensible,381,33120008,95.4206813617,_100,8,>100
6210,expansion,381,33120389,95.421779045,_100,9,>100
6211,gene,381,33120770,95.4228767283,_100,4,>100
6212,earliest,381,33121151,95.4239744116,_100,8,>100
6213,weigh,380,33121531,95.4250692138,_100,5,>100
6214,refuses,380,33121911,95.4261640161,_100,7,>100
6215,appeals,380,33122291,95.4272588183,_100,7,>100
6216,terry,380,33122671,95.4283536205,_100,5,>100
6217,displays,380,33123051,95.4294484228,_100,8,>100
6218,input,380,33123431,95.430543225,_100,5,>100
6219,orchestra,380,33123811,95.4316380273,_100,9,>100
6220,residence,380,33124191,95.4327328295,_100,9,>100
6221,careers,380,33124571,95.4338276317,_100,7,>100
6222,readily,380,33124951,95.434922434,_100,7,>100
6223,ho,380,33125331,95.4360172362,_100,2,>100
6224,potty,380,33125711,95.4371120385,_100,5,>100
6225,spider,380,33126091,95.4382068407,_100,6,>100
6226,vomiting,379,33126470,95.4392987619,_100,8,>100
6227,blogged,379,33126849,95.4403906831,_100,7,>100
6228,restore,379,33127228,95.4414826042,_100,7,>100
6229,hotels,379,33127607,95.4425745254,_100,6,>100
6230,ironically,379,33127986,95.4436664466,_100,10,>100
6231,gem,378,33128364,95.4447554867,_100,3,>100
6232,norm,378,33128742,95.4458445268,_100,4,>100
6233,relieved,378,33129120,95.446933567,_100,8,>100
6234,lining,378,33129498,95.4480226071,_100,6,>100
6235,transform,378,33129876,95.4491116472,_100,9,>100
6236,relating,378,33130254,95.4502006873,_100,8,>100
6237,lily,378,33130632,95.4512897275,_100,4,>100
6238,segment,378,33131010,95.4523787676,_100,7,>100
6239,traits,378,33131388,95.4534678077,_100,6,>100
6240,emailed,378,33131766,95.4545568478,_100,7,>100
6241,personalities,378,33132144,95.4556458879,_100,13,>100
6242,premier,377,33132521,95.456732047,_100,7,>100
6243,headache,377,33132898,95.4578182061,_100,8,>100
6244,universities,377,33133275,95.4589043651,_100,12,>100
6245,separation,377,33133652,95.4599905242,_100,10,>100
6246,surroundings,377,33134029,95.4610766833,_100,12,>100
6247,dairy,377,33134406,95.4621628423,_100,5,>100
6248,tunes,377,33134783,95.4632490014,_100,5,>100
6249,chick,377,33135160,95.4643351605,_100,5,>100
6250,worthwhile,377,33135537,95.4654213195,_100,10,>100
6251,blonde,377,33135914,95.4665074786,_100,6,>100
6252,addicted,377,33136291,95.4675936376,_100,8,>100
6253,recession,377,33136668,95.4686797967,_100,9,>100
6254,teddy,376,33137044,95.4697630747,_100,5,>100
6255,earrings,376,33137420,95.4708463527,_100,8,>100
6256,metro,376,33137796,95.4719296307,_100,5,>100
6257,arise,376,33138172,95.4730129087,_100,5,>100
6258,distinction,376,33138548,95.4740961867,_100,11,>100
6259,liberals,376,33138924,95.4751794647,_100,8,>100
6260,principal,376,33139300,95.4762627427,_100,9,>100
6261,stark,376,33139676,95.4773460207,_100,5,>100
6262,abused,376,33140052,95.4784292988,_100,6,>100
6263,uh,376,33140428,95.4795125768,_100,2,>100
6264,palette,376,33140804,95.4805958548,_100,7,>100
6265,feathers,375,33141179,95.4816762517,_100,8,>100
6266,ps,375,33141554,95.4827566487,_100,2,>100
6267,exploration,375,33141929,95.4838370456,_100,11,>100
6268,gems,375,33142304,95.4849174425,_100,4,>100
6269,bananas,375,33142679,95.4859978395,_100,7,>100
6270,bore,375,33143054,95.4870782364,_100,4,>100
6271,375,375,33143429,95.4881586334,_100,3,>100
6272,fiber,375,33143804,95.4892390303,_100,5,>100
6273,bikes,375,33144179,95.4903194273,_100,5,>100
6274,lettuce,375,33144554,95.4913998242,_100,7,>100
6275,moreover,375,33144929,95.4924802212,_100,8,>100
6276,willingness,375,33145304,95.4935606181,_100,11,>100
6277,protesters,375,33145679,95.4946410151,_100,10,>100
6278,strain,375,33146054,95.495721412,_100,6,>100
6279,cartoon,375,33146429,95.496801809,_100,7,>100
6280,employers,375,33146804,95.4978822059,_100,9,>100
6281,server,375,33147179,95.4989626029,_100,6,>100
6282,libraries,374,33147553,95.5000401187,_100,9,>100
6283,mitt,374,33147927,95.5011176346,_100,4,>100
6284,nfl,374,33148301,95.5021951505,_100,3,>100
6285,introducing,374,33148675,95.5032726664,_100,11,>100
6286,specialist,374,33149049,95.5043501823,_100,10,>100
6287,friendships,374,33149423,95.5054276982,_100,11,>100
6288,explosion,374,33149797,95.5065052141,_100,9,>100
6289,immune,374,33150171,95.50758273,_100,6,>100
6290,patents,373,33150544,95.5086573648,_100,7,>100
6291,pee,373,33150917,95.5097319996,_100,3,>100
6292,earthquake,373,33151290,95.5108066344,_100,10,>100
6293,amateur,373,33151663,95.5118812693,_100,7,>100
6294,identical,373,33152036,95.5129559041,_100,9,>100
6295,opponents,373,33152409,95.5140305389,_100,9,>100
6296,troubles,373,33152782,95.5151051738,_100,8,>100
6297,broccoli,373,33153155,95.5161798086,_100,8,>100
6298,catherine,373,33153528,95.5172544434,_100,9,>100
6299,limitations,373,33153901,95.5183290782,_100,11,>100
6300,forgetting,372,33154273,95.519400832,_100,10,>100
6301,illustrated,372,33154645,95.5204725858,_100,11,>100
6302,religions,372,33155017,95.5215443396,_100,9,>100
6303,sights,372,33155389,95.5226160933,_100,6,>100
6304,earning,372,33155761,95.5236878471,_100,7,>100
6305,quilting,372,33156133,95.5247596009,_100,8,>100
6306,definite,372,33156505,95.5258313546,_100,8,>100
6307,contributions,372,33156877,95.5269031084,_100,13,>100
6308,albert,372,33157249,95.5279748622,_100,6,>100
6309,campaigns,372,33157621,95.529046616,_100,9,>100
6310,infringement,372,33157993,95.5301183697,_100,12,>100
6311,indicates,372,33158365,95.5311901235,_100,9,>100
6312,chilly,372,33158737,95.5322618773,_100,6,>100
6313,agriculture,372,33159109,95.533333631,_100,11,>100
6314,weighed,372,33159481,95.5344053848,_100,7,>100
6315,demons,372,33159853,95.5354771386,_100,6,>100
6316,squad,372,33160225,95.5365488924,_100,5,>100
6317,campbell,371,33160596,95.5376177651,_100,8,>100
6318,mars,371,33160967,95.5386866378,_100,4,>100
6319,keyboard,371,33161338,95.5397555105,_100,8,>100
6320,kisses,371,33161709,95.5408243832,_100,6,>100
6321,discrimination,371,33162080,95.5418932559,_100,14,>100
6322,screamed,371,33162451,95.5429621286,_100,8,>100
6323,technologies,371,33162822,95.5440310013,_100,12,>100
6324,slower,371,33163193,95.5450998741,_100,6,>100
6325,diseases,371,33163564,95.5461687468,_100,8,>100
6326,connecting,371,33163935,95.5472376195,_100,10,>100
6327,toe,370,33164305,95.5483036111,_100,3,>100
6328,bees,370,33164675,95.5493696028,_100,4,>100
6329,holly,370,33165045,95.5504355944,_100,5,>100
6330,convenience,370,33165415,95.5515015861,_100,11,>100
6331,samuel,370,33165785,95.5525675777,_100,6,>100
6332,swept,370,33166155,95.5536335694,_100,5,>100
6333,stem,370,33166525,95.5546995611,_100,4,>100
6334,spark,370,33166895,95.5557655527,_100,5,>100
6335,smoothly,370,33167265,95.5568315444,_100,8,>100
6336,personnel,369,33167634,95.557894655,_100,9,>100
6337,cathedral,369,33168003,95.5589577656,_100,9,>100
6338,android,369,33168372,95.5600208762,_100,7,>100
6339,capitalism,369,33168741,95.5610839867,_100,10,>100
6340,developments,369,33169110,95.5621470973,_100,12,>100
6341,cooling,369,33169479,95.5632102079,_100,7,>100
6342,metaphor,369,33169848,95.5642733185,_100,8,>100
6343,sorrow,369,33170217,95.5653364291,_100,6,>100
6344,complexity,369,33170586,95.5663995397,_100,10,>100
6345,workshops,369,33170955,95.5674626503,_100,9,>100
6346,ali,369,33171324,95.5685257609,_100,3,>100
6347,offense,369,33171693,95.5695888715,_100,7,>100
6348,troubled,369,33172062,95.5706519821,_100,8,>100
6349,belgium,369,33172431,95.5717150927,_100,7,>100
6350,severely,369,33172800,95.5727782033,_100,8,>100
6351,rewards,369,33173169,95.5738413139,_100,7,>100
6352,directors,368,33173537,95.5749015434,_100,9,>100
6353,currency,368,33173905,95.575961773,_100,8,>100
6354,shifting,368,33174273,95.5770220025,_100,8,>100
6355,attraction,368,33174641,95.578082232,_100,10,>100
6356,bend,368,33175009,95.5791424616,_100,4,>100
6357,justified,368,33175377,95.5802026911,_100,9,>100
6358,enjoyment,368,33175745,95.5812629206,_100,9,>100
6359,disgusting,368,33176113,95.5823231502,_100,10,>100
6360,berries,368,33176481,95.5833833797,_100,7,>100
6361,thru,368,33176849,95.5844436093,_100,4,>100
6362,attacking,368,33177217,95.5855038388,_100,9,>100
6363,carrot,368,33177585,95.5865640683,_100,6,>100
6364,lo,368,33177953,95.5876242979,_100,2,>100
6365,poker,368,33178321,95.5886845274,_100,5,>100
6366,fictional,368,33178689,95.5897447569,_100,9,>100
6367,galaxy,367,33179056,95.5908021054,_100,6,>100
6368,admission,367,33179423,95.5918594539,_100,9,>100
6369,portrayed,367,33179790,95.5929168024,_100,9,>100
6370,caf,367,33180157,95.5939741509,_100,3,>100
6371,hospitals,367,33180524,95.5950314993,_100,9,>100
6372,frost,367,33180891,95.5960888478,_100,5,>100
6373,cattle,367,33181258,95.5971461963,_100,6,>100
6374,insert,366,33181624,95.5982006637,_100,6,>100
6375,throne,366,33181990,95.5992551311,_100,6,>100
6376,usage,366,33182356,95.6003095985,_100,5,>100
6377,cries,366,33182722,95.601364066,_100,5,>100
6378,grades,366,33183088,95.6024185334,_100,6,>100
6379,convey,366,33183454,95.6034730008,_100,6,>100
6380,cheeks,366,33183820,95.6045274682,_100,6,>100
6381,measuring,366,33184186,95.6055819356,_100,9,>100
6382,pains,366,33184552,95.6066364031,_100,5,>100
6383,reasoning,366,33184918,95.6076908705,_100,9,>100
6384,feared,366,33185284,95.6087453379,_100,6,>100
6385,diagnosis,365,33185649,95.6097969243,_100,9,>100
6386,convicted,365,33186014,95.6108485106,_100,9,>100
6387,proceed,365,33186379,95.611900097,_100,7,>100
6388,365,365,33186744,95.6129516834,_100,3,>100
6389,damned,365,33187109,95.6140032697,_100,6,>100
6390,criminals,365,33187474,95.6150548561,_100,9,>100
6391,enthusiastic,365,33187839,95.6161064424,_100,12,>100
6392,rewarding,365,33188204,95.6171580288,_100,9,>100
6393,prisoners,365,33188569,95.6182096152,_100,9,>100
6394,eleven,365,33188934,95.6192612015,_100,6,>100
6395,von,365,33189299,95.6203127879,_100,3,>100
6396,releasing,365,33189664,95.6213643742,_100,9,>100
6397,buyers,364,33190028,95.6224130795,_100,6,>100
6398,berry,364,33190392,95.6234617848,_100,5,>100
6399,begging,364,33190756,95.6245104902,_100,7,>100
6400,pops,364,33191120,95.6255591955,_100,4,>100
6401,sage,364,33191484,95.6266079008,_100,4,>100
6402,functional,364,33191848,95.6276566061,_100,10,>100
6403,compensation,364,33192212,95.6287053114,_100,12,>100
6404,trilogy,364,33192576,95.6297540167,_100,7,>100
6405,trace,364,33192940,95.630802722,_100,5,>100
6406,franklin,364,33193304,95.6318514273,_100,8,>100
6407,fog,364,33193668,95.6329001326,_100,3,>100
6408,stealing,364,33194032,95.6339488379,_100,8,>100
6409,mango,364,33194396,95.6349975432,_100,5,>100
6410,roller,364,33194760,95.6360462485,_100,6,>100
6411,ranging,364,33195124,95.6370949538,_100,7,>100
6412,tactics,363,33195487,95.638140778,_100,7,>100
6413,invasion,363,33195850,95.6391866023,_100,8,>100
6414,scroll,363,33196213,95.6402324265,_100,6,>100
6415,pens,363,33196576,95.6412782508,_100,4,>100
6416,ales,363,33196939,95.642324075,_100,4,>100
6417,indication,363,33197302,95.6433698992,_100,10,>100
6418,biscuits,363,33197665,95.6444157235,_100,8,>100
6419,cough,363,33198028,95.6454615477,_100,5,>100
6420,kicks,363,33198391,95.646507372,_100,5,>100
6421,wont,363,33198754,95.6475531962,_100,4,>100
6422,illusion,363,33199117,95.6485990205,_100,8,>100
6423,genetic,363,33199480,95.6496448447,_100,7,>100
6424,abby,363,33199843,95.650690669,_100,4,>100
6425,matched,363,33200206,95.6517364932,_100,7,>100
6426,restored,363,33200569,95.6527823174,_100,8,>100
6427,villain,362,33200931,95.6538252606,_100,7,>100
6428,insist,362,33201293,95.6548682038,_100,6,>100
6429,completing,362,33201655,95.655911147,_100,10,>100
6430,cleaner,362,33202017,95.6569540902,_100,7,>100
6431,curve,362,33202379,95.6579970334,_100,5,>100
6432,pillows,362,33202741,95.6590399766,_100,7,>100
6433,encourages,362,33203103,95.6600829197,_100,10,>100
6434,flights,362,33203465,95.6611258629,_100,7,>100
6435,attachment,362,33203827,95.6621688061,_100,10,>100
6436,noah,362,33204189,95.6632117493,_100,4,>100
6437,bugs,362,33204551,95.6642546925,_100,4,>100
6438,bowls,362,33204913,95.6652976357,_100,5,>100
6439,storms,361,33205274,95.6663376978,_100,6,>100
6440,champagne,361,33205635,95.6673777599,_100,9,>100
6441,resolved,361,33205996,95.6684178221,_100,8,>100
6442,scandal,361,33206357,95.6694578842,_100,7,>100
6443,variations,361,33206718,95.6704979463,_100,10,>100
6444,offended,361,33207079,95.6715380084,_100,8,>100
6445,viewer,361,33207440,95.6725780706,_100,6,>100
6446,sophie,361,33207801,95.6736181327,_100,6,>100
6447,sealed,360,33208161,95.6746553138,_100,6,>100
6448,buck,360,33208521,95.6756924948,_100,4,>100
6449,dramatically,360,33208881,95.6767296759,_100,12,>100
6450,360,360,33209241,95.677766857,_100,3,>100
6451,exceptional,360,33209601,95.678804038,_100,11,>100
6452,conspiracy,360,33209961,95.6798412191,_100,10,>100
6453,abundant,360,33210321,95.6808784002,_100,8,>100
6454,mario,360,33210681,95.6819155812,_100,5,>100
6455,permit,360,33211041,95.6829527623,_100,6,>100
6456,convert,360,33211401,95.6839899434,_100,7,>100
6457,chunks,360,33211761,95.6850271244,_100,6,>100
6458,crumbs,360,33212121,95.6860643055,_100,6,>100
6459,wounded,360,33212481,95.6871014866,_100,7,>100
6460,kennedy,360,33212841,95.6881386677,_100,7,>100
6461,morality,360,33213201,95.6891758487,_100,8,>100
6462,strictly,360,33213561,95.6902130298,_100,8,>100
6463,modest,359,33213920,95.6912473298,_100,6,>100
6464,locally,359,33214279,95.6922816298,_100,7,>100
6465,distinctive,359,33214638,95.6933159298,_100,11,>100
6466,credits,359,33214997,95.6943502298,_100,7,>100
6467,strings,359,33215356,95.6953845298,_100,7,>100
6468,apartheid,359,33215715,95.6964188298,_100,9,>100
6469,absurd,359,33216074,95.6974531299,_100,6,>100
6470,discovers,359,33216433,95.6984874299,_100,9,>100
6471,ghosts,359,33216792,95.6995217299,_100,6,>100
6472,rod,359,33217151,95.7005560299,_100,3,>100
6473,treasures,359,33217510,95.7015903299,_100,9,>100
6474,vampires,359,33217869,95.7026246299,_100,8,>100
6475,revolutionary,358,33218227,95.7036560489,_100,13,>100
6476,blossom,358,33218585,95.7046874678,_100,7,>100
6477,obey,358,33218943,95.7057188868,_100,4,>100
6478,proudly,358,33219301,95.7067503057,_100,7,>100
6479,hitler,358,33219659,95.7077817247,_100,6,>100
6480,acknowledged,358,33220017,95.7088131436,_100,12,>100
6481,tunnel,358,33220375,95.7098445626,_100,6,>100
6482,aliens,358,33220733,95.7108759815,_100,6,>100
6483,declare,358,33221091,95.7119074005,_100,7,>100
6484,jo,358,33221449,95.7129388194,_100,2,>100
6485,sporting,358,33221807,95.7139702384,_100,8,>100
6486,spokesman,358,33222165,95.7150016573,_100,9,>100
6487,parchment,358,33222523,95.7160330763,_100,9,>100
6488,fare,358,33222881,95.7170644952,_100,4,>100
6489,melissa,358,33223239,95.7180959142,_100,7,>100
6490,vancouver,358,33223597,95.7191273331,_100,9,>100
6491,dismissed,358,33223955,95.7201587521,_100,9,>100
6492,reporters,358,33224313,95.721190171,_100,9,>100
6493,soaked,358,33224671,95.72222159,_100,6,>100
6494,refusing,358,33225029,95.7232530089,_100,8,>100
6495,seated,358,33225387,95.7242844279,_100,6,>100
6496,mounted,358,33225745,95.7253158468,_100,7,>100
6497,believer,357,33226102,95.7263443847,_100,8,>100
6498,stole,357,33226459,95.7273729226,_100,5,>100
6499,jen,357,33226816,95.7284014605,_100,3,>100
6500,comprehensive,357,33227173,95.7294299984,_100,13,>100
6501,hosts,357,33227530,95.7304585363,_100,5,>100
6502,inability,357,33227887,95.7314870742,_100,9,>100
6503,priorities,357,33228244,95.7325156121,_100,10,>100
6504,preference,357,33228601,95.73354415,_100,10,>100
6505,saudi,357,33228958,95.7345726879,_100,5,>100
6506,immense,357,33229315,95.7356012258,_100,7,>100
6507,manual,357,33229672,95.7366297637,_100,6,>100
6508,grin,357,33230029,95.7376583016,_100,4,>100
6509,guild,356,33230385,95.7386839584,_100,5,>100
6510,implement,356,33230741,95.7397096152,_100,9,>100
6511,eagle,356,33231097,95.7407352721,_100,5,>100
6512,temptation,356,33231453,95.7417609289,_100,10,>100
6513,harris,356,33231809,95.7427865857,_100,6,>100
6514,procedures,356,33232165,95.7438122426,_100,10,>100
6515,dash,356,33232521,95.7448378994,_100,4,>100
6516,hiring,356,33232877,95.7458635562,_100,6,>100
6517,ross,356,33233233,95.7468892131,_100,4,>100
6518,writings,356,33233589,95.7479148699,_100,8,>100
6519,healthcare,356,33233945,95.7489405267,_100,10,>100
6520,africans,356,33234301,95.7499661836,_100,8,>100
6521,witnesses,356,33234657,95.7509918404,_100,9,>100
6522,vendors,356,33235013,95.7520174972,_100,7,>100
6523,scoop,355,33235368,95.753040273,_100,5,>100
6524,fbi,355,33235723,95.7540630488,_100,3,>100
6525,tournament,355,33236078,95.7550858246,_100,10,>100
6526,realizes,355,33236433,95.7561086003,_100,8,>100
6527,grated,355,33236788,95.7571313761,_100,6,>100
6528,doc,355,33237143,95.7581541519,_100,3,>100
6529,surrender,355,33237498,95.7591769277,_100,9,>100
6530,unpleasant,355,33237853,95.7601997035,_100,10,>100
6531,bersih,355,33238208,95.7612224792,_100,6,>100
6532,crappy,355,33238563,95.762245255,_100,6,>100
6533,influential,355,33238918,95.7632680308,_100,11,>100
6534,figuring,355,33239273,95.7642908066,_100,8,>100
6535,sleeve,354,33239627,95.7653107013,_100,6,>100
6536,topping,354,33239981,95.766330596,_100,7,>100
6537,clips,354,33240335,95.7673504907,_100,5,>100
6538,sesame,354,33240689,95.7683703854,_100,6,>100
6539,mindset,354,33241043,95.7693902801,_100,7,>100
6540,expectation,354,33241397,95.7704101749,_100,11,>100
6541,oval,354,33241751,95.7714300696,_100,4,>100
6542,controlling,354,33242105,95.7724499643,_100,11,>100
6543,carl,354,33242459,95.773469859,_100,4,>100
6544,receives,354,33242813,95.7744897537,_100,8,>100
6545,scholars,354,33243167,95.7755096484,_100,8,>100
6546,dump,354,33243521,95.7765295432,_100,4,>100
6547,denver,354,33243875,95.7775494379,_100,6,>100
6548,spine,354,33244229,95.7785693326,_100,5,>100
6549,labeled,354,33244583,95.7795892273,_100,7,>100
6550,porn,353,33244936,95.780606241,_100,4,>100
6551,cia,353,33245289,95.7816232546,_100,3,>100
6552,allegations,353,33245642,95.7826402683,_100,11,>100
6553,sidewalk,353,33245995,95.783657282,_100,8,>100
6554,prep,353,33246348,95.7846742956,_100,4,>100
6555,utilities,353,33246701,95.7856913093,_100,9,>100
6556,sip,353,33247054,95.7867083229,_100,3,>100
6557,recovered,353,33247407,95.7877253366,_100,9,>100
6558,bias,353,33247760,95.7887423502,_100,4,>100
6559,towers,353,33248113,95.7897593639,_100,6,>100
6560,slaves,353,33248466,95.7907763776,_100,6,>100
6561,appointments,353,33248819,95.7917933912,_100,12,>100
6562,clearing,353,33249172,95.7928104049,_100,8,>100
6563,controversy,352,33249524,95.7938245375,_100,11,>100
6564,lame,352,33249876,95.7948386701,_100,4,>100
6565,restrictions,352,33250228,95.7958528027,_100,12,>100
6566,cows,352,33250580,95.7968669353,_100,4,>100
6567,proceeds,352,33250932,95.7978810679,_100,8,>100
6568,guards,352,33251284,95.7988952005,_100,6,>100
6569,tennessee,352,33251636,95.7999093331,_100,9,>100
6570,alternate,352,33251988,95.8009234657,_100,9,>100
6571,variation,352,33252340,95.8019375983,_100,9,>100
6572,aaron,352,33252692,95.8029517309,_100,5,>100
6573,posters,352,33253044,95.8039658635,_100,7,>100
6574,scenery,352,33253396,95.8049799961,_100,7,>100
6575,entertain,351,33253747,95.8059912476,_100,9,>100
6576,towels,351,33254098,95.8070024992,_100,6,>100
6577,wit,351,33254449,95.8080137507,_100,3,>100
6578,invention,351,33254800,95.8090250023,_100,9,>100
6579,commander,351,33255151,95.8100362538,_100,9,>100
6580,presumably,351,33255502,95.8110475053,_100,10,>100
6581,nominated,351,33255853,95.8120587569,_100,9,>100
6582,pills,351,33256204,95.8130700084,_100,5,>100
6583,fragile,351,33256555,95.81408126,_100,7,>100
6584,crawl,351,33256906,95.8150925115,_100,5,>100
6585,achieving,350,33257256,95.816100882,_100,9,>100
6586,abandon,350,33257606,95.8171092525,_100,7,>100
6587,denial,350,33257956,95.818117623,_100,6,>100
6588,kiddos,350,33258306,95.8191259934,_100,6,>100
6589,niece,350,33258656,95.8201343639,_100,5,>100
6590,drizzle,350,33259006,95.8211427344,_100,7,>100
6591,infinite,350,33259356,95.8221511049,_100,8,>100
6592,harmony,350,33259706,95.8231594754,_100,7,>100
6593,350,350,33260056,95.8241678459,_100,3,>100
6594,rival,350,33260406,95.8251762163,_100,5,>100
6595,societies,350,33260756,95.8261845868,_100,9,>100
6596,danny,349,33261105,95.8271900763,_100,5,>100
6597,straw,349,33261454,95.8281955657,_100,5,>100
6598,preschool,349,33261803,95.8292010551,_100,9,>100
6599,disability,349,33262152,95.8302065445,_100,10,>100
6600,blocked,349,33262501,95.831212034,_100,7,>100
6601,donation,349,33262850,95.8322175234,_100,8,>100
6602,accurately,349,33263199,95.8332230128,_100,10,>100
6603,iconic,349,33263548,95.8342285022,_100,6,>100
6604,wallet,349,33263897,95.8352339917,_100,6,>100
6605,publicity,349,33264246,95.8362394811,_100,9,>100
6606,stall,349,33264595,95.8372449705,_100,5,>100
6607,rip,349,33264944,95.8382504599,_100,3,>100
6608,serial,348,33265292,95.8392530683,_100,6,>100
6609,framed,348,33265640,95.8402556767,_100,6,>100
6610,undoubtedly,348,33265988,95.841258285,_100,11,>100
6611,poison,348,33266336,95.8422608934,_100,6,>100
6612,screams,348,33266684,95.8432635018,_100,7,>100
6613,welcoming,348,33267032,95.8442661101,_100,9,>100
6614,philippines,348,33267380,95.8452687185,_100,11,>100
6615,screw,348,33267728,95.8462713269,_100,5,>100
6616,lengthy,348,33268076,95.8472739352,_100,7,>100
6617,incidents,348,33268424,95.8482765436,_100,9,>100
6618,champions,348,33268772,95.849279152,_100,9,>100
6619,homeland,348,33269120,95.8502817603,_100,8,>100
6620,ash,348,33269468,95.8512843687,_100,3,>100
6621,designing,347,33269815,95.852284096,_100,9,>100
6622,crochet,347,33270162,95.8532838233,_100,7,>100
6623,nod,347,33270509,95.8542835506,_100,3,>100
6624,griffin,347,33270856,95.8552832779,_100,7,>100
6625,electrical,347,33271203,95.8562830052,_100,10,>100
6626,aisle,347,33271550,95.8572827325,_100,5,>100
6627,offerings,347,33271897,95.8582824598,_100,9,>100
6628,practiced,347,33272244,95.8592821871,_100,9,>100
6629,reign,347,33272591,95.8602819145,_100,5,>100
6630,apostle,347,33272938,95.8612816418,_100,7,>100
6631,tense,347,33273285,95.8622813691,_100,5,>100
6632,widespread,347,33273632,95.8632810964,_100,10,>100
6633,simplicity,347,33273979,95.8642808237,_100,10,>100
6634,departure,347,33274326,95.865280551,_100,9,>100
6635,inspirational,347,33274673,95.8662802783,_100,13,>100
6636,dusty,347,33275020,95.8672800056,_100,5,>100
6637,bourbon,347,33275367,95.8682797329,_100,7,>100
6638,highlighted,346,33275713,95.8692765792,_100,11,>100
6639,loudly,346,33276059,95.8702734254,_100,6,>100
6640,trails,346,33276405,95.8712702717,_100,6,>100
6641,whispered,346,33276751,95.8722671179,_100,9,>100
6642,ridiculously,346,33277097,95.8732639642,_100,12,>100
6643,longing,346,33277443,95.8742608104,_100,7,>100
6644,pencils,346,33277789,95.8752576567,_100,7,>100
6645,expressing,346,33278135,95.8762545029,_100,10,>100
6646,rounded,346,33278481,95.8772513492,_100,7,>100
6647,judgement,346,33278827,95.8782481954,_100,9,>100
6648,nephew,346,33279173,95.8792450417,_100,6,>100
6649,improvements,346,33279519,95.8802418879,_100,12,>100
6650,counsel,346,33279865,95.8812387342,_100,7,>100
6651,heroine,345,33280210,95.8822326994,_100,7,>100
6652,heather,345,33280555,95.8832266645,_100,7,>100
6653,boats,345,33280900,95.8842206297,_100,5,>100
6654,wages,345,33281245,95.8852145949,_100,5,>100
6655,del,345,33281590,95.8862085601,_100,3,>100
6656,efficiency,345,33281935,95.8872025253,_100,10,>100
6657,rug,345,33282280,95.8881964905,_100,3,>100
6658,pursuing,345,33282625,95.8891904557,_100,8,>100
6659,destiny,345,33282970,95.8901844209,_100,7,>100
6660,faded,345,33283315,95.8911783861,_100,5,>100
6661,tours,345,33283660,95.8921723513,_100,5,>100
6662,rant,345,33284005,95.8931663164,_100,4,>100
6663,inappropriate,344,33284349,95.8941574006,_100,13,>100
6664,fab,344,33284693,95.8951484847,_100,3,>100
6665,behaviors,344,33285037,95.8961395688,_100,9,>100
6666,carol,344,33285381,95.897130653,_100,5,>100
6667,borrowed,344,33285725,95.8981217371,_100,8,>100
6668,salsa,344,33286069,95.8991128212,_100,5,>100
6669,eh,344,33286413,95.9001039054,_100,2,>100
6670,shouted,344,33286757,95.9010949895,_100,7,>100
6671,appearances,344,33287101,95.9020860736,_100,11,>100
6672,replacing,344,33287445,95.9030771578,_100,9,>100
6673,equipped,344,33287789,95.9040682419,_100,8,>100
6674,borrow,344,33288133,95.905059326,_100,6,>100
6675,origins,344,33288477,95.9060504102,_100,7,>100
6676,mysteries,344,33288821,95.9070414943,_100,9,>100
6677,cheating,344,33289165,95.9080325784,_100,8,>100
6678,explored,343,33289508,95.9090207815,_100,8,>100
6679,stats,343,33289851,95.9100089846,_100,5,>100
6680,shredded,343,33290194,95.9109971877,_100,8,>100
6681,kissed,343,33290537,95.9119853907,_100,6,>100
6682,sponsors,343,33290880,95.9129735938,_100,8,>100
6683,strongest,343,33291223,95.9139617969,_100,9,>100
6684,ethics,343,33291566,95.9149499999,_100,6,>100
6685,marie,343,33291909,95.915938203,_100,5,>100
6686,funded,343,33292252,95.9169264061,_100,6,>100
6687,needles,343,33292595,95.9179146092,_100,7,>100
6688,wasting,343,33292938,95.9189028122,_100,7,>100
6689,bat,343,33293281,95.9198910153,_100,3,>100
6690,conclusions,343,33293624,95.9208792184,_100,11,>100
6691,coincidence,342,33293966,95.9218645404,_100,11,>100
6692,responding,342,33294308,95.9228498624,_100,10,>100
6693,najib,342,33294650,95.9238351844,_100,5,>100
6694,predict,342,33294992,95.9248205065,_100,7,>100
6695,larry,342,33295334,95.9258058285,_100,5,>100
6696,repeating,342,33295676,95.9267911505,_100,9,>100
6697,foolish,342,33296018,95.9277764725,_100,7,>100
6698,legally,342,33296360,95.9287617945,_100,7,>100
6699,copper,341,33296701,95.9297442355,_100,6,>100
6700,gop,341,33297042,95.9307266764,_100,3,>100
6701,veterans,341,33297383,95.9317091174,_100,8,>100
6702,vacuum,341,33297724,95.9326915583,_100,6,>100
6703,weeds,341,33298065,95.9336739993,_100,5,>100
6704,bud,341,33298406,95.9346564403,_100,3,>100
6705,rogers,341,33298747,95.9356388812,_100,6,>100
6706,unsure,341,33299088,95.9366213222,_100,6,>100
6707,makers,341,33299429,95.9376037631,_100,6,>100
6708,males,341,33299770,95.9385862041,_100,5,>100
6709,embellishments,340,33300110,95.939565764,_100,14,>100
6710,yum,340,33300450,95.9405453239,_100,3,>100
6711,filing,340,33300790,95.9415248838,_100,6,>100
6712,defending,340,33301130,95.9425044437,_100,9,>100
6713,graham,340,33301470,95.9434840036,_100,6,>100
6714,containers,340,33301810,95.9444635635,_100,10,>100
6715,hips,340,33302150,95.9454431234,_100,4,>100
6716,declaration,340,33302490,95.9464226833,_100,11,>100
6717,starring,340,33302830,95.9474022432,_100,8,>100
6718,fulfilled,340,33303170,95.9483818031,_100,9,>100
6719,aforementioned,340,33303510,95.949361363,_100,14,>100
6720,tide,339,33303849,95.9503380418,_100,4,>100
6721,void,339,33304188,95.9513147206,_100,4,>100
6722,withdrawal,339,33304527,95.9522913995,_100,10,>100
6723,nutrition,339,33304866,95.9532680783,_100,9,>100
6724,provision,339,33305205,95.9542447572,_100,9,>100
6725,engines,339,33305544,95.955221436,_100,7,>100
6726,giants,339,33305883,95.9561981148,_100,6,>100
6727,ambitious,339,33306222,95.9571747937,_100,9,>100
6728,diy,339,33306561,95.9581514725,_100,3,>100
6729,bakery,339,33306900,95.9591281514,_100,6,>100
6730,smallest,339,33307239,95.9601048302,_100,8,>100
6731,pleasing,339,33307578,95.961081509,_100,8,>100
6732,arrange,339,33307917,95.9620581879,_100,7,>100
6733,rang,339,33308256,95.9630348667,_100,4,>100
6734,pineapple,339,33308595,95.9640115456,_100,9,>100
6735,irrelevant,339,33308934,95.9649882244,_100,10,>100
6736,celebrations,339,33309273,95.9659649032,_100,12,>100
6737,pirates,338,33309611,95.966938701,_100,7,>100
6738,vinyl,338,33309949,95.9679124988,_100,5,>100
6739,gel,338,33310287,95.9688862966,_100,3,>100
6740,franchise,338,33310625,95.9698600944,_100,9,>100
6741,outdoors,338,33310963,95.9708338921,_100,8,>100
6742,libya,338,33311301,95.9718076899,_100,5,>100
6743,portions,338,33311639,95.9727814877,_100,8,>100
6744,alabama,338,33311977,95.9737552855,_100,7,>100
6745,coal,338,33312315,95.9747290833,_100,4,>100
6746,indigenous,338,33312653,95.975702881,_100,10,>100
6747,namely,338,33312991,95.9766766788,_100,6,>100
6748,mold,338,33313329,95.9776504766,_100,4,>100
6749,pirate,338,33313667,95.9786242744,_100,6,>100
6750,spellbinders,338,33314005,95.9795980722,_100,12,>100
6751,banking,338,33314343,95.9805718699,_100,7,>100
6752,gown,338,33314681,95.9815456677,_100,4,>100
6753,twine,337,33315018,95.9825165845,_100,5,>100
6754,crops,337,33315355,95.9834875012,_100,5,>100
6755,infamous,337,33315692,95.9844584179,_100,8,>100
6756,baskets,337,33316029,95.9854293346,_100,7,>100
6757,residential,337,33316366,95.9864002513,_100,11,>100
6758,joan,337,33316703,95.9873711681,_100,4,>100
6759,zest,337,33317040,95.9883420848,_100,4,>100
6760,strive,337,33317377,95.9893130015,_100,6,>100
6761,curtain,337,33317714,95.9902839182,_100,7,>100
6762,rail,337,33318051,95.991254835,_100,4,>100
6763,excessive,337,33318388,95.9922257517,_100,9,>100
6764,rapid,337,33318725,95.9931966684,_100,5,>100
6765,owl,337,33319062,95.9941675851,_100,3,>100
6766,requiring,337,33319399,95.9951385018,_100,9,>100
6767,muffins,336,33319735,95.9961065375,_100,7,>100
6768,lasts,336,33320071,95.9970745732,_100,5,>100
6769,stability,336,33320407,95.9980426088,_100,9,>100
6770,kraft,336,33320743,95.9990106445,_100,5,>100
6771,parker,336,33321079,95.9999786802,_100,6,>100
6772,ipod,336,33321415,96.0009467158,_100,4,>100
6773,badge,336,33321751,96.0019147515,_100,5,>100
6774,wayne,336,33322087,96.0028827872,_100,5,>100
6775,rangers,336,33322423,96.0038508228,_100,7,>100
6776,grandchildren,336,33322759,96.0048188585,_100,13,>100
6777,delivers,335,33323094,96.0057840131,_100,8,>100
6778,countryside,335,33323429,96.0067491677,_100,11,>100
6779,quicker,335,33323764,96.0077143223,_100,7,>100
6780,flawed,335,33324099,96.0086794769,_100,6,>100
6781,predictable,335,33324434,96.0096446315,_100,11,>100
6782,adapt,335,33324769,96.0106097861,_100,5,>100
6783,reviewing,335,33325104,96.0115749407,_100,9,>100
6784,proportion,335,33325439,96.0125400953,_100,10,>100
6785,acquire,335,33325774,96.0135052499,_100,7,>100
6786,trigger,335,33326109,96.0144704045,_100,7,>100
6787,sickness,335,33326444,96.0154355591,_100,8,>100
6788,embraced,335,33326779,96.0164007138,_100,8,>100
6789,contacts,335,33327114,96.0173658684,_100,8,>100
6790,rank,335,33327449,96.018331023,_100,4,>100
6791,benjamin,335,33327784,96.0192961776,_100,8,>100
6792,villages,335,33328119,96.0202613322,_100,8,>100
6793,covenant,335,33328454,96.0212264868,_100,8,>100
6794,shoots,334,33328788,96.0221887603,_100,6,>100
6795,ranch,334,33329122,96.0231510339,_100,5,>100
6796,strengthen,334,33329456,96.0241133074,_100,10,>100
6797,cord,334,33329790,96.025075581,_100,4,>100
6798,minnesota,334,33330124,96.0260378545,_100,9,>100
6799,palate,334,33330458,96.0270001281,_100,6,>100
6800,righteousness,334,33330792,96.0279624016,_100,13,>100
6801,frightening,334,33331126,96.0289246752,_100,11,>100
6802,demonstration,334,33331460,96.0298869487,_100,13,>100
6803,financially,334,33331794,96.0308492223,_100,11,>100
6804,journals,334,33332128,96.0318114958,_100,8,>100
6805,exams,333,33332461,96.0327708883,_100,5,>100
6806,vessel,333,33332794,96.0337302808,_100,6,>100
6807,miracles,333,33333127,96.0346896733,_100,8,>100
6808,corinthians,333,33333460,96.0356490658,_100,11,>100
6809,cowboy,333,33333793,96.0366084582,_100,6,>100
6810,trunk,333,33334126,96.0375678507,_100,5,>100
6811,righteous,333,33334459,96.0385272432,_100,9,>100
6812,realities,333,33334792,96.0394866357,_100,9,>100
6813,editorial,333,33335125,96.0404460282,_100,9,>100
6814,unions,333,33335458,96.0414054207,_100,6,>100
6815,prompted,333,33335791,96.0423648132,_100,8,>100
6816,traditionally,333,33336124,96.0433242057,_100,13,>100
6817,liquor,333,33336457,96.0442835981,_100,6,>100
6818,cleveland,333,33336790,96.0452429906,_100,9,>100
6819,oxygen,333,33337123,96.0462023831,_100,6,>100
6820,savage,333,33337456,96.0471617756,_100,6,>100
6821,swiss,332,33337788,96.048118287,_100,5,>100
6822,continuous,332,33338120,96.0490747985,_100,10,>100
6823,underwear,332,33338452,96.0500313099,_100,9,>100
6824,fills,332,33338784,96.0509878213,_100,5,>100
6825,shifted,332,33339116,96.0519443328,_100,7,>100
6826,buyer,332,33339448,96.0529008442,_100,5,>100
6827,khan,332,33339780,96.0538573556,_100,4,>100
6828,frequency,332,33340112,96.0548138671,_100,9,>100
6829,outcomes,332,33340444,96.0557703785,_100,8,>100
6830,reluctant,332,33340776,96.0567268899,_100,9,>100
6831,politician,331,33341107,96.0576805203,_100,10,>100
6832,truths,331,33341438,96.0586341507,_100,6,>100
6833,hiking,331,33341769,96.059587781,_100,6,>100
6834,facial,331,33342100,96.0605414114,_100,6,>100
6835,psychology,331,33342431,96.0614950418,_100,10,>100
6836,shifts,331,33342762,96.0624486721,_100,6,>100
6837,priests,331,33343093,96.0634023025,_100,7,>100
6838,pans,331,33343424,96.0643559329,_100,4,>100
6839,fringe,331,33343755,96.0653095633,_100,6,>100
6840,biological,331,33344086,96.0662631936,_100,10,>100
6841,cage,331,33344417,96.067216824,_100,4,>100
6842,cheesy,331,33344748,96.0681704544,_100,6,>100
6843,nerves,331,33345079,96.0691240847,_100,6,>100
6844,alpha,331,33345410,96.0700777151,_100,5,>100
6845,tyler,331,33345741,96.0710313455,_100,5,>100
6846,absent,331,33346072,96.0719849759,_100,6,>100
6847,toll,331,33346403,96.0729386062,_100,4,>100
6848,dangers,330,33346733,96.0738893555,_100,7,>100
6849,canon,330,33347063,96.0748401049,_100,5,>100
6850,faint,330,33347393,96.0757908542,_100,5,>100
6851,ladder,330,33347723,96.0767416035,_100,6,>100
6852,roberts,330,33348053,96.0776923528,_100,7,>100
6853,thailand,330,33348383,96.0786431021,_100,8,>100
6854,smelled,330,33348713,96.0795938514,_100,7,>100
6855,thriller,330,33349043,96.0805446007,_100,8,>100
6856,damp,330,33349373,96.08149535,_100,4,>100
6857,bookstore,330,33349703,96.0824460994,_100,9,>100
6858,protective,330,33350033,96.0833968487,_100,10,>100
6859,obstacles,330,33350363,96.084347598,_100,9,>100
6860,grammar,330,33350693,96.0852983473,_100,7,>100
6861,gains,330,33351023,96.0862490966,_100,5,>100
6862,citrus,330,33351353,96.0871998459,_100,6,>100
6863,compliment,329,33351682,96.0881477142,_100,10,>100
6864,agricultural,329,33352011,96.0890955824,_100,12,>100
6865,forehead,329,33352340,96.0900434507,_100,8,>100
6866,formation,329,33352669,96.0909913189,_100,9,>100
6867,disabled,329,33352998,96.0919391872,_100,8,>100
6868,sincere,329,33353327,96.0928870554,_100,7,>100
6869,lauren,329,33353656,96.0938349237,_100,6,>100
6870,ethical,329,33353985,96.094782792,_100,7,>100
6871,attach,329,33354314,96.0957306602,_100,6,>100
6872,depressing,329,33354643,96.0966785285,_100,10,>100
6873,trusting,329,33354972,96.0976263967,_100,8,>100
6874,suited,329,33355301,96.098574265,_100,6,>100
6875,coke,329,33355630,96.0995221332,_100,4,>100
6876,forums,328,33355958,96.1004671204,_100,6,>100
6877,teachings,328,33356286,96.1014121076,_100,9,>100
6878,parmesan,328,33356614,96.1023570948,_100,8,>100
6879,examination,328,33356942,96.103302082,_100,11,>100
6880,innocence,328,33357270,96.1042470692,_100,9,>100
6881,survivors,328,33357598,96.1051920564,_100,9,>100
6882,recommendation,328,33357926,96.1061370436,_100,14,>100
6883,promoted,328,33358254,96.1070820308,_100,8,>100
6884,chelsea,328,33358582,96.108027018,_100,7,>100
6885,dilemma,328,33358910,96.1089720052,_100,7,>100
6886,adequate,328,33359238,96.1099169924,_100,8,>100
6887,egyptian,328,33359566,96.1108619796,_100,8,>100
6888,supper,328,33359894,96.1118069668,_100,6,>100
6889,madison,328,33360222,96.112751954,_100,7,>100
6890,lied,328,33360550,96.1136969412,_100,4,>100
6891,nerve,328,33360878,96.1146419284,_100,5,>100
6892,proceedings,328,33361206,96.1155869156,_100,11,>100
6893,coaches,328,33361534,96.1165319028,_100,7,>100
6894,twists,327,33361861,96.1174740089,_100,6,>100
6895,stylish,327,33362188,96.118416115,_100,7,>100
6896,physics,327,33362515,96.1193582212,_100,7,>100
6897,poets,327,33362842,96.1203003273,_100,5,>100
6898,varying,327,33363169,96.1212424334,_100,7,>100
6899,nut,327,33363496,96.1221845396,_100,3,>100
6900,linen,327,33363823,96.1231266457,_100,5,>100
6901,wiped,327,33364150,96.1240687519,_100,5,>100
6902,visions,327,33364477,96.125010858,_100,7,>100
6903,cited,327,33364804,96.1259529641,_100,5,>100
6904,cult,327,33365131,96.1268950703,_100,4,>100
6905,publications,327,33365458,96.1278371764,_100,12,>100
6906,horrific,326,33365784,96.1287764015,_100,8,>100
6907,leaning,326,33366110,96.1297156266,_100,7,>100
6908,alaska,326,33366436,96.1306548516,_100,6,>100
6909,barrier,326,33366762,96.1315940767,_100,7,>100
6910,mayo,326,33367088,96.1325333018,_100,4,>100
6911,conflicts,326,33367414,96.1334725269,_100,9,>100
6912,wrist,326,33367740,96.134411752,_100,5,>100
6913,donations,326,33368066,96.135350977,_100,9,>100
6914,yell,326,33368392,96.1362902021,_100,4,>100
6915,outlets,326,33368718,96.1372294272,_100,7,>100
6916,thrill,326,33369044,96.1381686523,_100,6,>100
6917,lent,326,33369370,96.1391078773,_100,4,>100
6918,grains,326,33369696,96.1400471024,_100,6,>100
6919,backgrounds,326,33370022,96.1409863275,_100,11,>100
6920,norway,326,33370348,96.1419255526,_100,6,>100
6921,theft,326,33370674,96.1428647777,_100,5,>100
6922,salary,325,33370999,96.1438011217,_100,6,>100
6923,hears,325,33371324,96.1447374657,_100,5,>100
6924,commenting,325,33371649,96.1456738097,_100,10,>100
6925,insights,325,33371974,96.1466101537,_100,8,>100
6926,guides,325,33372299,96.1475464978,_100,6,>100
6927,deliberate,325,33372624,96.1484828418,_100,10,>100
6928,sara,325,33372949,96.1494191858,_100,4,>100
6929,celery,325,33373274,96.1503555298,_100,6,>100
6930,joel,325,33373599,96.1512918738,_100,4,>100
6931,325,325,33373924,96.1522282179,_100,3,>100
6932,faculty,325,33374249,96.1531645619,_100,7,>100
6933,witty,325,33374574,96.1541009059,_100,5,>100
6934,bubbles,325,33374899,96.1550372499,_100,7,>100
6935,chains,325,33375224,96.1559735939,_100,6,>100
6936,expressions,324,33375548,96.1569070569,_100,11,>100
6937,donald,324,33375872,96.1578405199,_100,6,>100
6938,surreal,324,33376196,96.1587739828,_100,7,>100
6939,mates,324,33376520,96.1597074458,_100,5,>100
6940,feb,324,33376844,96.1606409088,_100,3,>100
6941,meters,324,33377168,96.1615743717,_100,6,>100
6942,buddies,324,33377492,96.1625078347,_100,7,>100
6943,tennis,324,33377816,96.1634412976,_100,6,>100
6944,crispy,324,33378140,96.1643747606,_100,6,>100
6945,consisted,324,33378464,96.1653082236,_100,9,>100
6946,misery,324,33378788,96.1662416865,_100,6,>100
6947,agrees,324,33379112,96.1671751495,_100,6,>100
6948,brighter,324,33379436,96.1681086124,_100,8,>100
6949,birthdays,324,33379760,96.1690420754,_100,9,>100
6950,leo,324,33380084,96.1699755384,_100,3,>100
6951,remembers,323,33380407,96.1709061203,_100,9,>100
6952,veteran,323,33380730,96.1718367022,_100,7,>100
6953,breed,323,33381053,96.1727672841,_100,5,>100
6954,obligation,323,33381376,96.173697866,_100,10,>100
6955,jesse,323,33381699,96.1746284479,_100,5,>100
6956,contributing,323,33382022,96.1755590298,_100,12,>100
6957,neighbours,323,33382345,96.1764896117,_100,10,>100
6958,tolerance,323,33382668,96.1774201936,_100,9,>100
6959,sung,323,33382991,96.1783507755,_100,4,>100
6960,thrift,323,33383314,96.1792813574,_100,6,>100
6961,ripe,323,33383637,96.1802119393,_100,4,>100
6962,mentor,323,33383960,96.1811425212,_100,6,>100
6963,rises,323,33384283,96.1820731031,_100,5,>100
6964,advise,323,33384606,96.183003685,_100,6,>100
6965,toxic,323,33384929,96.1839342669,_100,5,>100
6966,elder,323,33385252,96.1848648488,_100,5,>100
6967,noises,323,33385575,96.1857954307,_100,6,>100
6968,verbal,323,33385898,96.1867260126,_100,6,>100
6969,flows,323,33386221,96.1876565945,_100,5,>100
6970,reflecting,323,33386544,96.1885871764,_100,10,>100
6971,slot,323,33386867,96.1895177583,_100,4,>100
6972,consultant,323,33387190,96.1904483402,_100,10,>100
6973,nathan,322,33387512,96.1913760411,_100,6,>100
6974,kits,322,33387834,96.1923037419,_100,4,>100
6975,dolls,322,33388156,96.1932314428,_100,5,>100
6976,infant,322,33388478,96.1941591436,_100,6,>100
6977,finale,322,33388800,96.1950868445,_100,6,>100
6978,cheesecake,322,33389122,96.1960145453,_100,10,>100
6979,crib,322,33389444,96.1969422462,_100,4,>100
6980,preaching,322,33389766,96.197869947,_100,9,>100
6981,es,322,33390088,96.1987976478,_100,2,>100
6982,seam,322,33390410,96.1997253487,_100,4,>100
6983,obscure,322,33390732,96.2006530495,_100,7,>100
6984,chooses,322,33391054,96.2015807504,_100,7,>100
6985,knocking,322,33391376,96.2025084512,_100,8,>100
6986,sentiments,322,33391698,96.2034361521,_100,10,>100
6987,dumped,321,33392019,96.2043609719,_100,6,>100
6988,suite,321,33392340,96.2052857916,_100,5,>100
6989,envy,321,33392661,96.2062106114,_100,4,>100
6990,trucks,321,33392982,96.2071354312,_100,6,>100
6991,expose,321,33393303,96.208060251,_100,6,>100
6992,comparing,321,33393624,96.2089850708,_100,9,>100
6993,rivers,321,33393945,96.2099098906,_100,6,>100
6994,clues,321,33394266,96.2108347104,_100,5,>100
6995,inserted,321,33394587,96.2117595301,_100,8,>100
6996,predicted,321,33394908,96.2126843499,_100,9,>100
6997,output,320,33395228,96.2136062887,_100,6,>100
6998,acres,320,33395548,96.2145282274,_100,5,>100
6999,stems,320,33395868,96.2154501661,_100,5,>100
7000,illustration,320,33396188,96.2163721048,_100,12,>100
7001,mundane,320,33396508,96.2172940436,_100,7,>100
7002,silently,320,33396828,96.2182159823,_100,8,>100
7003,resolutions,320,33397148,96.219137921,_100,11,>100
7004,portfolio,320,33397468,96.2200598598,_100,9,>100
7005,interactions,320,33397788,96.2209817985,_100,12,>100
7006,stephanie,320,33398108,96.2219037372,_100,9,>100
7007,carved,320,33398428,96.2228256759,_100,6,>100
7008,civilians,320,33398748,96.2237476147,_100,9,>100
7009,patiently,320,33399068,96.2246695534,_100,9,>100
7010,cheers,320,33399388,96.2255914921,_100,6,>100
7011,bites,319,33399707,96.2265105498,_100,5,>100
7012,recognise,319,33400026,96.2274296075,_100,9,>100
7013,individually,319,33400345,96.2283486651,_100,12,>100
7014,scout,319,33400664,96.2292677228,_100,5,>100
7015,flavours,319,33400983,96.2301867805,_100,8,>100
7016,bnp,319,33401302,96.2311058381,_100,3,>100
7017,walter,319,33401621,96.2320248958,_100,6,>100
7018,vibe,319,33401940,96.2329439535,_100,4,>100
7019,programming,319,33402259,96.2338630111,_100,11,>100
7020,tokyo,319,33402578,96.2347820688,_100,5,>100
7021,settling,319,33402897,96.2357011265,_100,8,>100
7022,cabbage,318,33403215,96.2366173031,_100,7,>100
7023,backdrop,318,33403533,96.2375334797,_100,8,>100
7024,spelling,318,33403851,96.2384496563,_100,8,>100
7025,placement,318,33404169,96.2393658329,_100,9,>100
7026,narrator,318,33404487,96.2402820095,_100,8,>100
7027,mug,318,33404805,96.2411981861,_100,3,>100
7028,spy,318,33405123,96.2421143628,_100,3,>100
7029,confession,318,33405441,96.2430305394,_100,10,>100
7030,translate,318,33405759,96.243946716,_100,9,>100
7031,nicole,317,33406076,96.2448600115,_100,6,>100
7032,comfy,317,33406393,96.2457733071,_100,5,>100
7033,stance,317,33406710,96.2466866026,_100,6,>100
7034,aids,317,33407027,96.2475998982,_100,4,>100
7035,shells,317,33407344,96.2485131937,_100,6,>100
7036,utah,317,33407661,96.2494264893,_100,4,>100
7037,chemistry,317,33407978,96.2503397848,_100,9,>100
7038,ratings,317,33408295,96.2512530804,_100,7,>100
7039,suspects,317,33408612,96.2521663759,_100,8,>100
7040,trauma,317,33408929,96.2530796715,_100,6,>100
7041,risen,317,33409246,96.253992967,_100,5,>100
7042,du,317,33409563,96.2549062626,_100,2,>100
7043,sticker,317,33409880,96.2558195582,_100,7,>100
7044,strangely,317,33410197,96.2567328537,_100,9,>100
7045,lifting,317,33410514,96.2576461493,_100,7,>100
7046,celebrities,317,33410831,96.2585594448,_100,11,>100
7047,dec,317,33411148,96.2594727404,_100,3,>100
7048,cycling,317,33411465,96.2603860359,_100,7,>100
7049,designated,316,33411781,96.2612964504,_100,10,>100
7050,rosemary,316,33412097,96.2622068649,_100,8,>100
7051,saves,316,33412413,96.2631172794,_100,5,>100
7052,bye,316,33412729,96.2640276939,_100,3,>100
7053,cigarettes,316,33413045,96.2649381084,_100,10,>100
7054,imagery,316,33413361,96.2658485229,_100,7,>100
7055,alternatives,316,33413677,96.2667589374,_100,12,>100
7056,partial,316,33413993,96.2676693519,_100,7,>100
7057,preview,316,33414309,96.2685797664,_100,7,>100
7058,crackers,316,33414625,96.2694901808,_100,8,>100
7059,barrels,316,33414941,96.2704005953,_100,7,>100
7060,feat,316,33415257,96.2713110098,_100,4,>100
7061,flick,316,33415573,96.2722214243,_100,5,>100
7062,sally,316,33415889,96.2731318388,_100,5,>100
7063,apologies,316,33416205,96.2740422533,_100,9,>100
7064,additionally,315,33416520,96.2749497868,_100,12,>100
7065,carrier,315,33416835,96.2758573202,_100,7,>100
7066,experiments,315,33417150,96.2767648536,_100,11,>100
7067,thereby,315,33417465,96.2776723871,_100,7,>100
7068,essays,315,33417780,96.2785799205,_100,6,>100
7069,permanently,315,33418095,96.2794874539,_100,11,>100
7070,delayed,315,33418410,96.2803949874,_100,7,>100
7071,mitchell,315,33418725,96.2813025208,_100,8,>100
7072,desserts,315,33419040,96.2822100542,_100,8,>100
7073,muse,315,33419355,96.2831175877,_100,4,>100
7074,storyline,315,33419670,96.2840251211,_100,9,>100
7075,santorum,315,33419985,96.2849326545,_100,8,>100
7076,starter,315,33420300,96.285840188,_100,7,>100
7077,chin,314,33420614,96.2867448403,_100,4,>100
7078,boiled,314,33420928,96.2876494927,_100,6,>100
7079,drill,314,33421242,96.2885541451,_100,5,>100
7080,accountable,314,33421556,96.2894587975,_100,11,>100
7081,destructive,314,33421870,96.2903634499,_100,11,>100
7082,organisations,314,33422184,96.2912681022,_100,13,>100
7083,entertained,314,33422498,96.2921727546,_100,11,>100
7084,centered,314,33422812,96.293077407,_100,8,>100
7085,browsing,314,33423126,96.2939820594,_100,8,>100
7086,diced,314,33423440,96.2948867117,_100,5,>100
7087,screens,314,33423754,96.2957913641,_100,7,>100
7088,rocking,314,33424068,96.2966960165,_100,7,>100
7089,execution,314,33424382,96.2976006689,_100,9,>100
7090,bolt,313,33424695,96.2985024402,_100,4,>100
7091,chorus,313,33425008,96.2994042115,_100,6,>100
7092,noting,313,33425321,96.3003059828,_100,6,>100
7093,sierra,313,33425634,96.3012077541,_100,6,>100
7094,manifest,313,33425947,96.3021095255,_100,8,>100
7095,ruins,313,33426260,96.3030112968,_100,5,>100
7096,pointless,313,33426573,96.3039130681,_100,9,>100
7097,install,313,33426886,96.3048148394,_100,7,>100
7098,renewed,313,33427199,96.3057166107,_100,7,>100
7099,inherent,313,33427512,96.306618382,_100,8,>100
7100,workplace,313,33427825,96.3075201534,_100,9,>100
7101,attendance,313,33428138,96.3084219247,_100,10,>100
7102,groceries,312,33428450,96.3093208149,_100,9,>100
7103,headlines,312,33428762,96.3102197052,_100,9,>100
7104,sustain,312,33429074,96.3111185955,_100,7,>100
7105,tobacco,312,33429386,96.3120174857,_100,7,>100
7106,inflation,312,33429698,96.312916376,_100,9,>100
7107,shepherd,312,33430010,96.3138152662,_100,8,>100
7108,impress,312,33430322,96.3147141565,_100,7,>100
7109,radiation,312,33430634,96.3156130468,_100,9,>100
7110,occupation,312,33430946,96.316511937,_100,10,>100
7111,modified,312,33431258,96.3174108273,_100,8,>100
7112,solved,312,33431570,96.3183097175,_100,6,>100
7113,boutique,312,33431882,96.3192086078,_100,8,>100
7114,deepest,312,33432194,96.3201074981,_100,7,>100
7115,anime,312,33432506,96.3210063883,_100,5,>100
7116,argues,312,33432818,96.3219052786,_100,6,>100
7117,investigating,312,33433130,96.3228041688,_100,13,>100
7118,inexpensive,312,33433442,96.3237030591,_100,11,>100
7119,hamilton,311,33433753,96.3245990683,_100,8,>100
7120,kyle,311,33434064,96.3254950775,_100,4,>100
7121,encounters,311,33434375,96.3263910867,_100,10,>100
7122,bust,311,33434686,96.3272870959,_100,4,>100
7123,oils,311,33434997,96.3281831051,_100,4,>100
7124,versatile,311,33435308,96.3290791143,_100,9,>100
7125,coin,311,33435619,96.3299751235,_100,4,>100
7126,drained,311,33435930,96.3308711327,_100,7,>100
7127,spoiled,311,33436241,96.3317671419,_100,7,>100
7128,tribe,311,33436552,96.3326631511,_100,5,>100
7129,pdf,311,33436863,96.3335591603,_100,3,>100
7130,hype,311,33437174,96.3344551695,_100,4,>100
7131,airlines,310,33437484,96.3353482976,_100,8,>100
7132,accommodate,310,33437794,96.3362414258,_100,11,>100
7133,est,310,33438104,96.3371345539,_100,3,>100
7134,functioning,310,33438414,96.3380276821,_100,11,>100
7135,instructor,310,33438724,96.3389208102,_100,10,>100
7136,skilled,310,33439034,96.3398139384,_100,7,>100
7137,crashing,310,33439344,96.3407070665,_100,8,>100
7138,almonds,310,33439654,96.3416001946,_100,7,>100
7139,imaginary,310,33439964,96.3424933228,_100,9,>100
7140,gravy,310,33440274,96.3433864509,_100,5,>100
7141,cooled,310,33440584,96.3442795791,_100,6,>100
7142,molly,310,33440894,96.3451727072,_100,5,>100
7143,canyon,310,33441204,96.3460658354,_100,6,>100
7144,fb,310,33441514,96.3469589635,_100,2,>100
7145,cuisine,310,33441824,96.3478520916,_100,7,>100
7146,natalie,310,33442134,96.3487452198,_100,7,>100
7147,awaiting,309,33442443,96.3496354669,_100,8,>100
7148,reagan,309,33442752,96.350525714,_100,6,>100
7149,liverpool,309,33443061,96.351415961,_100,9,>100
7150,intact,309,33443370,96.3523062081,_100,6,>100
7151,toasted,309,33443679,96.3531964552,_100,7,>100
7152,addressing,309,33443988,96.3540867023,_100,10,>100
7153,opponent,309,33444297,96.3549769494,_100,8,>100
7154,symbols,309,33444606,96.3558671965,_100,7,>100
7155,vocabulary,309,33444915,96.3567574435,_100,10,>100
7156,recovering,309,33445224,96.3576476906,_100,10,>100
7157,heavens,309,33445533,96.3585379377,_100,7,>100
7158,clich,309,33445842,96.3594281848,_100,5,>100
7159,ivy,308,33446150,96.3603155508,_100,3,>100
7160,graphics,308,33446458,96.3612029168,_100,8,>100
7161,conclude,308,33446766,96.3620902829,_100,8,>100
7162,rubbish,308,33447074,96.3629776489,_100,7,>100
7163,uncertainty,308,33447382,96.3638650149,_100,11,>100
7164,flipped,308,33447690,96.3647523809,_100,7,>100
7165,inked,308,33447998,96.365639747,_100,5,>100
7166,chronic,308,33448306,96.366527113,_100,7,>100
7167,aloud,308,33448614,96.367414479,_100,5,>100
7168,farming,308,33448922,96.368301845,_100,7,>100
7169,judy,308,33449230,96.3691892111,_100,4,>100
7170,shabby,307,33449537,96.370073696,_100,6,>100
7171,sculpture,307,33449844,96.370958181,_100,9,>100
7172,senator,307,33450151,96.371842666,_100,7,>100
7173,messed,307,33450458,96.3727271509,_100,6,>100
7174,coral,307,33450765,96.3736116359,_100,5,>100
7175,enters,307,33451072,96.3744961209,_100,6,>100
7176,mentioning,307,33451379,96.3753806058,_100,10,>100
7177,seasoned,307,33451686,96.3762650908,_100,8,>100
7178,socially,307,33451993,96.3771495758,_100,8,>100
7179,id,307,33452300,96.3780340607,_100,2,>100
7180,coins,307,33452607,96.3789185457,_100,5,>100
7181,arrogant,307,33452914,96.3798030307,_100,8,>100
7182,fiscal,307,33453221,96.3806875156,_100,6,>100
7183,genres,307,33453528,96.3815720006,_100,6,>100
7184,retailers,307,33453835,96.3824564856,_100,9,>100
7185,coaching,307,33454142,96.3833409705,_100,8,>100
7186,apology,307,33454449,96.3842254555,_100,7,>100
7187,thanked,307,33454756,96.3851099405,_100,7,>100
7188,weddings,307,33455063,96.3859944254,_100,8,>100
7189,deficit,307,33455370,96.3868789104,_100,7,>100
7190,edinburgh,307,33455677,96.3877633954,_100,9,>100
7191,readings,307,33455984,96.3886478803,_100,8,>100
7192,sorted,306,33456290,96.3895294842,_100,6,>100
7193,skirts,306,33456596,96.3904110882,_100,6,>100
7194,dye,306,33456902,96.3912926921,_100,3,>100
7195,healed,306,33457208,96.392174296,_100,6,>100
7196,favourites,306,33457514,96.3930558999,_100,10,>100
7197,failures,306,33457820,96.3939375038,_100,8,>100
7198,swallow,306,33458126,96.3948191077,_100,7,>100
7199,welsh,306,33458432,96.3957007116,_100,5,>100
7200,strengths,306,33458738,96.3965823155,_100,9,>100
7201,provider,306,33459044,96.3974639194,_100,8,>100
7202,beaches,306,33459350,96.3983455233,_100,7,>100
7203,finances,306,33459656,96.3992271272,_100,8,>100
7204,peeled,306,33459962,96.4001087311,_100,6,>100
7205,cartridge,306,33460268,96.4009903351,_100,9,>100
7206,venues,306,33460574,96.401871939,_100,6,>100
7207,yield,306,33460880,96.4027535429,_100,5,>100
7208,seasoning,306,33461186,96.4036351468,_100,9,>100
7209,tire,306,33461492,96.4045167507,_100,4,>100
7210,succeeded,306,33461798,96.4053983546,_100,9,>100
7211,mcdonald,306,33462104,96.4062799585,_100,8,>100
7212,blair,306,33462410,96.4071615624,_100,5,>100
7213,animated,306,33462716,96.4080431663,_100,8,>100
7214,douglas,306,33463022,96.4089247702,_100,7,>100
7215,framework,306,33463328,96.4098063741,_100,9,>100
7216,submissions,306,33463634,96.410687978,_100,11,>100
7217,splash,306,33463940,96.411569582,_100,6,>100
7218,educate,305,33464245,96.4124483048,_100,7,>100
7219,olivia,305,33464550,96.4133270277,_100,6,>100
7220,afghan,305,33464855,96.4142057505,_100,6,>100
7221,diabetes,305,33465160,96.4150844734,_100,8,>100
7222,sketches,305,33465465,96.4159631962,_100,8,>100
7223,cabinets,305,33465770,96.4168419191,_100,8,>100
7224,gal,305,33466075,96.4177206419,_100,3,>100
7225,pope,305,33466380,96.4185993648,_100,4,>100
7226,storytelling,305,33466685,96.4194780876,_100,12,>100
7227,aesthetic,305,33466990,96.4203568105,_100,9,>100
7228,exhausting,305,33467295,96.4212355333,_100,10,>100
7229,sheriff,305,33467600,96.4221142562,_100,7,>100
7230,superb,305,33467905,96.422992979,_100,6,>100
7231,magnolia,304,33468209,96.4238688208,_100,8,>100
7232,accordingly,304,33468513,96.4247446626,_100,11,>100
7233,angela,304,33468817,96.4256205044,_100,6,>100
7234,unconscious,304,33469121,96.4264963462,_100,11,>100
7235,instinct,304,33469425,96.427372188,_100,8,>100
7236,ultrasound,304,33469729,96.4282480298,_100,10,>100
7237,nicer,304,33470033,96.4291238715,_100,5,>100
7238,ribbons,304,33470337,96.4299997133,_100,7,>100
7239,timothy,304,33470641,96.4308755551,_100,7,>100
7240,harper,304,33470945,96.4317513969,_100,6,>100
7241,emperor,304,33471249,96.4326272387,_100,7,>100
7242,rightly,304,33471553,96.4335030805,_100,7,>100
7243,proving,304,33471857,96.4343789223,_100,7,>100
7244,absorbed,304,33472161,96.4352547641,_100,8,>100
7245,grabbing,304,33472465,96.4361306059,_100,8,>100
7246,carrie,304,33472769,96.4370064477,_100,6,>100
7247,farther,303,33473072,96.4378794084,_100,7,>100
7248,guided,303,33473375,96.4387523691,_100,6,>100
7249,collar,303,33473678,96.4396253299,_100,6,>100
7250,frying,303,33473981,96.4404982906,_100,6,>100
7251,ashley,303,33474284,96.4413712513,_100,6,>100
7252,tile,303,33474587,96.4422442121,_100,4,>100
7253,tofu,303,33474890,96.4431171728,_100,4,>100
7254,investing,303,33475193,96.4439901335,_100,9,>100
7255,minded,303,33475496,96.4448630943,_100,6,>100
7256,viable,303,33475799,96.445736055,_100,6,>100
7257,illustrate,303,33476102,96.4466090157,_100,10,>100
7258,installment,303,33476405,96.4474819765,_100,11,>100
7259,respectively,303,33476708,96.4483549372,_100,12,>100
7260,drying,303,33477011,96.4492278979,_100,6,>100
7261,lodge,302,33477313,96.4500979776,_100,5,>100
7262,decorative,302,33477615,96.4509680573,_100,10,>100
7263,stunned,302,33477917,96.4518381369,_100,7,>100
7264,jumps,302,33478219,96.4527082166,_100,5,>100
7265,stripes,302,33478521,96.4535782963,_100,7,>100
7266,chunk,302,33478823,96.454448376,_100,5,>100
7267,francis,302,33479125,96.4553184556,_100,7,>100
7268,newborn,302,33479427,96.4561885353,_100,7,>100
7269,buses,302,33479729,96.457058615,_100,5,>100
7270,bedtime,302,33480031,96.4579286947,_100,7,>100
7271,allies,302,33480333,96.4587987743,_100,6,>100
7272,hurdle,301,33480634,96.459665973,_100,6,>100
7273,dedication,301,33480935,96.4605331716,_100,10,>100
7274,burgers,301,33481236,96.4614003702,_100,7,>100
7275,derek,301,33481537,96.4622675688,_100,5,>100
7276,screening,301,33481838,96.4631347674,_100,9,>100
7277,sustained,301,33482139,96.464001966,_100,9,>100
7278,feminist,301,33482440,96.4648691647,_100,8,>100
7279,firing,301,33482741,96.4657363633,_100,6,>100
7280,funky,301,33483042,96.4666035619,_100,5,>100
7281,vicious,301,33483343,96.4674707605,_100,7,>100
7282,digress,301,33483644,96.4683379591,_100,7,>100
7283,ruth,301,33483945,96.4692051577,_100,4,>100
7284,blake,301,33484246,96.4700723563,_100,5,>100
7285,developer,301,33484547,96.470939555,_100,9,>100
7286,packet,301,33484848,96.4718067536,_100,6,>100
7287,subsequently,301,33485149,96.4726739522,_100,12,>100
7288,sums,301,33485450,96.4735411508,_100,4,>100
7289,developers,301,33485751,96.4744083494,_100,10,>100
7290,stubborn,300,33486051,96.475272667,_100,8,>100
7291,certainty,300,33486351,96.4761369845,_100,9,>100
7292,mash,300,33486651,96.4770013021,_100,4,>100
7293,unfamiliar,300,33486951,96.4778656197,_100,10,>100
7294,database,300,33487251,96.4787299372,_100,8,>100
7295,surviving,300,33487551,96.4795942548,_100,9,>100
7296,gulf,300,33487851,96.4804585723,_100,4,>100
7297,missouri,300,33488151,96.4813228899,_100,8,>100
7298,300,300,33488451,96.4821872074,_100,3,>100
7299,dinners,300,33488751,96.483051525,_100,7,>100
7300,implemented,300,33489051,96.4839158426,_100,11,>100
7301,coupons,300,33489351,96.4847801601,_100,7,>100
7302,fashioned,300,33489651,96.4856444777,_100,9,>100
7303,distressed,300,33489951,96.4865087952,_100,10,>100
7304,overlooked,300,33490251,96.4873731128,_100,10,>100
7305,downloaded,300,33490551,96.4882374303,_100,10,>100
7306,photographed,300,33490851,96.4891017479,_100,12,>100
7307,ally,300,33491151,96.4899660655,_100,4,>100
7308,admired,300,33491451,96.490830383,_100,7,>100
7309,dublin,300,33491751,96.4916947006,_100,6,>100
7310,memoir,299,33492050,96.4925561371,_100,6,>100
7311,meds,299,33492349,96.4934175736,_100,4,>100
7312,oral,299,33492648,96.4942790101,_100,4,>100
7313,barley,299,33492947,96.4951404466,_100,6,>100
7314,piles,299,33493246,96.4960018831,_100,5,>100
7315,prey,299,33493545,96.4968633196,_100,4,>100
7316,collapsed,299,33493844,96.4977247561,_100,9,>100
7317,ontario,299,33494143,96.4985861926,_100,7,>100
7318,murphy,299,33494442,96.4994476291,_100,6,>100
7319,liver,299,33494741,96.5003090656,_100,5,>100
7320,dispute,299,33495040,96.5011705021,_100,7,>100
7321,kissing,299,33495339,96.5020319386,_100,7,>100
7322,singles,299,33495638,96.502893375,_100,7,>100
7323,glowing,299,33495937,96.5037548115,_100,7,>100
7324,spotlight,299,33496236,96.504616248,_100,9,>100
7325,blade,299,33496535,96.5054776845,_100,5,>100
7326,forgiven,299,33496834,96.506339121,_100,8,>100
7327,straightforward,298,33497132,96.5071976765,_100,15,>100
7328,buds,298,33497430,96.5080562319,_100,4,>100
7329,casey,298,33497728,96.5089147874,_100,5,>100
7330,fade,298,33498026,96.5097733428,_100,4,>100
7331,layouts,298,33498324,96.5106318982,_100,7,>100
7332,ellen,298,33498622,96.5114904537,_100,5,>100
7333,showers,298,33498920,96.5123490091,_100,7,>100
7334,relates,298,33499218,96.5132075646,_100,7,>100
7335,fierce,298,33499516,96.51406612,_100,6,>100
7336,disappoint,298,33499814,96.5149246754,_100,10,>100
7337,jill,298,33500112,96.5157832309,_100,4,>100
7338,gallon,298,33500410,96.5166417863,_100,6,>100
7339,heating,298,33500708,96.5175003418,_100,7,>100
7340,caroline,298,33501006,96.5183588972,_100,8,>100
7341,valued,298,33501304,96.5192174526,_100,6,>100
7342,lacks,298,33501602,96.5200760081,_100,5,>100
7343,blamed,298,33501900,96.5209345635,_100,6,>100
7344,indulge,297,33502197,96.5217902379,_100,7,>100
7345,fulfilling,297,33502494,96.5226459123,_100,10,>100
7346,aims,297,33502791,96.5235015867,_100,4,>100
7347,communion,297,33503088,96.5243572611,_100,9,>100
7348,sandy,297,33503385,96.5252129354,_100,5,>100
7349,organ,297,33503682,96.5260686098,_100,5,>100
7350,rhetoric,297,33503979,96.5269242842,_100,8,>100
7351,slightest,297,33504276,96.5277799586,_100,9,>100
7352,paranormal,297,33504573,96.528635633,_100,10,>100
7353,photographers,297,33504870,96.5294913073,_100,13,>100
7354,positively,297,33505167,96.5303469817,_100,10,>100
7355,navigate,297,33505464,96.5312026561,_100,8,>100
7356,headline,297,33505761,96.5320583305,_100,8,>100
7357,lynn,297,33506058,96.5329140049,_100,4,>100
7358,umno,297,33506355,96.5337696793,_100,4,>100
7359,tropical,297,33506652,96.5346253536,_100,8,>100
7360,spaghetti,297,33506949,96.535481028,_100,9,>100
7361,wilderness,296,33507245,96.5363338213,_100,10,>100
7362,dancer,296,33507541,96.5371866147,_100,6,>100
7363,harbor,296,33507837,96.538039408,_100,6,>100
7364,bracelet,296,33508133,96.5388922013,_100,8,>100
7365,iv,296,33508429,96.5397449946,_100,2,>100
7366,unbelievable,296,33508725,96.540597788,_100,12,>100
7367,cooper,296,33509021,96.5414505813,_100,6,>100
7368,inventory,296,33509317,96.5423033746,_100,9,>100
7369,blankets,296,33509613,96.5431561679,_100,8,>100
7370,jackie,296,33509909,96.5440089612,_100,6,>100
7371,colonial,296,33510205,96.5448617546,_100,8,>100
7372,batteries,296,33510501,96.5457145479,_100,9,>100
7373,suspense,296,33510797,96.5465673412,_100,8,>100
7374,perceive,296,33511093,96.5474201345,_100,8,>100
7375,lipstick,296,33511389,96.5482729279,_100,8,>100
7376,indoor,296,33511685,96.5491257212,_100,6,>100
7377,spiritually,296,33511981,96.5499785145,_100,11,>100
7378,hometown,296,33512277,96.5508313078,_100,8,>100
7379,optimistic,296,33512573,96.5516841012,_100,10,>100
7380,ikea,296,33512869,96.5525368945,_100,4,>100
7381,soooo,296,33513165,96.5533896878,_100,5,>100
7382,hopping,296,33513461,96.5542424811,_100,7,>100
7383,juicy,296,33513757,96.5550952744,_100,5,>100
7384,hesitate,296,33514053,96.5559480678,_100,8,>100
7385,prone,296,33514349,96.5568008611,_100,5,>100
7386,lil,296,33514645,96.5576536544,_100,3,>100
7387,outright,296,33514941,96.5585064477,_100,8,>100
7388,piss,296,33515237,96.5593592411,_100,4,>100
7389,mississippi,295,33515532,96.5602091533,_100,11,>100
7390,crawling,295,33515827,96.5610590656,_100,8,>100
7391,swedish,295,33516122,96.5619089779,_100,7,>100
7392,regulation,295,33516417,96.5627588901,_100,10,>100
7393,riley,295,33516712,96.5636088024,_100,5,>100
7394,legislature,295,33517007,96.5644587146,_100,11,>100
7395,cracks,295,33517302,96.5653086269,_100,6,>100
7396,medieval,295,33517597,96.5661585392,_100,8,>100
7397,newer,295,33517892,96.5670084514,_100,5,>100
7398,juices,295,33518187,96.5678583637,_100,6,>100
7399,float,295,33518482,96.568708276,_100,5,>100
7400,accompany,295,33518777,96.5695581882,_100,9,>100
7401,leftovers,295,33519072,96.5704081005,_100,9,>100
7402,reportedly,294,33519366,96.5712551317,_100,10,>100
7403,sweep,294,33519660,96.5721021629,_100,5,>100
7404,unhealthy,294,33519954,96.5729491941,_100,9,>100
7405,mister,294,33520248,96.5737962253,_100,6,>100
7406,simpler,294,33520542,96.5746432565,_100,7,>100
7407,customs,294,33520836,96.5754902877,_100,7,>100
7408,nov,294,33521130,96.5763373189,_100,3,>100
7409,genesis,294,33521424,96.5771843501,_100,7,>100
7410,cm,294,33521718,96.5780313814,_100,2,>100
7411,sings,294,33522012,96.5788784126,_100,5,>100
7412,devotion,294,33522306,96.5797254438,_100,8,>100
7413,barnes,293,33522599,96.5805695939,_100,6,>100
7414,conferences,293,33522892,96.5814137441,_100,11,>100
7415,cloves,293,33523185,96.5822578942,_100,6,>100
7416,permitted,293,33523478,96.5831020444,_100,9,>100
7417,newcastle,293,33523771,96.5839461945,_100,9,>100
7418,threads,293,33524064,96.5847903447,_100,7,>100
7419,filter,293,33524357,96.5856344948,_100,6,>100
7420,angles,293,33524650,96.5864786449,_100,6,>100
7421,bella,293,33524943,96.5873227951,_100,5,>100
7422,intake,293,33525236,96.5881669452,_100,6,>100
7423,achievements,293,33525529,96.5890110954,_100,12,>100
7424,completion,293,33525822,96.5898552455,_100,10,>100
7425,filmed,293,33526115,96.5906993957,_100,6,>100
7426,poop,293,33526408,96.5915435458,_100,4,>100
7427,eddie,293,33526701,96.592387696,_100,5,>100
7428,fires,293,33526994,96.5932318461,_100,5,>100
7429,cheerful,293,33527287,96.5940759963,_100,8,>100
7430,punches,293,33527580,96.5949201464,_100,7,>100
7431,unfolding,293,33527873,96.5957642966,_100,9,>100
7432,forecast,292,33528165,96.5966055657,_100,8,>100
7433,blending,292,33528457,96.5974468347,_100,8,>100
7434,swift,292,33528749,96.5982881038,_100,5,>100
7435,gregory,292,33529041,96.5991293729,_100,7,>100
7436,fury,292,33529333,96.599970642,_100,4,>100
7437,crunchy,292,33529625,96.6008119111,_100,7,>100
7438,implies,292,33529917,96.6016531802,_100,7,>100
7439,lt,292,33530209,96.6024944493,_100,2,>100
7440,chicks,292,33530501,96.6033357184,_100,6,>100
7441,inspires,292,33530793,96.6041769875,_100,8,>100
7442,stained,292,33531085,96.6050182565,_100,7,>100
7443,sweden,292,33531377,96.6058595256,_100,6,>100
7444,haunted,292,33531669,96.6067007947,_100,7,>100
7445,deeds,292,33531961,96.6075420638,_100,5,>100
7446,preventing,292,33532253,96.6083833329,_100,10,>100
7447,dancers,291,33532544,96.6092217209,_100,7,>100
7448,taxpayers,291,33532835,96.610060109,_100,9,>100
7449,literal,291,33533126,96.610898497,_100,7,>100
7450,belonged,291,33533417,96.611736885,_100,8,>100
7451,hmmm,291,33533708,96.6125752731,_100,4,>100
7452,genocide,291,33533999,96.6134136611,_100,8,>100
7453,hubs,291,33534290,96.6142520491,_100,4,>100
7454,patio,291,33534581,96.6150904371,_100,5,>100
7455,cooperation,291,33534872,96.6159288252,_100,11,>100
7456,investments,291,33535163,96.6167672132,_100,11,>100
7457,indonesia,291,33535454,96.6176056012,_100,9,>100
7458,opposing,291,33535745,96.6184439893,_100,8,>100
7459,mummy,291,33536036,96.6192823773,_100,5,>100
7460,salty,291,33536327,96.6201207653,_100,5,>100
7461,subway,291,33536618,96.6209591534,_100,6,>100
7462,scenarios,290,33536908,96.6217946603,_100,9,>100
7463,capabilities,290,33537198,96.6226301673,_100,12,>100
7464,faux,290,33537488,96.6234656743,_100,4,>100
7465,departments,290,33537778,96.6243011812,_100,11,>100
7466,shark,290,33538068,96.6251366882,_100,5,>100
7467,squeezed,290,33538358,96.6259721952,_100,8,>100
7468,blocking,290,33538648,96.6268077022,_100,8,>100
7469,nevada,290,33538938,96.6276432091,_100,6,>100
7470,rebecca,290,33539228,96.6284787161,_100,7,>100
7471,skipped,290,33539518,96.6293142231,_100,7,>100
7472,scholarship,290,33539808,96.6301497301,_100,11,>100
7473,catches,290,33540098,96.630985237,_100,7,>100
7474,birmingham,290,33540388,96.631820744,_100,10,>100
7475,masterpiece,289,33540677,96.6326533699,_100,11,>100
7476,cancelled,289,33540966,96.6334859958,_100,9,>100
7477,radar,289,33541255,96.6343186217,_100,5,>100
7478,denying,289,33541544,96.6351512476,_100,7,>100
7479,mo,289,33541833,96.6359838736,_100,2,>100
7480,prosperity,289,33542122,96.6368164995,_100,10,>100
7481,technological,289,33542411,96.6376491254,_100,13,>100
7482,cuba,289,33542700,96.6384817513,_100,4,>100
7483,mentality,289,33542989,96.6393143772,_100,9,>100
7484,harmful,289,33543278,96.6401470031,_100,7,>100
7485,flu,289,33543567,96.640979629,_100,3,>100
7486,lakes,289,33543856,96.641812255,_100,5,>100
7487,proposals,289,33544145,96.6426448809,_100,9,>100
7488,sri,289,33544434,96.6434775068,_100,3,>100
7489,advantages,289,33544723,96.6443101327,_100,10,>100
7490,tutorials,289,33545012,96.6451427586,_100,9,>100
7491,invites,289,33545301,96.6459753845,_100,7,>100
7492,festivals,289,33545590,96.6468080104,_100,9,>100
7493,dimensions,289,33545879,96.6476406364,_100,10,>100
7494,compelled,289,33546168,96.6484732623,_100,9,>100
7495,drunken,289,33546457,96.6493058882,_100,7,>100
7496,monitoring,289,33546746,96.6501385141,_100,10,>100
7497,nato,289,33547035,96.65097114,_100,4,>100
7498,marshall,289,33547324,96.6518037659,_100,8,>100
7499,theology,288,33547612,96.6526335108,_100,8,>100
7500,icon,288,33547900,96.6534632556,_100,4,>100
7501,clash,288,33548188,96.6542930005,_100,5,>100
7502,continent,288,33548476,96.6551227453,_100,9,>100
7503,safer,288,33548764,96.6559524902,_100,5,>100
7504,accustomed,288,33549052,96.656782235,_100,10,>100
7505,bump,288,33549340,96.6576119799,_100,4,>100
7506,louisiana,288,33549628,96.6584417248,_100,9,>100
7507,festive,288,33549916,96.6592714696,_100,7,>100
7508,broader,288,33550204,96.6601012145,_100,7,>100
7509,fuzzy,287,33550491,96.6609280783,_100,5,>100
7510,ensuring,287,33550778,96.6617549421,_100,8,>100
7511,staple,287,33551065,96.6625818059,_100,6,>100
7512,nashville,287,33551352,96.6634086697,_100,9,>100
7513,grabs,287,33551639,96.6642355334,_100,5,>100
7514,mob,287,33551926,96.6650623972,_100,3,>100
7515,downright,287,33552213,96.665889261,_100,9,>100
7516,beg,287,33552500,96.6667161248,_100,3,>100
7517,province,287,33552787,96.6675429886,_100,8,>100
7518,billions,287,33553074,96.6683698524,_100,8,>100
7519,breakdown,287,33553361,96.6691967162,_100,9,>100
7520,exercising,287,33553648,96.67002358,_100,10,>100
7521,destined,287,33553935,96.6708504438,_100,8,>100
7522,commerce,287,33554222,96.6716773076,_100,8,>100
7523,malcolm,287,33554509,96.6725041714,_100,7,>100
7524,adjusted,287,33554796,96.6733310352,_100,8,>100
7525,remotely,287,33555083,96.674157899,_100,8,>100
7526,syria,287,33555370,96.6749847628,_100,5,>100
7527,secular,287,33555657,96.6758116266,_100,7,>100
7528,asparagus,286,33555943,96.6766356093,_100,9,>100
7529,caribbean,286,33556229,96.6774595921,_100,9,>100
7530,iowa,286,33556515,96.6782835748,_100,4,>100
7531,trembling,286,33556801,96.6791075575,_100,9,>100
7532,robinson,286,33557087,96.6799315403,_100,8,>100
7533,apostles,286,33557373,96.680755523,_100,8,>100
7534,suffice,286,33557659,96.6815795058,_100,7,>100
7535,alcoholic,286,33557945,96.6824034885,_100,9,>100
7536,iceland,286,33558231,96.6832274712,_100,7,>100
7537,greed,286,33558517,96.684051454,_100,5,>100
7538,prompt,286,33558803,96.6848754367,_100,6,>100
7539,collage,286,33559089,96.6856994195,_100,7,>100
7540,dragons,286,33559375,96.6865234022,_100,7,>100
7541,insists,286,33559661,96.6873473849,_100,7,>100
7542,stickles,285,33559946,96.6881684866,_100,8,>100
7543,pole,285,33560231,96.6889895883,_100,4,>100
7544,hugely,285,33560516,96.68981069,_100,6,>100
7545,doubled,285,33560801,96.6906317916,_100,7,>100
7546,rye,285,33561086,96.6914528933,_100,3,>100
7547,scissors,285,33561371,96.692273995,_100,8,>100
7548,automatic,285,33561656,96.6930950967,_100,9,>100
7549,interactive,285,33561941,96.6939161984,_100,11,>100
7550,zucchini,285,33562226,96.6947373,_100,8,>100
7551,ribs,285,33562511,96.6955584017,_100,4,>100
7552,experimental,285,33562796,96.6963795034,_100,12,>100
7553,sparkling,285,33563081,96.6972006051,_100,9,>100
7554,rooted,285,33563366,96.6980217068,_100,6,>100
7555,lively,285,33563651,96.6988428084,_100,6,>100
7556,populations,285,33563936,96.6996639101,_100,11,>100
7557,prevented,284,33564220,96.7004821307,_100,9,>100
7558,culinary,284,33564504,96.7013003514,_100,8,>100
7559,bases,284,33564788,96.702118572,_100,5,>100
7560,bottled,284,33565072,96.7029367926,_100,7,>100
7561,wholly,284,33565356,96.7037550132,_100,6,>100
7562,animation,284,33565640,96.7045732338,_100,9,>100
7563,steadily,284,33565924,96.7053914545,_100,8,>100
7564,sanity,284,33566208,96.7062096751,_100,6,>100
7565,cracking,284,33566492,96.7070278957,_100,8,>100
7566,hmm,284,33566776,96.7078461163,_100,3,>100
7567,paperback,284,33567060,96.7086643369,_100,9,>100
7568,holtz,284,33567344,96.7094825576,_100,5,>100
7569,samsung,284,33567628,96.7103007782,_100,7,>100
7570,parsley,284,33567912,96.7111189988,_100,7,>100
7571,inquiry,284,33568196,96.7119372194,_100,7,>100
7572,contractions,284,33568480,96.7127554401,_100,12,>100
7573,committing,284,33568764,96.7135736607,_100,10,>100
7574,pads,284,33569048,96.7143918813,_100,4,>100
7575,broadway,284,33569332,96.7152101019,_100,8,>100
7576,marriages,284,33569616,96.7160283225,_100,9,>100
7577,adaptation,284,33569900,96.7168465432,_100,10,>100
7578,continuously,284,33570184,96.7176647638,_100,12,>100
7579,megan,284,33570468,96.7184829844,_100,5,>100
7580,crafted,284,33570752,96.719301205,_100,7,>100
7581,browned,283,33571035,96.7201165446,_100,7,>100
7582,melting,283,33571318,96.7209318841,_100,7,>100
7583,naive,283,33571601,96.7217472237,_100,5,>100
7584,preach,283,33571884,96.7225625633,_100,6,>100
7585,updating,283,33572167,96.7233779028,_100,8,>100
7586,errands,283,33572450,96.7241932424,_100,7,>100
7587,fleet,283,33572733,96.725008582,_100,5,>100
7588,pension,283,33573016,96.7258239215,_100,7,>100
7589,poetic,283,33573299,96.7266392611,_100,6,>100
7590,installation,283,33573582,96.7274546006,_100,12,>100
7591,mechanism,283,33573865,96.7282699402,_100,9,>100
7592,travelled,283,33574148,96.7290852798,_100,9,>100
7593,stripped,283,33574431,96.7299006193,_100,8,>100
7594,mirrors,283,33574714,96.7307159589,_100,7,>100
7595,sacrifices,282,33574996,96.7315284174,_100,10,>100
7596,font,282,33575278,96.7323408759,_100,4,>100
7597,luggage,282,33575560,96.7331533344,_100,7,>100
7598,blogspot,282,33575842,96.7339657929,_100,8,>100
7599,fireworks,282,33576124,96.7347782514,_100,9,>100
7600,omg,282,33576406,96.7355907099,_100,3,>100
7601,bead,282,33576688,96.7364031684,_100,4,>100
7602,wizard,282,33576970,96.7372156269,_100,6,>100
7603,privileged,282,33577252,96.7380280854,_100,10,>100
7604,drift,282,33577534,96.7388405439,_100,5,>100
7605,hectic,282,33577816,96.7396530024,_100,6,>100
7606,stain,282,33578098,96.7404654609,_100,5,>100
7607,garnish,282,33578380,96.7412779194,_100,7,>100
7608,sliding,282,33578662,96.7420903779,_100,7,>100
7609,prospects,282,33578944,96.7429028364,_100,9,>100
7610,glossy,282,33579226,96.7437152949,_100,6,>100
7611,engineer,282,33579508,96.7445277535,_100,8,>100
7612,polished,282,33579790,96.745340212,_100,8,>100
7613,donna,281,33580071,96.7461497894,_100,5,>100
7614,compound,281,33580352,96.7469593668,_100,8,>100
7615,chatted,281,33580633,96.7477689443,_100,7,>100
7616,closes,281,33580914,96.7485785217,_100,6,>100
7617,stanley,281,33581195,96.7493880992,_100,7,>100
7618,seafood,281,33581476,96.7501976766,_100,7,>100
7619,trio,281,33581757,96.7510072541,_100,4,>100
7620,didnt,281,33582038,96.7518168315,_100,5,>100
7621,powdered,281,33582319,96.752626409,_100,8,>100
7622,moisture,281,33582600,96.7534359864,_100,8,>100
7623,haul,281,33582881,96.7542455639,_100,4,>100
7624,ounces,281,33583162,96.7550551413,_100,6,>100
7625,frightened,281,33583443,96.7558647187,_100,10,>100
7626,fuss,281,33583724,96.7566742962,_100,4,>100
7627,uncertain,281,33584005,96.7574838736,_100,9,>100
7628,myths,281,33584286,96.7582934511,_100,5,>100
7629,motives,281,33584567,96.7591030285,_100,7,>100
7630,screwed,280,33584847,96.7599097249,_100,7,>100
7631,ankle,280,33585127,96.7607164213,_100,5,>100
7632,plug,280,33585407,96.7615231177,_100,4,>100
7633,lend,280,33585687,96.7623298141,_100,4,>100
7634,noticing,280,33585967,96.7631365105,_100,8,>100
7635,custody,280,33586247,96.7639432068,_100,7,>100
7636,disorders,280,33586527,96.7647499032,_100,9,>100
7637,widow,280,33586807,96.7655565996,_100,5,>100
7638,nigeria,280,33587087,96.766363296,_100,7,>100
7639,manufacturers,280,33587367,96.7671699924,_100,13,>100
7640,triumph,280,33587647,96.7679766888,_100,7,>100
7641,lust,280,33587927,96.7687833852,_100,4,>100
7642,sparkle,280,33588207,96.7695900816,_100,7,>100
7643,appropriately,280,33588487,96.7703967779,_100,13,>100
7644,subscribe,280,33588767,96.7712034743,_100,9,>100
7645,warmed,279,33589046,96.7720072897,_100,6,>100
7646,filming,279,33589325,96.772811105,_100,7,>100
7647,oneself,279,33589604,96.7736149203,_100,7,>100
7648,karma,279,33589883,96.7744187356,_100,5,>100
7649,affecting,279,33590162,96.775222551,_100,9,>100
7650,ideals,279,33590441,96.7760263663,_100,6,>100
7651,activist,279,33590720,96.7768301816,_100,8,>100
7652,vain,279,33590999,96.777633997,_100,4,>100
7653,grid,279,33591278,96.7784378123,_100,4,>100
7654,neglect,279,33591557,96.7792416276,_100,7,>100
7655,hopped,278,33591835,96.7800425619,_100,6,>100
7656,noticeable,278,33592113,96.7808434961,_100,10,>100
7657,skeptical,278,33592391,96.7816444304,_100,9,>100
7658,mechanical,278,33592669,96.7824453647,_100,10,>100
7659,elastic,278,33592947,96.783246299,_100,7,>100
7660,todd,278,33593225,96.7840472332,_100,4,>100
7661,imposed,278,33593503,96.7848481675,_100,7,>100
7662,ballet,278,33593781,96.7856491018,_100,6,>100
7663,condemned,278,33594059,96.786450036,_100,9,>100
7664,accents,278,33594337,96.7872509703,_100,7,>100
7665,glanced,278,33594615,96.7880519046,_100,7,>100
7666,printer,278,33594893,96.7888528388,_100,7,>100
7667,idol,278,33595171,96.7896537731,_100,4,>100
7668,di,278,33595449,96.7904547074,_100,2,>100
7669,prevention,277,33595726,96.7912527606,_100,10,>100
7670,examined,277,33596003,96.7920508138,_100,8,>100
7671,volumes,277,33596280,96.792848867,_100,7,>100
7672,spa,277,33596557,96.7936469202,_100,3,>100
7673,tablet,277,33596834,96.7944449734,_100,6,>100
7674,handles,277,33597111,96.7952430266,_100,7,>100
7675,pleasantly,277,33597388,96.7960410799,_100,10,>100
7676,informative,277,33597665,96.7968391331,_100,11,>100
7677,flags,277,33597942,96.7976371863,_100,5,>100
7678,brooks,277,33598219,96.7984352395,_100,6,>100
7679,olympics,277,33598496,96.7992332927,_100,8,>100
7680,sinister,277,33598773,96.8000313459,_100,8,>100
7681,cycles,277,33599050,96.8008293991,_100,6,>100
7682,flames,277,33599327,96.8016274523,_100,6,>100
7683,stumble,277,33599604,96.8024255056,_100,7,>100
7684,norwegian,277,33599881,96.8032235588,_100,9,>100
7685,chilled,277,33600158,96.804021612,_100,7,>100
7686,signals,277,33600435,96.8048196652,_100,7,>100
7687,rescued,277,33600712,96.8056177184,_100,7,>100
7688,bicycle,276,33600988,96.8064128905,_100,7,>100
7689,daring,276,33601264,96.8072080627,_100,6,>100
7690,lavender,276,33601540,96.8080032349,_100,8,>100
7691,paintball,276,33601816,96.808798407,_100,9,>100
7692,blows,276,33602092,96.8095935792,_100,5,>100
7693,mashed,276,33602368,96.8103887513,_100,6,>100
7694,oops,276,33602644,96.8111839235,_100,4,>100
7695,spoil,276,33602920,96.8119790956,_100,5,>100
7696,triangle,276,33603196,96.8127742678,_100,8,>100
7697,newsletter,276,33603472,96.8135694399,_100,10,>100
7698,bail,276,33603748,96.8143646121,_100,4,>100
7699,exterior,276,33604024,96.8151597842,_100,8,>100
7700,cambridge,276,33604300,96.8159549564,_100,9,>100
7701,confront,276,33604576,96.8167501285,_100,8,>100
7702,mushroom,276,33604852,96.8175453007,_100,8,>100
7703,chapel,275,33605127,96.8183375918,_100,6,>100
7704,airline,275,33605402,96.8191298829,_100,7,>100
7705,neatly,275,33605677,96.819922174,_100,6,>100
7706,brushed,275,33605952,96.8207144651,_100,7,>100
7707,momma,275,33606227,96.8215067562,_100,5,>100
7708,absorb,275,33606502,96.8222990472,_100,6,>100
7709,gesture,275,33606777,96.8230913383,_100,7,>100
7710,hudson,275,33607052,96.8238836294,_100,6,>100
7711,reminiscent,275,33607327,96.8246759205,_100,11,>100
7712,booze,275,33607602,96.8254682116,_100,5,>100
7713,ruby,275,33607877,96.8262605027,_100,4,>100
7714,formerly,275,33608152,96.8270527938,_100,8,>100
7715,builds,275,33608427,96.8278450849,_100,6,>100
7716,cab,275,33608702,96.828637376,_100,3,>100
7717,tattoo,275,33608977,96.8294296671,_100,6,>100
7718,marc,275,33609252,96.8302219582,_100,4,>100
7719,melbourne,275,33609527,96.8310142493,_100,9,>100
7720,conditioning,275,33609802,96.8318065404,_100,12,>100
7721,merit,275,33610077,96.8325988315,_100,5,>100
7722,posed,275,33610352,96.8333911226,_100,5,>100
7723,employ,275,33610627,96.8341834137,_100,6,>100
7724,leaned,275,33610902,96.8349757048,_100,6,>100
7725,ridge,274,33611176,96.8357651148,_100,5,>100
7726,seldom,274,33611450,96.8365545248,_100,6,>100
7727,tourism,274,33611724,96.8373439349,_100,7,>100
7728,chalk,274,33611998,96.8381333449,_100,5,>100
7729,interpret,274,33612272,96.8389227549,_100,9,>100
7730,ep,274,33612546,96.839712165,_100,2,>100
7731,confronted,274,33612820,96.840501575,_100,10,>100
7732,fraction,274,33613094,96.841290985,_100,8,>100
7733,dylan,274,33613368,96.8420803951,_100,5,>100
7734,yup,274,33613642,96.8428698051,_100,3,>100
7735,conversion,274,33613916,96.8436592151,_100,10,>100
7736,successes,274,33614190,96.8444486252,_100,9,>100
7737,weed,274,33614464,96.8452380352,_100,4,>100
7738,crashed,274,33614738,96.8460274453,_100,7,>100
7739,walmart,274,33615012,96.8468168553,_100,7,>100
7740,congressional,274,33615286,96.8476062653,_100,13,>100
7741,accomplishment,274,33615560,96.8483956754,_100,14,>100
7742,overhead,274,33615834,96.8491850854,_100,8,>100
7743,deposit,274,33616108,96.8499744954,_100,7,>100
7744,dances,273,33616381,96.8507610244,_100,6,>100
7745,obedience,273,33616654,96.8515475534,_100,9,>100
7746,greeting,273,33616927,96.8523340824,_100,8,>100
7747,doomed,273,33617200,96.8531206113,_100,6,>100
7748,disc,273,33617473,96.8539071403,_100,4,>100
7749,insanity,273,33617746,96.8546936693,_100,8,>100
7750,sparkly,273,33618019,96.8554801983,_100,7,>100
7751,bushes,273,33618292,96.8562667272,_100,6,>100
7752,insult,273,33618565,96.8570532562,_100,6,>100
7753,textures,273,33618838,96.8578397852,_100,8,>100
7754,defining,273,33619111,96.8586263142,_100,8,>100
7755,holmes,273,33619384,96.8594128432,_100,6,>100
7756,distraction,273,33619657,96.8601993721,_100,11,>100
7757,bombs,272,33619929,96.86098302,_100,5,>100
7758,slim,272,33620201,96.861766668,_100,4,>100
7759,boom,272,33620473,96.8625503159,_100,4,>100
7760,shipped,272,33620745,96.8633339638,_100,7,>100
7761,administrative,272,33621017,96.8641176117,_100,14,>100
7762,tummy,272,33621289,96.8649012596,_100,5,>100
7763,evans,272,33621561,96.8656849076,_100,5,>100
7764,mouths,272,33621833,96.8664685555,_100,6,>100
7765,slap,272,33622105,96.8672522034,_100,4,>100
7766,praised,272,33622377,96.8680358513,_100,7,>100
7767,sooo,272,33622649,96.8688194992,_100,4,>100
7768,combinations,272,33622921,96.8696031472,_100,12,>100
7769,daunting,272,33623193,96.8703867951,_100,8,>100
7770,violation,272,33623465,96.871170443,_100,9,>100
7771,mistaken,272,33623737,96.8719540909,_100,8,>100
7772,sermon,272,33624009,96.8727377388,_100,6,>100
7773,taco,272,33624281,96.8735213867,_100,4,>100
7774,attributes,272,33624553,96.8743050347,_100,10,>100
7775,mortal,272,33624825,96.8750886826,_100,6,>100
7776,immigrant,272,33625097,96.8758723305,_100,9,>100
7777,approve,272,33625369,96.8766559784,_100,7,>100
7778,cheat,272,33625641,96.8774396263,_100,5,>100
7779,upgrade,271,33625912,96.8782203932,_100,7,>100
7780,peer,271,33626183,96.8790011601,_100,4,>100
7781,philosophical,271,33626454,96.8797819269,_100,13,>100
7782,barriers,271,33626725,96.8805626938,_100,8,>100
7783,recycling,271,33626996,96.8813434606,_100,9,>100
7784,joys,271,33627267,96.8821242275,_100,4,>100
7785,elvis,271,33627538,96.8829049944,_100,5,>100
7786,acrylic,271,33627809,96.8836857612,_100,7,>100
7787,sushi,271,33628080,96.8844665281,_100,5,>100
7788,cubes,271,33628351,96.8852472949,_100,5,>100
7789,pill,271,33628622,96.8860280618,_100,4,>100
7790,heavier,271,33628893,96.8868088287,_100,7,>100
7791,malaysian,271,33629164,96.8875895955,_100,9,>100
7792,flexibility,271,33629435,96.8883703624,_100,11,>100
7793,wildly,271,33629706,96.8891511292,_100,6,>100
7794,pleasures,270,33629976,96.889929015,_100,9,>100
7795,fixing,270,33630246,96.8907069008,_100,6,>100
7796,outlook,270,33630516,96.8914847866,_100,7,>100
7797,hostile,270,33630786,96.8922626724,_100,7,>100
7798,transparent,270,33631056,96.8930405582,_100,11,>100
7799,vessels,270,33631326,96.893818444,_100,7,>100
7800,females,270,33631596,96.8945963298,_100,7,>100
7801,planes,270,33631866,96.8953742156,_100,6,>100
7802,giveaways,270,33632136,96.8961521015,_100,9,>100
7803,shield,270,33632406,96.8969299873,_100,6,>100
7804,statue,270,33632676,96.8977078731,_100,6,>100
7805,catholics,270,33632946,96.8984857589,_100,9,>100
7806,decrease,270,33633216,96.8992636447,_100,8,>100
7807,aboard,270,33633486,96.9000415305,_100,6,>100
7808,transaction,270,33633756,96.9008194163,_100,11,>100
7809,divorced,270,33634026,96.9015973021,_100,8,>100
7810,perfume,270,33634296,96.9023751879,_100,7,>100
7811,embracing,270,33634566,96.9031530737,_100,9,>100
7812,nbc,270,33634836,96.9039309595,_100,3,>100
7813,dwell,269,33635105,96.9047059642,_100,5,>100
7814,seller,269,33635374,96.905480969,_100,6,>100
7815,liz,269,33635643,96.9062559737,_100,3,>100
7816,randy,269,33635912,96.9070309784,_100,5,>100
7817,sympathetic,269,33636181,96.9078059832,_100,11,>100
7818,circular,269,33636450,96.9085809879,_100,8,>100
7819,solving,269,33636719,96.9093559927,_100,7,>100
7820,auto,269,33636988,96.9101309974,_100,4,>100
7821,demonstrates,269,33637257,96.9109060022,_100,12,>100
7822,peculiar,269,33637526,96.9116810069,_100,8,>100
7823,bridges,269,33637795,96.9124560116,_100,7,>100
7824,maryland,269,33638064,96.9132310164,_100,8,>100
7825,prima,269,33638333,96.9140060211,_100,5,>100
7826,trademark,269,33638602,96.9147810259,_100,9,>100
7827,performers,269,33638871,96.9155560306,_100,10,>100
7828,flakes,269,33639140,96.9163310354,_100,6,>100
7829,gum,269,33639409,96.9171060401,_100,3,>100
7830,commercials,269,33639678,96.9178810448,_100,11,>100
7831,oppression,269,33639947,96.9186560496,_100,10,>100
7832,gossip,269,33640216,96.9194310543,_100,6,>100
7833,grounded,269,33640485,96.9202060591,_100,8,>100
7834,humorous,269,33640754,96.9209810638,_100,8,>100
7835,diana,268,33641022,96.9217531875,_100,5,>100
7836,considers,268,33641290,96.9225253112,_100,9,>100
7837,limbs,268,33641558,96.9232974349,_100,5,>100
7838,estimate,268,33641826,96.9240695585,_100,8,>100
7839,oats,268,33642094,96.9248416822,_100,4,>100
7840,colin,268,33642362,96.9256138059,_100,5,>100
7841,secured,268,33642630,96.9263859296,_100,7,>100
7842,masculine,268,33642898,96.9271580533,_100,9,>100
7843,provisions,268,33643166,96.927930177,_100,10,>100
7844,observing,268,33643434,96.9287023007,_100,9,>100
7845,planets,268,33643702,96.9294744243,_100,7,>100
7846,fist,268,33643970,96.930246548,_100,4,>100
7847,bully,268,33644238,96.9310186717,_100,5,>100
7848,tribal,268,33644506,96.9317907954,_100,6,>100
7849,homeschooling,268,33644774,96.9325629191,_100,13,>100
7850,inherited,268,33645042,96.9333350428,_100,9,>100
7851,discomfort,268,33645310,96.9341071664,_100,10,>100
7852,nicholas,268,33645578,96.9348792901,_100,8,>100
7853,roommate,268,33645846,96.9356514138,_100,8,>100
7854,lush,268,33646114,96.9364235375,_100,4,>100
7855,accuracy,268,33646382,96.9371956612,_100,8,>100
7856,considerably,268,33646650,96.9379677849,_100,12,>100
7857,sprayed,268,33646918,96.9387399086,_100,7,>100
7858,foremost,267,33647185,96.9395091512,_100,8,>100
7859,drawers,267,33647452,96.9402783938,_100,7,>100
7860,tidy,267,33647719,96.9410476364,_100,4,>100
7861,hurricane,267,33647986,96.9418168791,_100,9,>100
7862,bells,267,33648253,96.9425861217,_100,5,>100
7863,maya,267,33648520,96.9433553643,_100,4,>100
7864,hopeless,267,33648787,96.9441246069,_100,8,>100
7865,gosh,267,33649054,96.9448938496,_100,4,>100
7866,sci,267,33649321,96.9456630922,_100,3,>100
7867,weave,267,33649588,96.9464323348,_100,5,>100
7868,develops,267,33649855,96.9472015774,_100,8,>100
7869,integrated,267,33650122,96.9479708201,_100,10,>100
7870,podcast,266,33650388,96.9487371816,_100,7,>100
7871,admits,266,33650654,96.9495035432,_100,6,>100
7872,finishes,266,33650920,96.9502699048,_100,8,>100
7873,comfortably,266,33651186,96.9510362663,_100,11,>100
7874,democrat,266,33651452,96.9518026279,_100,8,>100
7875,lions,266,33651718,96.9525689895,_100,5,>100
7876,inhabitants,266,33651984,96.953335351,_100,11,>100
7877,suspension,266,33652250,96.9541017126,_100,10,>100
7878,sundays,266,33652516,96.9548680742,_100,7,>100
7879,measurements,266,33652782,96.9556344357,_100,12,>100
7880,dread,266,33653048,96.9564007973,_100,5,>100
7881,chloe,266,33653314,96.9571671589,_100,5,>100
7882,cleansing,266,33653580,96.9579335204,_100,9,>100
7883,umbrella,266,33653846,96.958699882,_100,8,>100
7884,taliban,266,33654112,96.9594662436,_100,7,>100
7885,halt,266,33654378,96.9602326051,_100,4,>100
7886,raid,266,33654644,96.9609989667,_100,4,>100
7887,sixteen,266,33654910,96.9617653283,_100,7,>100
7888,bland,266,33655176,96.9625316898,_100,5,>100
7889,outrageous,266,33655442,96.9632980514,_100,10,>100
7890,wagon,266,33655708,96.964064413,_100,5,>100
7891,gaps,266,33655974,96.9648307745,_100,4,>100
7892,noir,266,33656240,96.9655971361,_100,4,>100
7893,akin,266,33656506,96.9663634977,_100,4,>100
7894,pies,265,33656771,96.9671269782,_100,4,>100
7895,redemption,265,33657036,96.9678904587,_100,10,>100
7896,netherlands,265,33657301,96.9686539392,_100,11,>100
7897,scoring,265,33657566,96.9694174197,_100,7,>100
7898,coated,265,33657831,96.9701809002,_100,6,>100
7899,mythology,265,33658096,96.9709443807,_100,9,>100
7900,spiral,265,33658361,96.9717078612,_100,6,>100
7901,moody,265,33658626,96.9724713418,_100,5,>100
7902,balloon,265,33658891,96.9732348223,_100,7,>100
7903,separately,265,33659156,96.9739983028,_100,10,>100
7904,enhanced,265,33659421,96.9747617833,_100,8,>100
7905,aired,264,33659685,96.9755223827,_100,5,>100
7906,veggie,264,33659949,96.9762829822,_100,6,>100
7907,mason,264,33660213,96.9770435816,_100,5,>100
7908,generic,264,33660477,96.9778041811,_100,7,>100
7909,damaging,264,33660741,96.9785647805,_100,8,>100
7910,crave,264,33661005,96.97932538,_100,5,>100
7911,thompson,264,33661269,96.9800859794,_100,8,>100
7912,consequently,264,33661533,96.9808465789,_100,12,>100
7913,abusive,264,33661797,96.9816071783,_100,7,>100
7914,les,264,33662061,96.9823677778,_100,3,>100
7915,tens,264,33662325,96.9831283772,_100,4,>100
7916,bra,264,33662589,96.9838889767,_100,3,>100
7917,exceptions,264,33662853,96.9846495761,_100,10,>100
7918,dreaded,264,33663117,96.9854101756,_100,7,>100
7919,loosely,264,33663381,96.986170775,_100,7,>100
7920,harvard,264,33663645,96.9869313745,_100,7,>100
7921,maggie,263,33663908,96.9876890929,_100,6,>100
7922,grants,263,33664171,96.9884468113,_100,6,>100
7923,gps,263,33664434,96.9892045297,_100,3,>100
7924,withstand,263,33664697,96.989962248,_100,9,>100
7925,restricted,263,33664960,96.9907199664,_100,10,>100
7926,paints,263,33665223,96.9914776848,_100,6,>100
7927,madrid,263,33665486,96.9922354032,_100,6,>100
7928,kathy,263,33665749,96.9929931216,_100,5,>100
7929,locate,263,33666012,96.99375084,_100,6,>100
7930,cupboard,263,33666275,96.9945085584,_100,8,>100
7931,critic,263,33666538,96.9952662768,_100,6,>100
7932,concentrated,263,33666801,96.9960239952,_100,12,>100
7933,cancel,263,33667064,96.9967817136,_100,6,>100
7934,comprehend,263,33667327,96.997539432,_100,10,>100
7935,thesis,263,33667590,96.9982971504,_100,6,>100
7936,foreigners,263,33667853,96.9990548688,_100,10,>100
7937,wakes,263,33668116,96.9998125871,_100,5,>100
7938,expects,263,33668379,97.0005703055,_100,7,>100
7939,unlimited,263,33668642,97.0013280239,_100,9,>100
7940,vertical,263,33668905,97.0020857423,_100,8,>100
7941,recipient,263,33669168,97.0028434607,_100,9,>100
7942,mandatory,263,33669431,97.0036011791,_100,9,>100
7943,sane,263,33669694,97.0043588975,_100,4,>100
7944,pigs,262,33669956,97.0051137348,_100,4,>100
7945,bacteria,262,33670218,97.0058685722,_100,8,>100
7946,seth,262,33670480,97.0066234095,_100,4,>100
7947,maine,262,33670742,97.0073782468,_100,5,>100
7948,plots,262,33671004,97.0081330842,_100,5,>100
7949,refuge,262,33671266,97.0088879215,_100,6,>100
7950,reforms,262,33671528,97.0096427588,_100,7,>100
7951,vodka,262,33671790,97.0103975962,_100,5,>100
7952,instructed,262,33672052,97.0111524335,_100,10,>100
7953,holders,262,33672314,97.0119072708,_100,7,>100
7954,lp,262,33672576,97.0126621082,_100,2,>100
7955,trillion,262,33672838,97.0134169455,_100,8,>100
7956,ambition,262,33673100,97.0141717828,_100,8,>100
7957,charging,261,33673361,97.0149237391,_100,8,>100
7958,optional,261,33673622,97.0156756954,_100,8,>100
7959,museums,261,33673883,97.0164276517,_100,7,>100
7960,mt,261,33674144,97.0171796079,_100,2,>100
7961,characteristic,261,33674405,97.0179315642,_100,14,>100
7962,lenses,261,33674666,97.0186835205,_100,6,>100
7963,clearer,261,33674927,97.0194354767,_100,7,>100
7964,prescription,261,33675188,97.020187433,_100,12,>100
7965,identifying,261,33675449,97.0209393893,_100,11,>100
7966,hybrid,261,33675710,97.0216913456,_100,6,>100
7967,sprinkled,261,33675971,97.0224433018,_100,9,>100
7968,tweets,261,33676232,97.0231952581,_100,6,>100
7969,daisy,261,33676493,97.0239472144,_100,5,>100
7970,sweeping,261,33676754,97.0246991707,_100,8,>100
7971,concerts,261,33677015,97.0254511269,_100,8,>100
7972,tortured,261,33677276,97.0262030832,_100,8,>100
7973,recycled,261,33677537,97.0269550395,_100,8,>100
7974,occurring,261,33677798,97.0277069958,_100,9,>100
7975,generosity,261,33678059,97.028458952,_100,10,>100
7976,advances,260,33678319,97.0292080273,_100,8,>100
7977,loneliness,260,33678579,97.0299571025,_100,10,>100
7978,stray,260,33678839,97.0307061777,_100,5,>100
7979,oct,260,33679099,97.0314552529,_100,3,>100
7980,intentionally,260,33679359,97.0322043281,_100,13,>100
7981,unwanted,260,33679619,97.0329534033,_100,8,>100
7982,argentina,260,33679879,97.0337024786,_100,9,>100
7983,tab,260,33680139,97.0344515538,_100,3,>100
7984,cynical,260,33680399,97.035200629,_100,7,>100
7985,justification,260,33680659,97.0359497042,_100,13,>100
7986,instrumental,260,33680919,97.0366987794,_100,12,>100
7987,forbidden,260,33681179,97.0374478546,_100,9,>100
7988,ponder,260,33681439,97.0381969299,_100,6,>100
7989,stuffing,260,33681699,97.0389460051,_100,8,>100
7990,tights,260,33681959,97.0396950803,_100,6,>100
7991,rebellion,260,33682219,97.0404441555,_100,9,>100
7992,backpack,260,33682479,97.0411932307,_100,8,>100
7993,dragging,260,33682739,97.0419423059,_100,8,>100
7994,bundle,260,33682999,97.0426913812,_100,6,>100
7995,sock,259,33683258,97.0434375753,_100,4,>100
7996,sleeps,259,33683517,97.0441837695,_100,6,>100
7997,thor,259,33683776,97.0449299636,_100,4,>100
7998,owen,259,33684035,97.0456761578,_100,4,>100
7999,motorcycle,259,33684294,97.0464223519,_100,10,>100
8000,licensed,259,33684553,97.0471685461,_100,8,>100
8001,tangible,259,33684812,97.0479147403,_100,8,>100
8002,derived,259,33685071,97.0486609344,_100,7,>100
8003,organs,259,33685330,97.0494071286,_100,6,>100
8004,dresser,259,33685589,97.0501533227,_100,7,>100
8005,wreck,259,33685848,97.0508995169,_100,5,>100
8006,girly,259,33686107,97.051645711,_100,5,>100
8007,sleepy,259,33686366,97.0523919052,_100,6,>100
8008,combining,259,33686625,97.0531380994,_100,9,>100
8009,supplied,259,33686884,97.0538842935,_100,8,>100
8010,treasury,259,33687143,97.0546304877,_100,8,>100
8011,morris,259,33687402,97.0553766818,_100,6,>100
8012,responds,259,33687661,97.056122876,_100,8,>100
8013,productivity,259,33687920,97.0568690702,_100,12,>100
8014,diane,259,33688179,97.0576152643,_100,5,>100
8015,spencer,259,33688438,97.0583614585,_100,7,>100
8016,joyful,258,33688696,97.0591047716,_100,6,>100
8017,handing,258,33688954,97.0598480847,_100,7,>100
8018,seventh,258,33689212,97.0605913978,_100,7,>100
8019,launching,258,33689470,97.0613347109,_100,9,>100
8020,neighborhoods,258,33689728,97.062078024,_100,13,>100
8021,spill,258,33689986,97.0628213371,_100,5,>100
8022,juan,258,33690244,97.0635646502,_100,4,>100
8023,clicked,258,33690502,97.0643079633,_100,7,>100
8024,terminal,258,33690760,97.0650512764,_100,8,>100
8025,cheering,258,33691018,97.0657945895,_100,8,>100
8026,karl,258,33691276,97.0665379026,_100,4,>100
8027,skull,258,33691534,97.0672812157,_100,5,>100
8028,rested,258,33691792,97.0680245288,_100,6,>100
8029,horribly,258,33692050,97.0687678419,_100,8,>100
8030,accidents,258,33692308,97.069511155,_100,9,>100
8031,soaking,258,33692566,97.0702544681,_100,7,>100
8032,visitor,258,33692824,97.0709977812,_100,7,>100
8033,holland,258,33693082,97.0717410943,_100,7,>100
8034,closure,258,33693340,97.0724844074,_100,7,>100
8035,reunion,258,33693598,97.0732277205,_100,7,>100
8036,perspectives,258,33693856,97.0739710335,_100,12,>100
8037,impatient,257,33694113,97.0747114656,_100,9,>100
8038,fearful,257,33694370,97.0754518976,_100,7,>100
8039,salads,257,33694627,97.0761923297,_100,6,>100
8040,pricing,257,33694884,97.0769327617,_100,7,>100
8041,lb,257,33695141,97.0776731938,_100,2,>100
8042,forthcoming,257,33695398,97.0784136258,_100,11,>100
8043,liam,257,33695655,97.0791540578,_100,4,>100
8044,walnuts,257,33695912,97.0798944899,_100,7,>100
8045,additions,257,33696169,97.0806349219,_100,9,>100
8046,flock,257,33696426,97.081375354,_100,5,>100
8047,accompanying,257,33696683,97.082115786,_100,12,>100
8048,foul,257,33696940,97.082856218,_100,4,>100
8049,glasgow,257,33697197,97.0835966501,_100,7,>100
8050,understandable,257,33697454,97.0843370821,_100,14,>100
8051,spit,257,33697711,97.0850775142,_100,4,>100
8052,elevator,257,33697968,97.0858179462,_100,8,>100
8053,cask,257,33698225,97.0865583782,_100,4,>100
8054,gin,257,33698482,97.0872988103,_100,3,>100
8055,sponge,257,33698739,97.0880392423,_100,6,>100
8056,softened,257,33698996,97.0887796744,_100,8,>100
8057,psychic,256,33699252,97.0895172253,_100,7,>100
8058,palin,256,33699508,97.0902547763,_100,5,>100
8059,cognitive,256,33699764,97.0909923273,_100,9,>100
8060,cling,256,33700020,97.0917298783,_100,5,>100
8061,announcing,256,33700276,97.0924674293,_100,10,>100
8062,arguably,256,33700532,97.0932049803,_100,8,>100
8063,tearing,256,33700788,97.0939425312,_100,7,>100
8064,clarify,256,33701044,97.0946800822,_100,7,>100
8065,antonio,256,33701300,97.0954176332,_100,7,>100
8066,miniature,256,33701556,97.0961551842,_100,9,>100
8067,haiti,256,33701812,97.0968927352,_100,5,>100
8068,sony,256,33702068,97.0976302861,_100,4,>100
8069,debates,256,33702324,97.0983678371,_100,7,>100
8070,tolerate,256,33702580,97.0991053881,_100,8,>100
8071,settlement,256,33702836,97.0998429391,_100,10,>100
8072,unemployed,256,33703092,97.1005804901,_100,10,>100
8073,cilantro,256,33703348,97.1013180411,_100,8,>100
8074,hormones,256,33703604,97.102055592,_100,8,>100
8075,temporarily,256,33703860,97.102793143,_100,11,>100
8076,neighbour,256,33704116,97.103530694,_100,9,>100
8077,urgent,256,33704372,97.104268245,_100,6,>100
8078,wendy,256,33704628,97.105005796,_100,5,>100
8079,delete,256,33704884,97.105743347,_100,6,>100
8080,drummer,256,33705140,97.1064808979,_100,7,>100
8081,dipped,256,33705396,97.1072184489,_100,6,>100
8082,dentist,256,33705652,97.1079559999,_100,7,>100
8083,heroic,255,33705907,97.1086906698,_100,6,>100
8084,injustice,255,33706162,97.1094253397,_100,9,>100
8085,fled,255,33706417,97.1101600097,_100,4,>100
8086,ugh,255,33706672,97.1108946796,_100,3,>100
8087,robot,255,33706927,97.1116293495,_100,5,>100
8088,vested,255,33707182,97.1123640194,_100,6,>100
8089,poses,255,33707437,97.1130986894,_100,5,>100
8090,coupled,255,33707692,97.1138333593,_100,7,>100
8091,cloudy,255,33707947,97.1145680292,_100,6,>100
8092,possessed,255,33708202,97.1153026991,_100,9,>100
8093,plague,255,33708457,97.1160373691,_100,6,>100
8094,pools,255,33708712,97.116772039,_100,5,>100
8095,sweets,255,33708967,97.1175067089,_100,6,>100
8096,infected,255,33709222,97.1182413788,_100,8,>100
8097,pronounced,255,33709477,97.1189760488,_100,10,>100
8098,switching,255,33709732,97.1197107187,_100,9,>100
8099,weary,255,33709987,97.1204453886,_100,5,>100
8100,operated,255,33710242,97.1211800585,_100,8,>100
8101,kidney,255,33710497,97.1219147284,_100,6,>100
8102,horn,255,33710752,97.1226493984,_100,4,>100
8103,oppose,255,33711007,97.1233840683,_100,6,>100
8104,punished,255,33711262,97.1241187382,_100,8,>100
8105,distinguish,254,33711516,97.1248505271,_100,11,>100
8106,weaknesses,254,33711770,97.1255823159,_100,10,>100
8107,heel,254,33712024,97.1263141048,_100,4,>100
8108,jaw,254,33712278,97.1270458937,_100,3,>100
8109,rituals,254,33712532,97.1277776825,_100,7,>100
8110,robust,254,33712786,97.1285094714,_100,6,>100
8111,engineers,254,33713040,97.1292412603,_100,9,>100
8112,creme,254,33713294,97.1299730491,_100,5,>100
8113,construct,254,33713548,97.130704838,_100,9,>100
8114,speeches,254,33713802,97.1314366269,_100,8,>100
8115,jew,254,33714056,97.1321684157,_100,3,>100
8116,hay,254,33714310,97.1329002046,_100,3,>100
8117,smarter,254,33714564,97.1336319935,_100,7,>100
8118,biased,254,33714818,97.1343637823,_100,6,>100
8119,isaiah,254,33715072,97.1350955712,_100,6,>100
8120,mandate,254,33715326,97.1358273601,_100,7,>100
8121,traded,254,33715580,97.1365591489,_100,6,>100
8122,softly,254,33715834,97.1372909378,_100,6,>100
8123,reservations,254,33716088,97.1380227267,_100,12,>100
8124,interestingly,253,33716341,97.1387516345,_100,13,>100
8125,acquisition,253,33716594,97.1394805423,_100,11,>100
8126,beatles,253,33716847,97.1402094501,_100,7,>100
8127,misses,253,33717100,97.1409383579,_100,6,>100
8128,codes,253,33717353,97.1416672657,_100,5,>100
8129,magnetic,253,33717606,97.1423961735,_100,8,>100
8130,blush,253,33717859,97.1431250813,_100,5,>100
8131,lone,253,33718112,97.1438539891,_100,4,>100
8132,melody,253,33718365,97.1445828969,_100,6,>100
8133,hid,253,33718618,97.1453118047,_100,3,>100
8134,vincent,253,33718871,97.1460407125,_100,7,>100
8135,thrilling,253,33719124,97.1467696203,_100,9,>100
8136,folding,253,33719377,97.1474985281,_100,7,>100
8137,dominate,252,33719629,97.1482245549,_100,8,>100
8138,experimenting,252,33719881,97.1489505816,_100,13,>100
8139,winding,252,33720133,97.1496766084,_100,7,>100
8140,baltimore,252,33720385,97.1504026351,_100,9,>100
8141,oranges,252,33720637,97.1511286619,_100,7,>100
8142,fest,252,33720889,97.1518546886,_100,4,>100
8143,humility,252,33721141,97.1525807154,_100,8,>100
8144,brandon,252,33721393,97.1533067421,_100,7,>100
8145,shines,252,33721645,97.1540327689,_100,6,>100
8146,granny,252,33721897,97.1547587956,_100,6,>100
8147,slowed,252,33722149,97.1554848224,_100,6,>100
8148,bark,252,33722401,97.1562108491,_100,4,>100
8149,guitarist,252,33722653,97.1569368759,_100,9,>100
8150,cherish,252,33722905,97.1576629026,_100,7,>100
8151,wright,252,33723157,97.1583889294,_100,6,>100
8152,captures,252,33723409,97.1591149561,_100,8,>100
8153,energetic,252,33723661,97.1598409829,_100,9,>100
8154,wrath,252,33723913,97.1605670096,_100,5,>100
8155,accountability,252,33724165,97.1612930364,_100,14,>100
8156,fragrance,252,33724417,97.1620190631,_100,9,>100
8157,stroll,251,33724668,97.1627422088,_100,6,>100
8158,mining,251,33724919,97.1634653545,_100,6,>100
8159,airplane,251,33725170,97.1641885002,_100,8,>100
8160,anyhow,251,33725421,97.1649116459,_100,6,>100
8161,pours,251,33725672,97.1656347915,_100,5,>100
8162,rel,251,33725923,97.1663579372,_100,3,>100
8163,cider,251,33726174,97.1670810829,_100,5,>100
8164,cooker,251,33726425,97.1678042286,_100,6,>100
8165,advocates,251,33726676,97.1685273743,_100,9,>100
8166,rum,251,33726927,97.16925052,_100,3,>100
8167,louder,251,33727178,97.1699736657,_100,6,>100
8168,thighs,251,33727429,97.1706968114,_100,6,>100
8169,establishing,251,33727680,97.1714199571,_100,12,>100
8170,feeds,251,33727931,97.1721431028,_100,5,>100
8171,rendered,251,33728182,97.1728662484,_100,8,>100
8172,prejudice,251,33728433,97.1735893941,_100,9,>100
8173,starving,251,33728684,97.1743125398,_100,8,>100
8174,amsterdam,251,33728935,97.1750356855,_100,9,>100
8175,historian,251,33729186,97.1757588312,_100,9,>100
8176,amidst,250,33729436,97.1764790958,_100,6,>100
8177,greatness,250,33729686,97.1771993605,_100,9,>100
8178,doorway,250,33729936,97.1779196251,_100,7,>100
8179,250,250,33730186,97.1786398897,_100,3,>100
8180,carlos,250,33730436,97.1793601544,_100,6,>100
8181,hebrew,250,33730686,97.180080419,_100,6,>100
8182,brews,250,33730936,97.1808006836,_100,5,>100
8183,sciences,250,33731186,97.1815209482,_100,8,>100
8184,biography,250,33731436,97.1822412129,_100,9,>100
8185,memento,250,33731686,97.1829614775,_100,7,>100
8186,girlfriends,250,33731936,97.1836817421,_100,11,>100
8187,nostalgia,250,33732186,97.1844020068,_100,9,>100
8188,liner,250,33732436,97.1851222714,_100,5,>100
8189,paragraphs,249,33732685,97.185839655,_100,10,>100
8190,jose,249,33732934,97.1865570385,_100,4,>100
8191,lawsuit,249,33733183,97.1872744221,_100,7,>100
8192,professors,249,33733432,97.1879918057,_100,10,>100
8193,silhouette,249,33733681,97.1887091893,_100,10,>100
8194,catalog,249,33733930,97.1894265728,_100,7,>100
8195,marcus,249,33734179,97.1901439564,_100,6,>100
8196,raisins,249,33734428,97.19086134,_100,7,>100
8197,sec,249,33734677,97.1915787236,_100,3,>100
8198,chilli,249,33734926,97.1922961071,_100,6,>100
8199,blooming,249,33735175,97.1930134907,_100,8,>100
8200,spontaneous,249,33735424,97.1937308743,_100,11,>100
8201,battling,249,33735673,97.1944482578,_100,8,>100
8202,anthology,249,33735922,97.1951656414,_100,9,>100
8203,rulers,249,33736171,97.195883025,_100,6,>100
8204,queue,249,33736420,97.1966004086,_100,5,>100
8205,renowned,248,33736668,97.1973149111,_100,8,>100
8206,missions,248,33736916,97.1980294136,_100,8,>100
8207,hangs,248,33737164,97.1987439161,_100,5,>100
8208,platforms,248,33737412,97.1994584186,_100,9,>100
8209,daylight,248,33737660,97.2001729211,_100,8,>100
8210,tribes,248,33737908,97.2008874236,_100,6,>100
8211,definitions,248,33738156,97.2016019262,_100,11,>100
8212,endured,248,33738404,97.2023164287,_100,7,>100
8213,ministers,248,33738652,97.2030309312,_100,9,>100
8214,satellite,248,33738900,97.2037454337,_100,9,>100
8215,rat,248,33739148,97.2044599362,_100,3,>100
8216,powell,248,33739396,97.2051744387,_100,6,>100
8217,energies,248,33739644,97.2058889412,_100,8,>100
8218,specialty,248,33739892,97.2066034438,_100,9,>100
8219,stew,248,33740140,97.2073179463,_100,4,>100
8220,smelling,248,33740388,97.2080324488,_100,8,>100
8221,recap,247,33740635,97.2087440702,_100,5,>100
8222,bouncing,247,33740882,97.2094556917,_100,8,>100
8223,notorious,247,33741129,97.2101673132,_100,9,>100
8224,contempt,247,33741376,97.2108789346,_100,8,>100
8225,meter,247,33741623,97.2115905561,_100,5,>100
8226,consent,247,33741870,97.2123021775,_100,7,>100
8227,sparks,247,33742117,97.213013799,_100,6,>100
8228,rented,247,33742364,97.2137254204,_100,6,>100
8229,rats,247,33742611,97.2144370419,_100,4,>100
8230,equation,247,33742858,97.2151486633,_100,8,>100
8231,immensely,247,33743105,97.2158602848,_100,9,>100
8232,murray,247,33743352,97.2165719063,_100,6,>100
8233,colourful,247,33743599,97.2172835277,_100,9,>100
8234,defines,247,33743846,97.2179951492,_100,7,>100
8235,demo,247,33744093,97.2187067706,_100,4,>100
8236,eagerly,247,33744340,97.2194183921,_100,7,>100
8237,remainder,247,33744587,97.2201300135,_100,9,>100
8238,beverage,247,33744834,97.220841635,_100,8,>100
8239,judicial,247,33745081,97.2215532564,_100,8,>100
8240,slipping,247,33745328,97.2222648779,_100,8,>100
8241,evolve,247,33745575,97.2229764993,_100,6,>100
8242,grind,247,33745822,97.2236881208,_100,5,>100
8243,workouts,247,33746069,97.2243997423,_100,8,>100
8244,threaten,247,33746316,97.2251113637,_100,8,>100
8245,prisoner,246,33746562,97.2258201041,_100,8,>100
8246,cutest,246,33746808,97.2265288445,_100,6,>100
8247,aftermath,246,33747054,97.2272375849,_100,9,>100
8248,streaming,246,33747300,97.2279463253,_100,9,>100
8249,marx,246,33747546,97.2286550657,_100,4,>100
8250,glee,246,33747792,97.2293638061,_100,4,>100
8251,muddy,246,33748038,97.2300725465,_100,5,>100
8252,dryer,246,33748284,97.2307812869,_100,5,>100
8253,thorough,246,33748530,97.2314900273,_100,8,>100
8254,keg,246,33748776,97.2321987677,_100,3,>100
8255,providers,246,33749022,97.2329075081,_100,9,>100
8256,brunch,246,33749268,97.2336162485,_100,6,>100
8257,whining,246,33749514,97.2343249889,_100,7,>100
8258,scouts,246,33749760,97.2350337293,_100,6,>100
8259,th,246,33750006,97.2357424697,_100,2,>100
8260,vol,246,33750252,97.2364512101,_100,3,>100
8261,caution,246,33750498,97.2371599505,_100,7,>100
8262,orientation,246,33750744,97.2378686909,_100,11,>100
8263,atop,246,33750990,97.2385774313,_100,4,>100
8264,routes,246,33751236,97.2392861717,_100,6,>100
8265,altar,246,33751482,97.2399949121,_100,5,>100
8266,bn,246,33751728,97.2407036524,_100,2,>100
8267,spatula,246,33751974,97.2414123928,_100,7,>100
8268,warren,246,33752220,97.2421211332,_100,6,>100
8269,descent,246,33752466,97.2428298736,_100,7,>100
8270,spirituality,245,33752711,97.243535733,_100,12,>100
8271,cnn,245,33752956,97.2442415923,_100,3,>100
8272,fragrant,245,33753201,97.2449474517,_100,8,>100
8273,goose,245,33753446,97.245653311,_100,5,>100
8274,intricate,245,33753691,97.2463591703,_100,9,>100
8275,evaluation,245,33753936,97.2470650297,_100,10,>100
8276,pushes,245,33754181,97.247770889,_100,6,>100
8277,med,245,33754426,97.2484767483,_100,3,>100
8278,royalty,245,33754671,97.2491826077,_100,7,>100
8279,crunch,245,33754916,97.249888467,_100,6,>100
8280,sail,245,33755161,97.2505943264,_100,4,>100
8281,indoors,245,33755406,97.2513001857,_100,7,>100
8282,headquarters,245,33755651,97.252006045,_100,12,>100
8283,starters,245,33755896,97.2527119044,_100,8,>100
8284,fountain,244,33756140,97.2534148827,_100,8,>100
8285,unclear,244,33756384,97.2541178609,_100,7,>100
8286,subjected,244,33756628,97.2548208392,_100,9,>100
8287,rubbed,244,33756872,97.2555238175,_100,6,>100
8288,shannon,244,33757116,97.2562267958,_100,7,>100
8289,irrational,244,33757360,97.2569297741,_100,10,>100
8290,colleges,244,33757604,97.2576327523,_100,8,>100
8291,sailing,244,33757848,97.2583357306,_100,7,>100
8292,excerpt,244,33758092,97.2590387089,_100,7,>100
8293,incentive,244,33758336,97.2597416872,_100,9,>100
8294,directing,244,33758580,97.2604446655,_100,9,>100
8295,guitars,244,33758824,97.2611476437,_100,7,>100
8296,gracious,244,33759068,97.261850622,_100,8,>100
8297,greet,244,33759312,97.2625536003,_100,5,>100
8298,legislative,244,33759556,97.2632565786,_100,11,>100
8299,similarities,244,33759800,97.2639595569,_100,12,>100
8300,seating,244,33760044,97.2646625351,_100,7,>100
8301,cooks,244,33760288,97.2653655134,_100,5,>100
8302,adhere,243,33760531,97.2660656106,_100,6,>100
8303,irritating,243,33760774,97.2667657079,_100,10,>100
8304,questionable,243,33761017,97.2674658051,_100,12,>100
8305,accomplishments,243,33761260,97.2681659023,_100,15,>100
8306,intimidating,243,33761503,97.2688659995,_100,12,>100
8307,duo,243,33761746,97.2695660967,_100,3,>100
8308,windy,243,33761989,97.270266194,_100,5,>100
8309,christine,243,33762232,97.2709662912,_100,9,>100
8310,piled,243,33762475,97.2716663884,_100,5,>100
8311,petals,243,33762718,97.2723664856,_100,6,>100
8312,blur,243,33762961,97.2730665828,_100,4,>100
8313,itunes,243,33763204,97.2737666801,_100,6,>100
8314,preferences,243,33763447,97.2744667773,_100,11,>100
8315,pea,243,33763690,97.2751668745,_100,3,>100
8316,superhero,243,33763933,97.2758669717,_100,9,>100
8317,treadmill,243,33764176,97.276567069,_100,9,>100
8318,recalled,243,33764419,97.2772671662,_100,8,>100
8319,credibility,243,33764662,97.2779672634,_100,11,>100
8320,blueberries,243,33764905,97.2786673606,_100,11,>100
8321,balcony,243,33765148,97.2793674578,_100,7,>100
8322,beard,242,33765390,97.280064674,_100,5,>100
8323,rains,242,33765632,97.2807618902,_100,5,>100
8324,belonging,242,33765874,97.2814591063,_100,9,>100
8325,problematic,242,33766116,97.2821563225,_100,11,>100
8326,deleted,242,33766358,97.2828535387,_100,7,>100
8327,petty,242,33766600,97.2835507548,_100,5,>100
8328,bulb,242,33766842,97.284247971,_100,4,>100
8329,manufacturer,242,33767084,97.2849451871,_100,12,>100
8330,harvey,242,33767326,97.2856424033,_100,6,>100
8331,tiles,242,33767568,97.2863396195,_100,5,>100
8332,commonwealth,242,33767810,97.2870368356,_100,12,>100
8333,consulting,242,33768052,97.2877340518,_100,10,>100
8334,situated,242,33768294,97.288431268,_100,8,>100
8335,touring,242,33768536,97.2891284841,_100,7,>100
8336,brownies,242,33768778,97.2898257003,_100,8,>100
8337,isaac,242,33769020,97.2905229164,_100,5,>100
8338,communism,242,33769262,97.2912201326,_100,9,>100
8339,louise,242,33769504,97.2919173488,_100,6,>100
8340,symbolic,241,33769745,97.2926116839,_100,8,>100
8341,owning,241,33769986,97.293306019,_100,6,>100
8342,venus,241,33770227,97.2940003541,_100,5,>100
8343,peaks,241,33770468,97.2946946892,_100,5,>100
8344,eli,241,33770709,97.2953890243,_100,3,>100
8345,hulk,241,33770950,97.2960833594,_100,4,>100
8346,frog,241,33771191,97.2967776945,_100,4,>100
8347,generously,241,33771432,97.2974720296,_100,10,>100
8348,adventurous,241,33771673,97.2981663647,_100,11,>100
8349,timeless,241,33771914,97.2988606998,_100,8,>100
8350,bosses,241,33772155,97.2995550349,_100,6,>100
8351,hardcore,241,33772396,97.30024937,_100,8,>100
8352,identification,241,33772637,97.3009437051,_100,14,>100
8353,furious,241,33772878,97.3016380402,_100,7,>100
8354,warnings,241,33773119,97.3023323753,_100,8,>100
8355,singers,241,33773360,97.3030267104,_100,7,>100
8356,athletic,241,33773601,97.3037210455,_100,8,>100
8357,balloons,241,33773842,97.3044153806,_100,8,>100
8358,diving,241,33774083,97.3051097158,_100,6,>100
8359,nook,241,33774324,97.3058040509,_100,4,>100
8360,attic,241,33774565,97.306498386,_100,5,>100
8361,ballot,241,33774806,97.3071927211,_100,6,>100
8362,sinking,241,33775047,97.3078870562,_100,7,>100
8363,thirteen,241,33775288,97.3085813913,_100,8,>100
8364,helpless,241,33775529,97.3092757264,_100,8,>100
8365,linky,241,33775770,97.3099700615,_100,5,>100
8366,gentlemen,241,33776011,97.3106643966,_100,9,>100
8367,speculation,241,33776252,97.3113587317,_100,11,>100
8368,breathtaking,241,33776493,97.3120530668,_100,12,>100
8369,outing,241,33776734,97.3127474019,_100,6,>100
8370,swinging,241,33776975,97.313441737,_100,8,>100
8371,operates,240,33777215,97.314133191,_100,8,>100
8372,environments,240,33777455,97.3148246451,_100,12,>100
8373,merits,240,33777695,97.3155160991,_100,6,>100
8374,edl,240,33777935,97.3162075532,_100,3,>100
8375,commitments,240,33778175,97.3168990072,_100,11,>100
8376,stirred,240,33778415,97.3175904613,_100,7,>100
8377,walnut,240,33778655,97.3182819153,_100,6,>100
8378,attributed,240,33778895,97.3189733694,_100,10,>100
8379,dice,240,33779135,97.3196648234,_100,4,>100
8380,pitched,240,33779375,97.3203562775,_100,7,>100
8381,ache,240,33779615,97.3210477315,_100,4,>100
8382,fashionable,240,33779855,97.3217391856,_100,11,>100
8383,stakes,240,33780095,97.3224306396,_100,6,>100
8384,niche,240,33780335,97.3231220936,_100,5,>100
8385,tore,240,33780575,97.3238135477,_100,4,>100
8386,blossoms,240,33780815,97.3245050017,_100,8,>100
8387,polls,240,33781055,97.3251964558,_100,5,>100
8388,timely,240,33781295,97.3258879098,_100,6,>100
8389,lest,240,33781535,97.3265793639,_100,4,>100
8390,austen,240,33781775,97.3272708179,_100,6,>100
8391,opt,239,33782014,97.3279593909,_100,3,>100
8392,cartoons,239,33782253,97.3286479639,_100,8,>100
8393,rifle,239,33782492,97.3293365369,_100,5,>100
8394,congregation,239,33782731,97.3300251099,_100,12,>100
8395,mercury,239,33782970,97.3307136829,_100,7,>100
8396,ralph,239,33783209,97.3314022558,_100,5,>100
8397,par,239,33783448,97.3320908288,_100,3,>100
8398,dennis,239,33783687,97.3327794018,_100,6,>100
8399,founding,239,33783926,97.3334679748,_100,8,>100
8400,lingering,239,33784165,97.3341565478,_100,9,>100
8401,bout,239,33784404,97.3348451208,_100,4,>100
8402,limiting,239,33784643,97.3355336938,_100,8,>100
8403,avocado,239,33784882,97.3362222668,_100,7,>100
8404,anchor,239,33785121,97.3369108397,_100,6,>100
8405,warfare,239,33785360,97.3375994127,_100,7,>100
8406,tempting,239,33785599,97.3382879857,_100,8,>100
8407,minced,239,33785838,97.3389765587,_100,6,>100
8408,holocaust,239,33786077,97.3396651317,_100,9,>100
8409,proportions,238,33786315,97.3403508236,_100,11,>100
8410,atheist,238,33786553,97.3410365155,_100,7,>100
8411,enabled,238,33786791,97.3417222075,_100,7,>100
8412,stretches,238,33787029,97.3424078994,_100,9,>100
8413,rocket,238,33787267,97.3430935913,_100,6,>100
8414,sober,238,33787505,97.3437792833,_100,5,>100
8415,availability,238,33787743,97.3444649752,_100,12,>100
8416,cursed,238,33787981,97.3451506671,_100,6,>100
8417,rotten,238,33788219,97.345836359,_100,6,>100
8418,unfinished,238,33788457,97.346522051,_100,10,>100
8419,freddie,238,33788695,97.3472077429,_100,7,>100
8420,evaluate,238,33788933,97.3478934348,_100,8,>100
8421,beware,238,33789171,97.3485791268,_100,6,>100
8422,flourish,238,33789409,97.3492648187,_100,8,>100
8423,chased,238,33789647,97.3499505106,_100,6,>100
8424,ambulance,238,33789885,97.3506362025,_100,9,>100
8425,shaping,238,33790123,97.3513218945,_100,7,>100
8426,politely,238,33790361,97.3520075864,_100,8,>100
8427,nickname,238,33790599,97.3526932783,_100,8,>100
8428,utilize,238,33790837,97.3533789703,_100,7,>100
8429,scholar,238,33791075,97.3540646622,_100,7,>100
8430,batches,237,33791312,97.3547474731,_100,7,>100
8431,myriad,237,33791549,97.3554302839,_100,6,>100
8432,decoration,237,33791786,97.3561130948,_100,10,>100
8433,harold,237,33792023,97.3567959057,_100,6,>100
8434,waving,237,33792260,97.3574787165,_100,6,>100
8435,misleading,237,33792497,97.3581615274,_100,10,>100
8436,lengths,237,33792734,97.3588443383,_100,7,>100
8437,impose,237,33792971,97.3595271492,_100,6,>100
8438,dismiss,237,33793208,97.36020996,_100,7,>100
8439,numb,237,33793445,97.3608927709,_100,4,>100
8440,nietzsche,237,33793682,97.3615755818,_100,9,>100
8441,interrupted,237,33793919,97.3622583926,_100,11,>100
8442,interpreted,237,33794156,97.3629412035,_100,11,>100
8443,portable,237,33794393,97.3636240144,_100,8,>100
8444,nhs,237,33794630,97.3643068252,_100,3,>100
8445,nintendo,237,33794867,97.3649896361,_100,8,>100
8446,corps,237,33795104,97.365672447,_100,5,>100
8447,rumors,237,33795341,97.3663552579,_100,6,>100
8448,resigned,237,33795578,97.3670380687,_100,8,>100
8449,impressions,237,33795815,97.3677208796,_100,11,>100
8450,visually,237,33796052,97.3684036905,_100,8,>100
8451,gingrich,237,33796289,97.3690865013,_100,8,>100
8452,swirl,237,33796526,97.3697693122,_100,5,>100
8453,bureau,237,33796763,97.3704521231,_100,6,>100
8454,soothing,237,33797000,97.3711349339,_100,8,>100
8455,baggage,237,33797237,97.3718177448,_100,7,>100
8456,clinical,237,33797474,97.3725005557,_100,8,>100
8457,utility,237,33797711,97.3731833666,_100,7,>100
8458,marking,237,33797948,97.3738661774,_100,7,>100
8459,historically,237,33798185,97.3745489883,_100,12,>100
8460,noisy,237,33798422,97.3752317992,_100,5,>100
8461,performer,236,33798658,97.375911729,_100,9,>100
8462,ado,236,33798894,97.3765916588,_100,3,>100
8463,surround,236,33799130,97.3772715886,_100,8,>100
8464,riot,236,33799366,97.3779515184,_100,4,>100
8465,hollow,236,33799602,97.3786314482,_100,6,>100
8466,replies,236,33799838,97.379311378,_100,7,>100
8467,delhi,236,33800074,97.3799913078,_100,5,>100
8468,naming,236,33800310,97.3806712377,_100,6,>100
8469,projected,236,33800546,97.3813511675,_100,9,>100
8470,papa,236,33800782,97.3820310973,_100,4,>100
8471,suitcase,236,33801018,97.3827110271,_100,8,>100
8472,preserved,236,33801254,97.3833909569,_100,9,>100
8473,boarding,236,33801490,97.3840708867,_100,8,>100
8474,aiming,236,33801726,97.3847508165,_100,6,>100
8475,selections,236,33801962,97.3854307463,_100,10,>100
8476,rs,236,33802198,97.3861106762,_100,2,>100
8477,unacceptable,236,33802434,97.386790606,_100,12,>100
8478,rewarded,236,33802670,97.3874705358,_100,8,>100
8479,sweaty,236,33802906,97.3881504656,_100,6,>100
8480,arabia,236,33803142,97.3888303954,_100,6,>100
8481,estimates,236,33803378,97.3895103252,_100,9,>100
8482,colouring,236,33803614,97.390190255,_100,9,>100
8483,il,236,33803850,97.3908701848,_100,2,>100
8484,thrive,235,33804085,97.3915472336,_100,6,>100
8485,allergies,235,33804320,97.3922242823,_100,9,>100
8486,brilliantly,235,33804555,97.3929013311,_100,11,>100
8487,stereotypes,235,33804790,97.3935783798,_100,11,>100
8488,imagining,235,33805025,97.3942554286,_100,9,>100
8489,tubes,235,33805260,97.3949324774,_100,5,>100
8490,trimmed,235,33805495,97.3956095261,_100,7,>100
8491,electronics,235,33805730,97.3962865749,_100,11,>100
8492,restoration,235,33805965,97.3969636236,_100,11,>100
8493,refined,235,33806200,97.3976406724,_100,7,>100
8494,rehearsal,235,33806435,97.3983177211,_100,9,>100
8495,olives,235,33806670,97.3989947699,_100,6,>100
8496,trayvon,235,33806905,97.3996718186,_100,7,>100
8497,playful,235,33807140,97.4003488674,_100,7,>100
8498,turkish,235,33807375,97.4010259161,_100,7,>100
8499,novelty,235,33807610,97.4017029649,_100,7,>100
8500,objectives,235,33807845,97.4023800136,_100,10,>100
8501,freaked,235,33808080,97.4030570624,_100,7,>100
8502,quilts,235,33808315,97.4037341111,_100,6,>100
8503,herd,234,33808549,97.4044082788,_100,4,>100
8504,litigation,234,33808783,97.4050824465,_100,10,>100
8505,damages,234,33809017,97.4057566142,_100,7,>100
8506,zimmerman,234,33809251,97.4064307819,_100,9,>100
8507,painfully,234,33809485,97.4071049496,_100,9,>100
8508,schedules,234,33809719,97.4077791173,_100,9,>100
8509,companions,234,33809953,97.408453285,_100,10,>100
8510,blooms,234,33810187,97.4091274527,_100,6,>100
8511,striped,234,33810421,97.4098016204,_100,7,>100
8512,compliments,234,33810655,97.4104757881,_100,11,>100
8513,intentional,234,33810889,97.4111499558,_100,11,>100
8514,discouraged,234,33811123,97.4118241235,_100,11,>100
8515,admiration,234,33811357,97.4124982912,_100,10,>100
8516,dire,234,33811591,97.4131724589,_100,4,>100
8517,caps,234,33811825,97.4138466266,_100,4,>100
8518,implementation,234,33812059,97.4145207943,_100,14,>100
8519,desirable,234,33812293,97.415194962,_100,9,>100
8520,barcelona,234,33812527,97.4158691296,_100,9,>100
8521,doug,234,33812761,97.4165432973,_100,4,>100
8522,foundations,234,33812995,97.417217465,_100,11,>100
8523,herb,234,33813229,97.4178916327,_100,4,>100
8524,communicating,234,33813463,97.4185658004,_100,13,>100
8525,fellowship,233,33813696,97.4192370871,_100,10,>100
8526,joking,233,33813929,97.4199083737,_100,6,>100
8527,exploded,233,33814162,97.4205796603,_100,8,>100
8528,murdoch,233,33814395,97.421250947,_100,7,>100
8529,montreal,233,33814628,97.4219222336,_100,8,>100
8530,fatal,233,33814861,97.4225935202,_100,5,>100
8531,schemes,233,33815094,97.4232648069,_100,7,>100
8532,deaf,233,33815327,97.4239360935,_100,4,>100
8533,remedy,233,33815560,97.4246073801,_100,6,>100
8534,sampling,233,33815793,97.4252786668,_100,8,>100
8535,refusal,233,33816026,97.4259499534,_100,7,>100
8536,suburban,233,33816259,97.4266212401,_100,8,>100
8537,upward,233,33816492,97.4272925267,_100,6,>100
8538,wireless,233,33816725,97.4279638133,_100,8,>100
8539,geek,233,33816958,97.4286351,_100,4,>100
8540,fireplace,233,33817191,97.4293063866,_100,9,>100
8541,smack,233,33817424,97.4299776732,_100,5,>100
8542,bins,233,33817657,97.4306489599,_100,4,>100
8543,ashes,233,33817890,97.4313202465,_100,5,>100
8544,transit,233,33818123,97.4319915331,_100,7,>100
8545,notably,233,33818356,97.4326628198,_100,7,>100
8546,exploitation,233,33818589,97.4333341064,_100,12,>100
8547,ideally,233,33818822,97.4340053931,_100,7,>100
8548,doom,233,33819055,97.4346766797,_100,4,>100
8549,lifelong,233,33819288,97.4353479663,_100,8,>100
8550,meanings,233,33819521,97.436019253,_100,8,>100
8551,specially,233,33819754,97.4366905396,_100,9,>100
8552,professionally,233,33819987,97.4373618262,_100,14,>100
8553,outrage,233,33820220,97.4380331129,_100,7,>100
8554,denmark,232,33820452,97.4387015184,_100,7,>100
8555,haunting,232,33820684,97.439369924,_100,8,>100
8556,minorities,232,33820916,97.4400383296,_100,10,>100
8557,nerd,232,33821148,97.4407067352,_100,4,>100
8558,scanned,232,33821380,97.4413751408,_100,7,>100
8559,accounting,232,33821612,97.4420435463,_100,10,>100
8560,elevated,232,33821844,97.4427119519,_100,8,>100
8561,vein,232,33822076,97.4433803575,_100,4,>100
8562,lowered,232,33822308,97.4440487631,_100,7,>100
8563,archives,232,33822540,97.4447171686,_100,8,>100
8564,instincts,232,33822772,97.4453855742,_100,9,>100
8565,amused,232,33823004,97.4460539798,_100,6,>100
8566,lovingly,232,33823236,97.4467223854,_100,8,>100
8567,julian,232,33823468,97.447390791,_100,6,>100
8568,confirmation,232,33823700,97.4480591965,_100,12,>100
8569,revised,232,33823932,97.4487276021,_100,7,>100
8570,choir,232,33824164,97.4493960077,_100,5,>100
8571,solomon,232,33824396,97.4500644133,_100,7,>100
8572,disclosure,232,33824628,97.4507328188,_100,10,>100
8573,erin,232,33824860,97.4514012244,_100,4,>100
8574,perceptions,232,33825092,97.45206963,_100,11,>100
8575,buys,232,33825324,97.4527380356,_100,4,>100
8576,nightmares,232,33825556,97.4534064412,_100,10,>100
8577,abbey,232,33825788,97.4540748467,_100,5,>100
8578,catalogue,232,33826020,97.4547432523,_100,9,>100
8579,rinse,232,33826252,97.4554116579,_100,5,>100
8580,endeavor,232,33826484,97.4560800635,_100,8,>100
8581,gore,232,33826716,97.456748469,_100,4,>100
8582,chilling,232,33826948,97.4574168746,_100,8,>100
8583,surveillance,231,33827179,97.4580823991,_100,12,>100
8584,burton,231,33827410,97.4587479237,_100,6,>100
8585,beginnings,231,33827641,97.4594134482,_100,10,>100
8586,medications,231,33827872,97.4600789727,_100,11,>100
8587,unprecedented,231,33828103,97.4607444972,_100,13,>100
8588,guts,231,33828334,97.4614100217,_100,4,>100
8589,offspring,231,33828565,97.4620755463,_100,9,>100
8590,flats,231,33828796,97.4627410708,_100,5,>100
8591,minus,231,33829027,97.4634065953,_100,5,>100
8592,elf,231,33829258,97.4640721198,_100,3,>100
8593,stacked,231,33829489,97.4647376443,_100,7,>100
8594,cheryl,231,33829720,97.4654031688,_100,6,>100
8595,heartbeat,231,33829951,97.4660686934,_100,9,>100
8596,commissioned,231,33830182,97.4667342179,_100,12,>100
8597,lineup,231,33830413,97.4673997424,_100,6,>100
8598,consisting,231,33830644,97.4680652669,_100,10,>100
8599,differ,231,33830875,97.4687307914,_100,6,>100
8600,alley,231,33831106,97.469396316,_100,5,>100
8601,unexpectedly,231,33831337,97.4700618405,_100,12,>100
8602,agreements,230,33831567,97.4707244839,_100,10,>100
8603,believable,230,33831797,97.4713871274,_100,10,>100
8604,streams,230,33832027,97.4720497709,_100,7,>100
8605,props,230,33832257,97.4727124143,_100,5,>100
8606,exchanged,230,33832487,97.4733750578,_100,9,>100
8607,veil,230,33832717,97.4740377012,_100,4,>100
8608,gateway,230,33832947,97.4747003447,_100,7,>100
8609,sorting,230,33833177,97.4753629882,_100,7,>100
8610,buffet,230,33833407,97.4760256316,_100,6,>100
8611,annually,230,33833637,97.4766882751,_100,8,>100
8612,ducks,230,33833867,97.4773509185,_100,5,>100
8613,brussels,230,33834097,97.478013562,_100,8,>100
8614,subjective,230,33834327,97.4786762055,_100,10,>100
8615,gigantic,230,33834557,97.4793388489,_100,8,>100
8616,exhaust,230,33834787,97.4800014924,_100,7,>100
8617,eldest,230,33835017,97.4806641358,_100,6,>100
8618,ringing,230,33835247,97.4813267793,_100,7,>100
8619,giggle,230,33835477,97.4819894228,_100,6,>100
8620,gabriel,230,33835707,97.4826520662,_100,7,>100
8621,glamorous,230,33835937,97.4833147097,_100,9,>100
8622,novelist,230,33836167,97.4839773532,_100,8,>100
8623,intimacy,230,33836397,97.4846399966,_100,8,>100
8624,lump,230,33836627,97.4853026401,_100,4,>100
8625,consciously,230,33836857,97.4859652835,_100,11,>100
8626,cone,230,33837087,97.486627927,_100,4,>100
8627,nazis,229,33837316,97.4872876894,_100,5,>100
8628,biting,229,33837545,97.4879474518,_100,6,>100
8629,dictionary,229,33837774,97.4886072142,_100,10,>100
8630,relying,229,33838003,97.4892669766,_100,7,>100
8631,downs,229,33838232,97.489926739,_100,5,>100
8632,researched,229,33838461,97.4905865014,_100,10,>100
8633,impending,229,33838690,97.4912462638,_100,9,>100
8634,watering,229,33838919,97.4919060262,_100,8,>100
8635,costly,229,33839148,97.4925657886,_100,6,>100
8636,temper,229,33839377,97.493225551,_100,6,>100
8637,flipping,229,33839606,97.4938853134,_100,8,>100
8638,arc,229,33839835,97.4945450758,_100,3,>100
8639,bling,229,33840064,97.4952048382,_100,5,>100
8640,economies,229,33840293,97.4958646006,_100,9,>100
8641,shattered,229,33840522,97.496524363,_100,9,>100
8642,surgeon,229,33840751,97.4971841254,_100,7,>100
8643,nomination,229,33840980,97.4978438878,_100,10,>100
8644,katniss,229,33841209,97.4985036502,_100,7,>100
8645,incidentally,228,33841437,97.4991605316,_100,12,>100
8646,enables,228,33841665,97.4998174129,_100,7,>100
8647,cane,228,33841893,97.5004742943,_100,4,>100
8648,eyed,228,33842121,97.5011311756,_100,4,>100
8649,marble,228,33842349,97.5017880569,_100,6,>100
8650,willingly,228,33842577,97.5024449383,_100,9,>100
8651,ventured,228,33842805,97.5031018196,_100,8,>100
8652,breach,228,33843033,97.503758701,_100,6,>100
8653,tanks,228,33843261,97.5044155823,_100,5,>100
8654,upright,228,33843489,97.5050724637,_100,7,>100
8655,seeming,228,33843717,97.505729345,_100,7,>100
8656,sturdy,228,33843945,97.5063862264,_100,6,>100
8657,thrust,228,33844173,97.5070431077,_100,6,>100
8658,architectural,228,33844401,97.507699989,_100,13,>100
8659,clutter,228,33844629,97.5083568704,_100,7,>100
8660,consensus,228,33844857,97.5090137517,_100,9,>100
8661,dh,228,33845085,97.5096706331,_100,2,>100
8662,inspection,228,33845313,97.5103275144,_100,10,>100
8663,andrea,228,33845541,97.5109843958,_100,6,>100
8664,shakes,228,33845769,97.5116412771,_100,6,>100
8665,whisky,228,33845997,97.5122981584,_100,6,>100
8666,dynamics,228,33846225,97.5129550398,_100,8,>100
8667,btw,228,33846453,97.5136119211,_100,3,>100
8668,forests,228,33846681,97.5142688025,_100,7,>100
8669,certified,227,33846908,97.5149228028,_100,9,>100
8670,mystical,227,33847135,97.515576803,_100,8,>100
8671,retire,227,33847362,97.5162308033,_100,6,>100
8672,acoustic,227,33847589,97.5168848036,_100,8,>100
8673,persistent,227,33847816,97.5175388039,_100,10,>100
8674,demise,227,33848043,97.5181928042,_100,6,>100
8675,enforce,227,33848270,97.5188468045,_100,7,>100
8676,balancing,227,33848497,97.5195008048,_100,9,>100
8677,adjusting,227,33848724,97.520154805,_100,9,>100
8678,recognised,227,33848951,97.5208088053,_100,10,>100
8679,scars,227,33849178,97.5214628056,_100,5,>100
8680,fighter,227,33849405,97.5221168059,_100,7,>100
8681,bo,227,33849632,97.5227708062,_100,2,>100
8682,steamed,227,33849859,97.5234248065,_100,7,>100
8683,negotiations,227,33850086,97.5240788067,_100,12,>100
8684,thyme,227,33850313,97.524732807,_100,5,>100
8685,germans,227,33850540,97.5253868073,_100,7,>100
8686,masks,227,33850767,97.5260408076,_100,5,>100
8687,switzerland,227,33850994,97.5266948079,_100,11,>100
8688,helicopter,227,33851221,97.5273488082,_100,10,>100
8689,credible,227,33851448,97.5280028085,_100,8,>100
8690,mock,227,33851675,97.5286568087,_100,4,>100
8691,weights,227,33851902,97.529310809,_100,7,>100
8692,flee,227,33852129,97.5299648093,_100,4,>100
8693,seams,227,33852356,97.5306188096,_100,5,>100
8694,tracy,226,33852582,97.5312699288,_100,5,>100
8695,ounce,226,33852808,97.531921048,_100,5,>100
8696,blaming,226,33853034,97.5325721673,_100,7,>100
8697,unrelated,226,33853260,97.5332232865,_100,9,>100
8698,debts,226,33853486,97.5338744057,_100,5,>100
8699,rubbing,226,33853712,97.534525525,_100,7,>100
8700,wisely,226,33853938,97.5351766442,_100,6,>100
8701,obligations,226,33854164,97.5358277634,_100,11,>100
8702,prophets,226,33854390,97.5364788826,_100,8,>100
8703,pipes,226,33854616,97.5371300019,_100,5,>100
8704,debbie,226,33854842,97.5377811211,_100,6,>100
8705,kidnapped,226,33855068,97.5384322403,_100,9,>100
8706,kent,226,33855294,97.5390833595,_100,4,>100
8707,flown,226,33855520,97.5397344788,_100,5,>100
8708,consist,226,33855746,97.540385598,_100,7,>100
8709,darkest,226,33855972,97.5410367172,_100,7,>100
8710,mantra,226,33856198,97.5416878364,_100,6,>100
8711,renewal,226,33856424,97.5423389557,_100,7,>100
8712,pinned,226,33856650,97.5429900749,_100,6,>100
8713,exceptionally,226,33856876,97.5436411941,_100,13,>100
8714,width,226,33857102,97.5442923134,_100,5,>100
8715,phenomenal,226,33857328,97.5449434326,_100,10,>100
8716,magically,226,33857554,97.5455945518,_100,9,>100
8717,embroidery,226,33857780,97.546245671,_100,10,>100
8718,prosecution,226,33858006,97.5468967903,_100,11,>100
8719,integral,226,33858232,97.5475479095,_100,8,>100
8720,iranian,226,33858458,97.5481990287,_100,7,>100
8721,stroller,226,33858684,97.5488501479,_100,8,>100
8722,ranked,226,33858910,97.5495012672,_100,6,>100
8723,smashed,226,33859136,97.5501523864,_100,7,>100
8724,licence,225,33859361,97.5508006246,_100,7,>100
8725,baptist,225,33859586,97.5514488627,_100,7,>100
8726,citizenship,225,33859811,97.5520971009,_100,11,>100
8727,scrapbooking,225,33860036,97.5527453391,_100,12,>100
8728,devastated,225,33860261,97.5533935772,_100,10,>100
8729,elbow,225,33860486,97.5540418154,_100,5,>100
8730,poke,225,33860711,97.5546900536,_100,4,>100
8731,unwilling,225,33860936,97.5553382917,_100,9,>100
8732,chaotic,225,33861161,97.5559865299,_100,7,>100
8733,tattoos,225,33861386,97.5566347681,_100,7,>100
8734,nikki,225,33861611,97.5572830062,_100,5,>100
8735,evolving,225,33861836,97.5579312444,_100,8,>100
8736,rio,225,33862061,97.5585794826,_100,3,>100
8737,turner,225,33862286,97.5592277207,_100,6,>100
8738,structured,225,33862511,97.5598759589,_100,10,>100
8739,possessions,225,33862736,97.5605241971,_100,11,>100
8740,meaningless,225,33862961,97.5611724352,_100,11,>100
8741,dual,225,33863186,97.5618206734,_100,4,>100
8742,drinkers,224,33863410,97.5624660305,_100,8,>100
8743,favors,224,33863634,97.5631113876,_100,6,>100
8744,synopsis,224,33863858,97.5637567447,_100,8,>100
8745,embedded,224,33864082,97.5644021018,_100,8,>100
8746,backup,224,33864306,97.565047459,_100,6,>100
8747,fruity,224,33864530,97.5656928161,_100,6,>100
8748,sovereign,224,33864754,97.5663381732,_100,9,>100
8749,hooks,224,33864978,97.5669835303,_100,5,>100
8750,nba,224,33865202,97.5676288874,_100,3,>100
8751,cruelty,224,33865426,97.5682742445,_100,7,>100
8752,curl,224,33865650,97.5689196016,_100,4,>100
8753,isolation,224,33865874,97.5695649587,_100,9,>100
8754,ranger,224,33866098,97.5702103158,_100,6,>100
8755,helmet,224,33866322,97.5708556729,_100,6,>100
8756,blogosphere,224,33866546,97.5715010301,_100,11,>100
8757,beforehand,224,33866770,97.5721463872,_100,10,>100
8758,negotiate,224,33866994,97.5727917443,_100,9,>100
8759,console,224,33867218,97.5734371014,_100,7,>100
8760,distract,224,33867442,97.5740824585,_100,8,>100
8761,unfold,224,33867666,97.5747278156,_100,6,>100
8762,manipulate,224,33867890,97.5753731727,_100,10,>100
8763,chocolates,224,33868114,97.5760185298,_100,10,>100
8764,bounce,224,33868338,97.5766638869,_100,6,>100
8765,disturbed,224,33868562,97.577309244,_100,9,>100
8766,tires,224,33868786,97.5779546011,_100,5,>100
8767,progression,223,33869009,97.5785970772,_100,11,>100
8768,ornaments,223,33869232,97.5792395532,_100,9,>100
8769,freelance,223,33869455,97.5798820293,_100,9,>100
8770,lurking,223,33869678,97.5805245053,_100,7,>100
8771,cease,223,33869901,97.5811669814,_100,5,>100
8772,victor,223,33870124,97.5818094574,_100,6,>100
8773,slid,223,33870347,97.5824519335,_100,4,>100
8774,inn,223,33870570,97.5830944096,_100,3,>100
8775,extending,223,33870793,97.5837368856,_100,9,>100
8776,poppy,223,33871016,97.5843793617,_100,5,>100
8777,blurb,223,33871239,97.5850218377,_100,5,>100
8778,columbus,223,33871462,97.5856643138,_100,8,>100
8779,caffeine,223,33871685,97.5863067898,_100,8,>100
8780,admitting,223,33871908,97.5869492659,_100,9,>100
8781,ella,223,33872131,97.5875917419,_100,4,>100
8782,hesitant,223,33872354,97.588234218,_100,8,>100
8783,connor,223,33872577,97.588876694,_100,6,>100
8784,suffers,223,33872800,97.5895191701,_100,7,>100
8785,warrant,223,33873023,97.5901616461,_100,7,>100
8786,pounding,223,33873246,97.5908041222,_100,8,>100
8787,tactic,223,33873469,97.5914465982,_100,6,>100
8788,rocked,223,33873692,97.5920890743,_100,6,>100
8789,pressures,222,33873914,97.5927286693,_100,9,>100
8790,executives,222,33874136,97.5933682642,_100,10,>100
8791,sufficiently,222,33874358,97.5940078592,_100,12,>100
8792,dubbed,222,33874580,97.5946474542,_100,6,>100
8793,tina,222,33874802,97.5952870492,_100,4,>100
8794,overview,222,33875024,97.5959266442,_100,8,>100
8795,notices,222,33875246,97.5965662392,_100,7,>100
8796,pumping,222,33875468,97.5972058342,_100,7,>100
8797,paused,222,33875690,97.5978454292,_100,6,>100
8798,remake,222,33875912,97.5984850242,_100,6,>100
8799,lease,222,33876134,97.5991246192,_100,5,>100
8800,concludes,222,33876356,97.5997642142,_100,9,>100
8801,ample,222,33876578,97.6004038092,_100,5,>100
8802,explores,222,33876800,97.6010434042,_100,8,>100
8803,apt,222,33877022,97.6016829991,_100,3,>100
8804,arnold,222,33877244,97.6023225941,_100,6,>100
8805,sprouts,222,33877466,97.6029621891,_100,7,>100
8806,buddha,222,33877688,97.6036017841,_100,6,>100
8807,disgust,222,33877910,97.6042413791,_100,7,>100
8808,goats,222,33878132,97.6048809741,_100,5,>100
8809,surfaces,221,33878353,97.605517688,_100,8,>100
8810,slogan,221,33878574,97.606154402,_100,6,>100
8811,aspiring,221,33878795,97.6067911159,_100,8,>100
8812,outlined,221,33879016,97.6074278298,_100,8,>100
8813,athlete,221,33879237,97.6080645438,_100,7,>100
8814,apartments,221,33879458,97.6087012577,_100,10,>100
8815,clearance,221,33879679,97.6093379716,_100,9,>100
8816,metallic,221,33879900,97.6099746856,_100,8,>100
8817,browse,221,33880121,97.6106113995,_100,6,>100
8818,shortage,221,33880342,97.6112481134,_100,8,>100
8819,greedy,221,33880563,97.6118848274,_100,6,>100
8820,cheated,221,33880784,97.6125215413,_100,7,>100
8821,sincerely,221,33881005,97.6131582552,_100,9,>100
8822,yo,221,33881226,97.6137949692,_100,2,>100
8823,tedious,221,33881447,97.6144316831,_100,7,>100
8824,tossing,221,33881668,97.615068397,_100,7,>100
8825,trafficking,221,33881889,97.615705111,_100,11,>100
8826,districts,221,33882110,97.6163418249,_100,9,>100
8827,sinful,221,33882331,97.6169785389,_100,6,>100
8828,sandals,221,33882552,97.6176152528,_100,7,>100
8829,discourse,221,33882773,97.6182519667,_100,9,>100
8830,fastest,221,33882994,97.6188886807,_100,7,>100
8831,refugees,221,33883215,97.6195253946,_100,8,>100
8832,marijuana,221,33883436,97.6201621085,_100,9,>100
8833,idiots,221,33883657,97.6207988225,_100,6,>100
8834,raspberry,221,33883878,97.6214355364,_100,9,>100
8835,adjustments,221,33884099,97.6220722503,_100,11,>100
8836,architect,221,33884320,97.6227089643,_100,9,>100
8837,adjustment,221,33884541,97.6233456782,_100,10,>100
8838,curled,221,33884762,97.6239823921,_100,6,>100
8839,ave,221,33884983,97.6246191061,_100,3,>100
8840,bricks,220,33885203,97.6252529389,_100,6,>100
8841,resembles,220,33885423,97.6258867718,_100,9,>100
8842,ltd,220,33885643,97.6265206047,_100,3,>100
8843,prom,220,33885863,97.6271544376,_100,4,>100
8844,knot,220,33886083,97.6277882704,_100,4,>100
8845,endlessly,220,33886303,97.6284221033,_100,9,>100
8846,sub,220,33886523,97.6290559362,_100,3,>100
8847,begged,220,33886743,97.6296897691,_100,6,>100
8848,accommodation,220,33886963,97.6303236019,_100,13,>100
8849,icy,220,33887183,97.6309574348,_100,3,>100
8850,guiding,220,33887403,97.6315912677,_100,7,>100
8851,compost,220,33887623,97.6322251006,_100,7,>100
8852,governance,220,33887843,97.6328589334,_100,10,>100
8853,margin,220,33888063,97.6334927663,_100,6,>100
8854,bursting,220,33888283,97.6341265992,_100,8,>100
8855,manners,220,33888503,97.6347604321,_100,7,>100
8856,timeline,220,33888723,97.6353942649,_100,8,>100
8857,inclusion,220,33888943,97.6360280978,_100,9,>100
8858,lunches,220,33889163,97.6366619307,_100,7,>100
8859,batting,220,33889383,97.6372957636,_100,7,>100
8860,hail,220,33889603,97.6379295964,_100,4,>100
8861,bachelor,220,33889823,97.6385634293,_100,8,>100
8862,portrayal,220,33890043,97.6391972622,_100,9,>100
8863,nutrients,220,33890263,97.6398310951,_100,9,>100
8864,resentment,220,33890483,97.6404649279,_100,10,>100
8865,maturity,220,33890703,97.6410987608,_100,8,>100
8866,coaster,220,33890923,97.6417325937,_100,7,>100
8867,sheridan,219,33891142,97.6423635455,_100,8,>100
8868,risky,219,33891361,97.6429944973,_100,5,>100
8869,eyebrows,219,33891580,97.6436254491,_100,8,>100
8870,centres,219,33891799,97.644256401,_100,7,>100
8871,graduates,219,33892018,97.6448873528,_100,9,>100
8872,antibiotics,219,33892237,97.6455183046,_100,11,>100
8873,cherries,219,33892456,97.6461492564,_100,8,>100
8874,ga,219,33892675,97.6467802082,_100,2,>100
8875,manipulation,219,33892894,97.64741116,_100,12,>100
8876,schooling,219,33893113,97.6480421119,_100,9,>100
8877,pairing,219,33893332,97.6486730637,_100,7,>100
8878,mesh,219,33893551,97.6493040155,_100,4,>100
8879,kenya,219,33893770,97.6499349673,_100,5,>100
8880,incapable,219,33893989,97.6505659191,_100,9,>100
8881,wallace,219,33894208,97.6511968709,_100,7,>100
8882,slick,219,33894427,97.6518278228,_100,5,>100
8883,rustic,219,33894646,97.6524587746,_100,6,>100
8884,rated,219,33894865,97.6530897264,_100,5,>100
8885,ethan,219,33895084,97.6537206782,_100,5,>100
8886,explosive,219,33895303,97.65435163,_100,9,>100
8887,waved,219,33895522,97.6549825818,_100,5,>100
8888,theological,219,33895741,97.6556135337,_100,11,>100
8889,lucas,219,33895960,97.6562444855,_100,5,>100
8890,genes,219,33896179,97.6568754373,_100,5,>100
8891,incorrect,218,33896397,97.657503508,_100,9,>100
8892,pittsburgh,218,33896615,97.6581315788,_100,10,>100
8893,complications,218,33896833,97.6587596496,_100,13,>100
8894,brazilian,218,33897051,97.6593877203,_100,9,>100
8895,resemble,218,33897269,97.6600157911,_100,8,>100
8896,disbelief,218,33897487,97.6606438618,_100,9,>100
8897,dp,218,33897705,97.6612719326,_100,2,>100
8898,monica,218,33897923,97.6619000034,_100,6,>100
8899,photoshop,218,33898141,97.6625280741,_100,9,>100
8900,armor,218,33898359,97.6631561449,_100,5,>100
8901,edible,218,33898577,97.6637842156,_100,6,>100
8902,fertility,218,33898795,97.6644122864,_100,9,>100
8903,exquisite,218,33899013,97.6650403571,_100,9,>100
8904,downhill,218,33899231,97.6656684279,_100,8,>100
8905,unseen,218,33899449,97.6662964987,_100,6,>100
8906,descended,218,33899667,97.6669245694,_100,9,>100
8907,sweetest,218,33899885,97.6675526402,_100,8,>100
8908,fascination,218,33900103,97.6681807109,_100,11,>100
8909,casually,218,33900321,97.6688087817,_100,8,>100
8910,betrayal,218,33900539,97.6694368525,_100,8,>100
8911,cutter,218,33900757,97.6700649232,_100,6,>100
8912,commands,218,33900975,97.670692994,_100,8,>100
8913,slides,218,33901193,97.6713210647,_100,6,>100
8914,sullivan,218,33901411,97.6719491355,_100,8,>100
8915,cautious,218,33901629,97.6725772062,_100,8,>100
8916,demon,218,33901847,97.673205277,_100,5,>100
8917,painter,218,33902065,97.6738333478,_100,7,>100
8918,stellar,218,33902283,97.6744614185,_100,7,>100
8919,rebel,217,33902500,97.6750866082,_100,5,>100
8920,bryan,217,33902717,97.6757117979,_100,5,>100
8921,peanuts,217,33902934,97.6763369876,_100,7,>100
8922,urged,217,33903151,97.6769621773,_100,5,>100
8923,competent,217,33903368,97.677587367,_100,9,>100
8924,beijing,217,33903585,97.6782125567,_100,7,>100
8925,avid,217,33903802,97.6788377464,_100,4,>100
8926,calculated,217,33904019,97.6794629361,_100,10,>100
8927,trousers,217,33904236,97.6800881258,_100,8,>100
8928,setup,217,33904453,97.6807133155,_100,5,>100
8929,killers,217,33904670,97.6813385052,_100,7,>100
8930,pollution,217,33904887,97.6819636949,_100,9,>100
8931,fourteen,217,33905104,97.6825888846,_100,8,>100
8932,kale,217,33905321,97.6832140743,_100,4,>100
8933,turquoise,217,33905538,97.683839264,_100,9,>100
8934,remarkably,217,33905755,97.6844644537,_100,10,>100
8935,streak,217,33905972,97.6850896434,_100,6,>100
8936,rejoice,217,33906189,97.6857148331,_100,7,>100
8937,counterparts,217,33906406,97.6863400228,_100,12,>100
8938,progressed,217,33906623,97.6869652125,_100,10,>100
8939,bonnie,217,33906840,97.6875904022,_100,6,>100
8940,wallpaper,217,33907057,97.6882155919,_100,9,>100
8941,riots,217,33907274,97.6888407816,_100,5,>100
8942,marvelous,217,33907491,97.6894659713,_100,9,>100
8943,zip,217,33907708,97.690091161,_100,3,>100
8944,translates,216,33907924,97.6907134697,_100,10,>100
8945,import,216,33908140,97.6913357783,_100,6,>100
8946,puree,216,33908356,97.6919580869,_100,5,>100
8947,persuade,216,33908572,97.6925803956,_100,8,>100
8948,examining,216,33908788,97.6932027042,_100,9,>100
8949,crosses,216,33909004,97.6938250129,_100,7,>100
8950,magnitude,216,33909220,97.6944473215,_100,9,>100
8951,spells,216,33909436,97.6950696301,_100,6,>100
8952,monetary,216,33909652,97.6956919388,_100,8,>100
8953,km,216,33909868,97.6963142474,_100,2,>100
8954,galleries,216,33910084,97.6969365561,_100,9,>100
8955,chew,216,33910300,97.6975588647,_100,4,>100
8956,marilyn,216,33910516,97.6981811733,_100,7,>100
8957,portraits,216,33910732,97.698803482,_100,9,>100
8958,emphasize,216,33910948,97.6994257906,_100,9,>100
8959,lottery,216,33911164,97.7000480993,_100,7,>100
8960,introduces,216,33911380,97.7006704079,_100,10,>100
8961,railway,216,33911596,97.7012927166,_100,7,>100
8962,adulthood,216,33911812,97.7019150252,_100,9,>100
8963,vitamins,216,33912028,97.7025373338,_100,8,>100
8964,liability,216,33912244,97.7031596425,_100,9,>100
8965,capability,216,33912460,97.7037819511,_100,10,>100
8966,puff,216,33912676,97.7044042598,_100,4,>100
8967,sf,216,33912892,97.7050265684,_100,2,>100
8968,teaspoons,216,33913108,97.705648877,_100,9,>100
8969,jerk,216,33913324,97.7062711857,_100,4,>100
8970,festivities,216,33913540,97.7068934943,_100,11,>100
8971,distribute,216,33913756,97.707515803,_100,10,>100
8972,europeans,216,33913972,97.7081381116,_100,9,>100
8973,mailing,215,33914187,97.7087575392,_100,7,>100
8974,eliminated,215,33914402,97.7093769668,_100,10,>100
8975,flooding,215,33914617,97.7099963944,_100,8,>100
8976,civilian,215,33914832,97.7106158219,_100,8,>100
8977,threatens,215,33915047,97.7112352495,_100,9,>100
8978,explode,215,33915262,97.7118546771,_100,7,>100
8979,powered,215,33915477,97.7124741047,_100,7,>100
8980,nationwide,215,33915692,97.7130935323,_100,10,>100
8981,joins,215,33915907,97.7137129599,_100,5,>100
8982,haircut,215,33916122,97.7143323874,_100,7,>100
8983,urine,215,33916337,97.714951815,_100,5,>100
8984,independently,215,33916552,97.7155712426,_100,13,>100
8985,climax,215,33916767,97.7161906702,_100,6,>100
8986,preparations,215,33916982,97.7168100978,_100,12,>100
8987,vanity,215,33917197,97.7174295253,_100,6,>100
8988,dim,215,33917412,97.7180489529,_100,3,>100
8989,monkeys,215,33917627,97.7186683805,_100,7,>100
8990,hank,215,33917842,97.7192878081,_100,4,>100
8991,nc,215,33918057,97.7199072357,_100,2,>100
8992,discusses,215,33918272,97.7205266633,_100,9,>100
8993,disposal,215,33918487,97.7211460908,_100,8,>100
8994,equity,215,33918702,97.7217655184,_100,6,>100
8995,sterling,214,33918916,97.7223820649,_100,8,>100
8996,fighters,214,33919130,97.7229986115,_100,8,>100
8997,calmly,214,33919344,97.723615158,_100,6,>100
8998,adopting,214,33919558,97.7242317045,_100,8,>100
8999,luther,214,33919772,97.724848251,_100,6,>100
9000,prevents,214,33919986,97.7254647976,_100,8,>100
9001,austerity,214,33920200,97.7260813441,_100,9,>100
9002,disabilities,214,33920414,97.7266978906,_100,12,>100
9003,thicker,214,33920628,97.7273144371,_100,7,>100
9004,arabic,214,33920842,97.7279309837,_100,6,>100
9005,disappears,214,33921056,97.7285475302,_100,10,>100
9006,custard,214,33921270,97.7291640767,_100,7,>100
9007,seminar,214,33921484,97.7297806232,_100,7,>100
9008,hearty,214,33921698,97.7303971698,_100,6,>100
9009,hospitality,214,33921912,97.7310137163,_100,11,>100
9010,womb,214,33922126,97.7316302628,_100,4,>100
9011,desperation,214,33922340,97.7322468093,_100,11,>100
9012,mattress,214,33922554,97.7328633559,_100,8,>100
9013,complimentary,214,33922768,97.7334799024,_100,13,>100
9014,weighing,214,33922982,97.7340964489,_100,8,>100
9015,coating,214,33923196,97.7347129954,_100,7,>100
9016,netflix,214,33923410,97.735329542,_100,7,>100
9017,tablets,214,33923624,97.7359460885,_100,7,>100
9018,oblivious,214,33923838,97.736562635,_100,9,>100
9019,woven,214,33924052,97.7371791815,_100,5,>100
9020,eva,214,33924266,97.7377957281,_100,3,>100
9021,influenza,214,33924480,97.7384122746,_100,9,>100
9022,sunrise,213,33924693,97.73902594,_100,7,>100
9023,listener,213,33924906,97.7396396055,_100,8,>100
9024,bothering,213,33925119,97.740253271,_100,9,>100
9025,notions,213,33925332,97.7408669364,_100,7,>100
9026,flap,213,33925545,97.7414806019,_100,4,>100
9027,anticipate,213,33925758,97.7420942674,_100,10,>100
9028,crab,213,33925971,97.7427079328,_100,4,>100
9029,faults,213,33926184,97.7433215983,_100,6,>100
9030,trait,213,33926397,97.7439352638,_100,5,>100
9031,sept,213,33926610,97.7445489292,_100,4,>100
9032,entirety,213,33926823,97.7451625947,_100,8,>100
9033,confined,213,33927036,97.7457762602,_100,8,>100
9034,transmission,213,33927249,97.7463899256,_100,12,>100
9035,retro,213,33927462,97.7470035911,_100,5,>100
9036,freedoms,213,33927675,97.7476172566,_100,8,>100
9037,depicted,213,33927888,97.748230922,_100,8,>100
9038,dripping,213,33928101,97.7488445875,_100,8,>100
9039,pending,213,33928314,97.749458253,_100,7,>100
9040,violet,213,33928527,97.7500719184,_100,6,>100
9041,buddhist,213,33928740,97.7506855839,_100,8,>100
9042,gladly,213,33928953,97.7512992494,_100,6,>100
9043,contemplating,213,33929166,97.7519129148,_100,13,>100
9044,suburbs,213,33929379,97.7525265803,_100,7,>100
9045,pacing,213,33929592,97.7531402458,_100,6,>100
9046,lanes,213,33929805,97.7537539112,_100,5,>100
9047,halls,213,33930018,97.7543675767,_100,5,>100
9048,dental,213,33930231,97.7549812421,_100,6,>100
9049,wraps,213,33930444,97.7555949076,_100,5,>100
9050,offset,212,33930656,97.756205692,_100,6,>100
9051,lou,212,33930868,97.7568164764,_100,3,>100
9052,ft,212,33931080,97.7574272608,_100,2,>100
9053,leftist,212,33931292,97.7580380452,_100,7,>100
9054,ronald,212,33931504,97.7586488296,_100,6,>100
9055,thriving,212,33931716,97.7592596141,_100,8,>100
9056,astonishing,212,33931928,97.7598703985,_100,11,>100
9057,motive,212,33932140,97.7604811829,_100,6,>100
9058,reed,212,33932352,97.7610919673,_100,4,>100
9059,bailey,212,33932564,97.7617027517,_100,6,>100
9060,optimism,212,33932776,97.7623135361,_100,8,>100
9061,stella,212,33932988,97.7629243205,_100,6,>100
9062,tended,212,33933200,97.7635351049,_100,6,>100
9063,wherein,212,33933412,97.7641458893,_100,7,>100
9064,tornado,212,33933624,97.7647566737,_100,7,>100
9065,eden,212,33933836,97.7653674581,_100,4,>100
9066,nostalgic,212,33934048,97.7659782425,_100,9,>100
9067,maternity,212,33934260,97.7665890269,_100,9,>100
9068,bc,212,33934472,97.7671998113,_100,2,>100
9069,edwards,212,33934684,97.7678105958,_100,7,>100
9070,palestinians,212,33934896,97.7684213802,_100,12,>100
9071,arrests,211,33935107,97.7690292835,_100,7,>100
9072,vendor,211,33935318,97.7696371869,_100,6,>100
9073,tick,211,33935529,97.7702450902,_100,4,>100
9074,bennett,211,33935740,97.7708529936,_100,7,>100
9075,selves,211,33935951,97.7714608969,_100,6,>100
9076,propose,211,33936162,97.7720688003,_100,7,>100
9077,accordance,211,33936373,97.7726767036,_100,10,>100
9078,rambling,211,33936584,97.773284607,_100,8,>100
9079,downward,211,33936795,97.7738925103,_100,8,>100
9080,searches,211,33937006,97.7745004136,_100,8,>100
9081,norman,211,33937217,97.775108317,_100,6,>100
9082,christina,211,33937428,97.7757162203,_100,9,>100
9083,texting,211,33937639,97.7763241237,_100,7,>100
9084,integration,211,33937850,97.776932027,_100,11,>100
9085,cain,211,33938061,97.7775399304,_100,4,>100
9086,remarked,211,33938272,97.7781478337,_100,8,>100
9087,presentations,211,33938483,97.7787557371,_100,13,>100
9088,worthless,211,33938694,97.7793636404,_100,9,>100
9089,sweeter,211,33938905,97.7799715438,_100,7,>100
9090,lays,211,33939116,97.7805794471,_100,4,>100
9091,olds,211,33939327,97.7811873505,_100,4,>100
9092,deceased,210,33939537,97.7817923728,_100,8,>100
9093,waitress,210,33939747,97.7823973951,_100,8,>100
9094,footsteps,210,33939957,97.7830024174,_100,9,>100
9095,vatican,210,33940167,97.7836074396,_100,7,>100
9096,carroll,210,33940377,97.7842124619,_100,7,>100
9097,sustainability,210,33940587,97.7848174842,_100,14,>100
9098,cindy,210,33940797,97.7854225065,_100,5,>100
9099,licensing,210,33941007,97.7860275288,_100,9,>100
9100,mandela,210,33941217,97.7866325511,_100,7,>100
9101,promotional,210,33941427,97.7872375734,_100,11,>100
9102,defendant,210,33941637,97.7878425957,_100,9,>100
9103,suzanne,210,33941847,97.788447618,_100,7,>100
9104,joints,210,33942057,97.7890526403,_100,6,>100
9105,compiled,210,33942267,97.7896576625,_100,8,>100
9106,plunge,210,33942477,97.7902626848,_100,6,>100
9107,pupils,210,33942687,97.7908677071,_100,6,>100
9108,sequences,210,33942897,97.7914727294,_100,9,>100
9109,ratner,210,33943107,97.7920777517,_100,6,>100
9110,accusations,210,33943317,97.792682774,_100,11,>100
9111,flooded,210,33943527,97.7932877963,_100,7,>100
9112,chewing,210,33943737,97.7938928186,_100,7,>100
9113,fundraising,210,33943947,97.7944978409,_100,11,>100
9114,impacts,210,33944157,97.7951028632,_100,7,>100
9115,dreadful,209,33944366,97.7957050044,_100,8,>100
9116,routinely,209,33944575,97.7963071456,_100,9,>100
9117,hugh,209,33944784,97.7969092868,_100,4,>100
9118,demonstrations,209,33944993,97.7975114281,_100,14,>100
9119,seized,209,33945202,97.7981135693,_100,6,>100
9120,mice,209,33945411,97.7987157105,_100,4,>100
9121,gallons,209,33945620,97.7993178518,_100,7,>100
9122,gaza,209,33945829,97.799919993,_100,4,>100
9123,thumbs,209,33946038,97.8005221342,_100,6,>100
9124,eggplant,209,33946247,97.8011242755,_100,8,>100
9125,gothic,209,33946456,97.8017264167,_100,6,>100
9126,poland,209,33946665,97.8023285579,_100,6,>100
9127,dearly,209,33946874,97.8029306992,_100,6,>100
9128,distinguished,209,33947083,97.8035328404,_100,13,>100
9129,tapes,209,33947292,97.8041349816,_100,5,>100
9130,sneaking,209,33947501,97.8047371229,_100,8,>100
9131,compilation,209,33947710,97.8053392641,_100,11,>100
9132,pondering,209,33947919,97.8059414053,_100,9,>100
9133,leslie,209,33948128,97.8065435466,_100,6,>100
9134,veins,209,33948337,97.8071456878,_100,5,>100
9135,scrutiny,209,33948546,97.807747829,_100,8,>100
9136,arrow,209,33948755,97.8083499702,_100,5,>100
9137,explanations,209,33948964,97.8089521115,_100,12,>100
9138,amid,209,33949173,97.8095542527,_100,4,>100
9139,coordinating,209,33949382,97.8101563939,_100,12,>100
9140,conceived,209,33949591,97.8107585352,_100,9,>100
9141,upwards,209,33949800,97.8113606764,_100,7,>100
9142,inherently,209,33950009,97.8119628176,_100,10,>100
9143,pumps,209,33950218,97.8125649589,_100,5,>100
9144,bridal,209,33950427,97.8131671001,_100,6,>100
9145,florence,209,33950636,97.8137692413,_100,8,>100
9146,ferry,209,33950845,97.8143713826,_100,5,>100
9147,copied,208,33951053,97.8149706427,_100,6,>100
9148,declaring,208,33951261,97.8155699029,_100,9,>100
9149,lectures,208,33951469,97.8161691631,_100,8,>100
9150,ruler,208,33951677,97.8167684233,_100,5,>100
9151,chefs,208,33951885,97.8173676834,_100,5,>100
9152,pavement,208,33952093,97.8179669436,_100,8,>100
9153,elusive,208,33952301,97.8185662038,_100,7,>100
9154,transparency,208,33952509,97.8191654639,_100,12,>100
9155,consultation,208,33952717,97.8197647241,_100,12,>100
9156,aluminum,208,33952925,97.8203639843,_100,8,>100
9157,montana,208,33953133,97.8209632445,_100,7,>100
9158,rivals,208,33953341,97.8215625046,_100,6,>100
9159,earthly,208,33953549,97.8221617648,_100,7,>100
9160,blink,208,33953757,97.822761025,_100,5,>100
9161,conception,208,33953965,97.8233602852,_100,10,>100
9162,condo,208,33954173,97.8239595453,_100,5,>100
9163,persona,208,33954381,97.8245588055,_100,7,>100
9164,mildly,208,33954589,97.8251580657,_100,6,>100
9165,offenders,208,33954797,97.8257573258,_100,9,>100
9166,hart,208,33955005,97.826356586,_100,4,>100
9167,poignant,208,33955213,97.8269558462,_100,8,>100
9168,patrons,208,33955421,97.8275551064,_100,7,>100
9169,attorneys,208,33955629,97.8281543665,_100,9,>100
9170,verge,208,33955837,97.8287536267,_100,5,>100
9171,premises,208,33956045,97.8293528869,_100,8,>100
9172,whispers,208,33956253,97.8299521471,_100,8,>100
9173,investigations,208,33956461,97.8305514072,_100,14,>100
9174,intensely,208,33956669,97.8311506674,_100,9,>100
9175,stocks,208,33956877,97.8317499276,_100,6,>100
9176,neon,208,33957085,97.8323491878,_100,4,>100
9177,ultra,208,33957293,97.8329484479,_100,5,>100
9178,internationally,208,33957501,97.8335477081,_100,15,>100
9179,rotation,208,33957709,97.8341469683,_100,8,>100
9180,avery,208,33957917,97.8347462284,_100,5,>100
9181,typed,208,33958125,97.8353454886,_100,5,>100
9182,lacked,208,33958333,97.8359447488,_100,6,>100
9183,gentiles,208,33958541,97.836544009,_100,8,>100
9184,internship,208,33958749,97.8371432691,_100,10,>100
9185,groom,208,33958957,97.8377425293,_100,5,>100
9186,funk,208,33959165,97.8383417895,_100,4,>100
9187,knowledgeable,208,33959373,97.8389410497,_100,13,>100
9188,sparked,207,33959580,97.8395374288,_100,7,>100
9189,soften,207,33959787,97.8401338079,_100,6,>100
9190,allowance,207,33959994,97.840730187,_100,9,>100
9191,poking,207,33960201,97.8413265661,_100,6,>100
9192,capitol,207,33960408,97.8419229452,_100,7,>100
9193,insects,207,33960615,97.8425193243,_100,7,>100
9194,overweight,207,33960822,97.8431157035,_100,10,>100
9195,orphanage,207,33961029,97.8437120826,_100,9,>100
9196,intersection,207,33961236,97.8443084617,_100,12,>100
9197,warehouse,207,33961443,97.8449048408,_100,9,>100
9198,aspirations,207,33961650,97.8455012199,_100,11,>100
9199,deployed,207,33961857,97.846097599,_100,8,>100
9200,janet,207,33962064,97.8466939781,_100,5,>100
9201,des,207,33962271,97.8472903573,_100,3,>100
9202,sphere,207,33962478,97.8478867364,_100,6,>100
9203,volunteered,207,33962685,97.8484831155,_100,11,>100
9204,whitney,207,33962892,97.8490794946,_100,7,>100
9205,chops,207,33963099,97.8496758737,_100,5,>100
9206,regain,207,33963306,97.8502722528,_100,6,>100
9207,whew,207,33963513,97.8508686319,_100,4,>100
9208,filmmakers,207,33963720,97.8514650111,_100,10,>100
9209,finals,207,33963927,97.8520613902,_100,6,>100
9210,oppressed,207,33964134,97.8526577693,_100,9,>100
9211,litter,207,33964341,97.8532541484,_100,6,>100
9212,recognizing,207,33964548,97.8538505275,_100,11,>100
9213,carbs,206,33964754,97.8544440256,_100,5,>100
9214,mickey,206,33964960,97.8550375236,_100,6,>100
9215,agony,206,33965166,97.8556310217,_100,5,>100
9216,afterward,206,33965372,97.8562245197,_100,9,>100
9217,bedrooms,206,33965578,97.8568180178,_100,8,>100
9218,pros,206,33965784,97.8574115159,_100,4,>100
9219,reduces,206,33965990,97.8580050139,_100,7,>100
9220,mormon,206,33966196,97.858598512,_100,6,>100
9221,superman,206,33966402,97.85919201,_100,8,>100
9222,fridays,206,33966608,97.8597855081,_100,7,>100
9223,demographic,206,33966814,97.8603790061,_100,11,>100
9224,hugged,206,33967020,97.8609725042,_100,6,>100
9225,picky,206,33967226,97.8615660022,_100,5,>100
9226,robbery,206,33967432,97.8621595003,_100,7,>100
9227,initiatives,206,33967638,97.8627529984,_100,11,>100
9228,obnoxious,206,33967844,97.8633464964,_100,9,>100
9229,disastrous,206,33968050,97.8639399945,_100,10,>100
9230,outs,206,33968256,97.8645334925,_100,4,>100
9231,paranoid,206,33968462,97.8651269906,_100,8,>100
9232,gm,206,33968668,97.8657204886,_100,2,>100
9233,coriander,206,33968874,97.8663139867,_100,9,>100
9234,pakistani,206,33969080,97.8669074847,_100,9,>100
9235,warriors,206,33969286,97.8675009828,_100,8,>100
9236,wells,206,33969492,97.8680944809,_100,5,>100
9237,greene,206,33969698,97.8686879789,_100,6,>100
9238,photographic,205,33969903,97.8692785959,_100,12,>100
9239,mediocre,205,33970108,97.8698692129,_100,8,>100
9240,roasting,205,33970313,97.8704598299,_100,8,>100
9241,sack,205,33970518,97.8710504469,_100,4,>100
9242,prescribed,205,33970723,97.8716410639,_100,10,>100
9243,grandson,205,33970928,97.8722316809,_100,8,>100
9244,curly,205,33971133,97.8728222979,_100,5,>100
9245,exhaustion,205,33971338,97.8734129149,_100,10,>100
9246,duncan,205,33971543,97.8740035319,_100,6,>100
9247,fatigue,205,33971748,97.8745941489,_100,7,>100
9248,sipping,205,33971953,97.8751847659,_100,7,>100
9249,comprised,205,33972158,97.8757753829,_100,9,>100
9250,arrogance,205,33972363,97.8763659999,_100,9,>100
9251,hostess,205,33972568,97.8769566169,_100,7,>100
9252,gestures,205,33972773,97.8775472339,_100,8,>100
9253,rhyme,205,33972978,97.8781378509,_100,5,>100
9254,maternal,205,33973183,97.8787284679,_100,8,>100
9255,likelihood,205,33973388,97.8793190849,_100,10,>100
9256,tomb,205,33973593,97.8799097019,_100,4,>100
9257,uncommon,205,33973798,97.8805003189,_100,8,>100
9258,coastal,205,33974003,97.8810909359,_100,7,>100
9259,alphabet,205,33974208,97.8816815529,_100,8,>100
9260,irritated,205,33974413,97.8822721699,_100,9,>100
9261,fading,205,33974618,97.8828627869,_100,6,>100
9262,weaker,205,33974823,97.8834534038,_100,6,>100
9263,charms,205,33975028,97.8840440208,_100,6,>100
9264,earnings,205,33975233,97.8846346378,_100,8,>100
9265,dipping,205,33975438,97.8852252548,_100,7,>100
9266,gauge,205,33975643,97.8858158718,_100,5,>100
9267,kirk,205,33975848,97.8864064888,_100,4,>100
9268,saute,205,33976053,97.8869971058,_100,5,>100
9269,dealer,205,33976258,97.8875877228,_100,6,>100
9270,pear,204,33976462,97.8881754588,_100,4,>100
9271,physician,204,33976666,97.8887631947,_100,9,>100
9272,medal,204,33976870,97.8893509306,_100,5,>100
9273,bury,204,33977074,97.8899386666,_100,4,>100
9274,positioned,204,33977278,97.8905264025,_100,10,>100
9275,katherine,204,33977482,97.8911141385,_100,9,>100
9276,downside,204,33977686,97.8917018744,_100,8,>100
9277,whimsical,204,33977890,97.8922896103,_100,9,>100
9278,heartfelt,204,33978094,97.8928773463,_100,9,>100
9279,vent,204,33978298,97.8934650822,_100,4,>100
9280,supporter,204,33978502,97.8940528182,_100,9,>100
9281,orlando,204,33978706,97.8946405541,_100,7,>100
9282,asylum,204,33978910,97.89522829,_100,6,>100
9283,displaying,204,33979114,97.895816026,_100,10,>100
9284,mortality,204,33979318,97.8964037619,_100,9,>100
9285,imported,204,33979522,97.8969914979,_100,8,>100
9286,proclaimed,204,33979726,97.8975792338,_100,10,>100
9287,logan,204,33979930,97.8981669697,_100,5,>100
9288,nagging,204,33980134,97.8987547057,_100,7,>100
9289,celtic,204,33980338,97.8993424416,_100,6,>100
9290,ideological,204,33980542,97.8999301775,_100,11,>100
9291,fairness,204,33980746,97.9005179135,_100,8,>100
9292,elites,204,33980950,97.9011056494,_100,6,>100
9293,fundamentally,204,33981154,97.9016933854,_100,13,>100
9294,wires,204,33981358,97.9022811213,_100,5,>100
9295,initiated,204,33981562,97.9028688572,_100,9,>100
9296,heartbreaking,203,33981765,97.9034537121,_100,13,>100
9297,horizontal,203,33981968,97.904038567,_100,10,>100
9298,verdict,203,33982171,97.9046234219,_100,7,>100
9299,drowning,203,33982374,97.9052082768,_100,8,>100
9300,nate,203,33982577,97.9057931316,_100,4,>100
9301,keeper,203,33982780,97.9063779865,_100,6,>100
9302,excellence,203,33982983,97.9069628414,_100,10,>100
9303,crude,203,33983186,97.9075476963,_100,5,>100
9304,vaccine,203,33983389,97.9081325512,_100,7,>100
9305,obstacle,203,33983592,97.908717406,_100,8,>100
9306,brutally,203,33983795,97.9093022609,_100,8,>100
9307,flashing,203,33983998,97.9098871158,_100,8,>100
9308,kurt,203,33984201,97.9104719707,_100,4,>100
9309,depot,203,33984404,97.9110568256,_100,5,>100
9310,portray,203,33984607,97.9116416804,_100,7,>100
9311,curves,203,33984810,97.9122265353,_100,6,>100
9312,arkansas,203,33985013,97.9128113902,_100,8,>100
9313,warner,203,33985216,97.9133962451,_100,6,>100
9314,cuz,203,33985419,97.9139811,_100,3,>100
9315,rosie,203,33985622,97.9145659548,_100,5,>100
9316,fantasies,203,33985825,97.9151508097,_100,9,>100
9317,deadlines,203,33986028,97.9157356646,_100,9,>100
9318,pal,203,33986231,97.9163205195,_100,3,>100
9319,indicating,203,33986434,97.9169053744,_100,10,>100
9320,capturing,203,33986637,97.9174902293,_100,9,>100
9321,empathy,203,33986840,97.9180750841,_100,7,>100
9322,static,203,33987043,97.918659939,_100,6,>100
9323,watson,203,33987246,97.9192447939,_100,6,>100
9324,fools,203,33987449,97.9198296488,_100,5,>100
9325,stuart,203,33987652,97.9204145037,_100,6,>100
9326,respectful,203,33987855,97.9209993585,_100,10,>100
9327,marching,203,33988058,97.9215842134,_100,8,>100
9328,topps,203,33988261,97.9221690683,_100,5,>100
9329,comparable,202,33988463,97.9227510421,_100,10,>100
9330,sox,202,33988665,97.9233330159,_100,3,>100
9331,transported,202,33988867,97.9239149898,_100,11,>100
9332,impulse,202,33989069,97.9244969636,_100,7,>100
9333,sovereignty,202,33989271,97.9250789374,_100,11,>100
9334,taxpayer,202,33989473,97.9256609112,_100,8,>100
9335,barbecue,202,33989675,97.926242885,_100,8,>100
9336,espresso,202,33989877,97.9268248589,_100,8,>100
9337,goodwill,202,33990079,97.9274068327,_100,8,>100
9338,eclectic,202,33990281,97.9279888065,_100,8,>100
9339,betrayed,202,33990483,97.9285707803,_100,8,>100
9340,bankers,202,33990685,97.9291527542,_100,7,>100
9341,motherhood,202,33990887,97.929734728,_100,10,>100
9342,booking,202,33991089,97.9303167018,_100,7,>100
9343,bullets,202,33991291,97.9308986756,_100,7,>100
9344,milestone,202,33991493,97.9314806494,_100,9,>100
9345,sweating,202,33991695,97.9320626233,_100,8,>100
9346,sandra,202,33991897,97.9326445971,_100,6,>100
9347,conquer,202,33992099,97.9332265709,_100,7,>100
9348,sentenced,201,33992300,97.9338056637,_100,9,>100
9349,taller,201,33992501,97.9343847564,_100,6,>100
9350,invitations,201,33992702,97.9349638492,_100,11,>100
9351,breastfeeding,201,33992903,97.935542942,_100,13,>100
9352,extends,201,33993104,97.9361220347,_100,7,>100
9353,dissolved,201,33993305,97.9367011275,_100,9,>100
9354,debated,201,33993506,97.9372802203,_100,7,>100
9355,plea,201,33993707,97.937859313,_100,4,>100
9356,satin,201,33993908,97.9384384058,_100,5,>100
9357,contests,201,33994109,97.9390174985,_100,8,>100
9358,swings,201,33994310,97.9395965913,_100,6,>100
9359,merchant,201,33994511,97.9401756841,_100,8,>100
9360,subconscious,201,33994712,97.9407547768,_100,12,>100
9361,profoundly,201,33994913,97.9413338696,_100,10,>100
9362,weaving,201,33995114,97.9419129624,_100,7,>100
9363,grim,201,33995315,97.9424920551,_100,4,>100
9364,bleed,201,33995516,97.9430711479,_100,5,>100
9365,alfred,201,33995717,97.9436502406,_100,6,>100
9366,delights,201,33995918,97.9442293334,_100,8,>100
9367,raging,201,33996119,97.9448084262,_100,6,>100
9368,unpredictable,201,33996320,97.9453875189,_100,13,>100
9369,intensive,201,33996521,97.9459666117,_100,9,>100
9370,osama,201,33996722,97.9465457045,_100,5,>100
9371,subscription,201,33996923,97.9471247972,_100,12,>100
9372,salon,201,33997124,97.94770389,_100,5,>100
9373,bombing,201,33997325,97.9482829828,_100,7,>100
9374,routines,201,33997526,97.9488620755,_100,8,>100
9375,chunky,201,33997727,97.9494411683,_100,6,>100
9376,leonard,201,33997928,97.950020261,_100,7,>100
9377,curls,200,33998128,97.9505964727,_100,5,>100
9378,sewn,200,33998328,97.9511726845,_100,4,>100
9379,revenues,200,33998528,97.9517488962,_100,8,>100
9380,taped,200,33998728,97.9523251079,_100,5,>100
9381,honeymoon,200,33998928,97.9529013196,_100,9,>100
9382,saul,200,33999128,97.9534775313,_100,4,>100
9383,circulation,200,33999328,97.954053743,_100,11,>100
9384,bristol,200,33999528,97.9546299547,_100,7,>100
9385,motto,200,33999728,97.9552061664,_100,5,>100
9386,hottest,200,33999928,97.9557823781,_100,7,>100
9387,joyce,200,34000128,97.9563585898,_100,5,>100
9388,virtues,200,34000328,97.9569348015,_100,7,>100
9389,messing,200,34000528,97.9575110132,_100,7,>100
9390,uphill,200,34000728,97.9580872249,_100,6,>100
9391,sudan,200,34000928,97.9586634366,_100,5,>100
9392,emissions,200,34001128,97.9592396483,_100,9,>100
9393,kay,200,34001328,97.95981586,_100,3,>100
9394,refrigerate,200,34001528,97.9603920717,_100,11,>100
9395,coup,200,34001728,97.9609682834,_100,4,>100
9396,denise,200,34001928,97.9615444951,_100,6,>100
9397,hd,200,34002128,97.9621207068,_100,2,>100
9398,disposable,200,34002328,97.9626969185,_100,10,>100
9399,jealousy,200,34002528,97.9632731303,_100,8,>100
9400,priceless,200,34002728,97.963849342,_100,9,>100
9401,knives,200,34002928,97.9644255537,_100,6,>100
9402,200,200,34003128,97.9650017654,_100,3,>100
9403,quo,200,34003328,97.9655779771,_100,3,>100
9404,patches,200,34003528,97.9661541888,_100,7,>100
9405,lamps,200,34003728,97.9667304005,_100,5,>100
9406,daycare,200,34003928,97.9673066122,_100,7,>100
9407,primitive,200,34004128,97.9678828239,_100,9,>100
9408,bouquet,200,34004328,97.9684590356,_100,7,>100
9409,queens,200,34004528,97.9690352473,_100,6,>100
9410,intervals,200,34004728,97.969611459,_100,9,>100
9411,strokes,200,34004928,97.9701876707,_100,7,>100
9412,commanded,200,34005128,97.9707638824,_100,9,>100
9413,potent,199,34005327,97.9713372131,_100,6,>100
9414,boredom,199,34005526,97.9719105437,_100,7,>100
9415,accepts,199,34005725,97.9724838744,_100,7,>100
9416,newton,199,34005924,97.973057205,_100,6,>100
9417,striving,199,34006123,97.9736305356,_100,8,>100
9418,obesity,199,34006322,97.9742038663,_100,7,>100
9419,bp,199,34006521,97.9747771969,_100,2,>100
9420,relevance,199,34006720,97.9753505276,_100,9,>100
9421,jefferson,199,34006919,97.9759238582,_100,9,>100
9422,puzzles,199,34007118,97.9764971889,_100,7,>100
9423,giddy,199,34007317,97.9770705195,_100,5,>100
9424,tory,199,34007516,97.9776438502,_100,4,>100
9425,permits,199,34007715,97.9782171808,_100,7,>100
9426,thereof,199,34007914,97.9787905115,_100,7,>100
9427,styling,199,34008113,97.9793638421,_100,7,>100
9428,coughing,199,34008312,97.9799371728,_100,8,>100
9429,looming,199,34008511,97.9805105034,_100,7,>100
9430,punish,199,34008710,97.981083834,_100,6,>100
9431,focal,199,34008909,97.9816571647,_100,5,>100
9432,conservation,199,34009108,97.9822304953,_100,12,>100
9433,adjacent,199,34009307,97.982803826,_100,8,>100
9434,overlooking,199,34009506,97.9833771566,_100,11,>100
9435,vastly,199,34009705,97.9839504873,_100,6,>100
9436,drip,199,34009904,97.9845238179,_100,4,>100
9437,bathing,199,34010103,97.9850971486,_100,7,>100
9438,creeping,199,34010302,97.9856704792,_100,8,>100
9439,prefers,199,34010501,97.9862438099,_100,7,>100
9440,garment,199,34010700,97.9868171405,_100,7,>100
9441,scares,199,34010899,97.9873904712,_100,6,>100
9442,inadequate,199,34011098,97.9879638018,_100,10,>100
9443,pajamas,199,34011297,97.9885371325,_100,7,>100
9444,dock,198,34011495,97.989107582,_100,4,>100
9445,cheddar,198,34011693,97.9896780316,_100,7,>100
9446,vomit,198,34011891,97.9902484812,_100,5,>100
9447,uniforms,198,34012089,97.9908189308,_100,8,>100
9448,fiery,198,34012287,97.9913893804,_100,5,>100
9449,zones,198,34012485,97.99195983,_100,5,>100
9450,imply,198,34012683,97.9925302796,_100,5,>100
9451,jewellery,198,34012881,97.9931007292,_100,9,>100
9452,strap,198,34013079,97.9936711787,_100,5,>100
9453,toby,198,34013277,97.9942416283,_100,4,>100
9454,coping,198,34013475,97.9948120779,_100,6,>100
9455,slips,198,34013673,97.9953825275,_100,5,>100
9456,creep,198,34013871,97.9959529771,_100,5,>100
9457,qaeda,198,34014069,97.9965234267,_100,5,>100
9458,reactor,198,34014267,97.9970938763,_100,7,>100
9459,addict,198,34014465,97.9976643259,_100,6,>100
9460,clerk,198,34014663,97.9982347754,_100,5,>100
9461,murderer,198,34014861,97.998805225,_100,8,>100
9462,manufactured,198,34015059,97.9993756746,_100,12,>100
9463,scratching,198,34015257,97.9999461242,_100,10,>100
9464,beta,198,34015455,98.0005165738,_100,4,>100
9465,bamboo,198,34015653,98.0010870234,_100,6,>100
9466,electoral,198,34015851,98.001657473,_100,9,>100
9467,brenda,198,34016049,98.0022279226,_100,6,>100
9468,nasa,198,34016247,98.0027983721,_100,4,>100
9469,vienna,198,34016445,98.0033688217,_100,6,>100
9470,consecutive,198,34016643,98.0039392713,_100,11,>100
9471,rays,198,34016841,98.0045097209,_100,4,>100
9472,sighed,198,34017039,98.0050801705,_100,6,>100
9473,horrified,198,34017237,98.0056506201,_100,9,>100
9474,bows,198,34017435,98.0062210697,_100,4,>100
9475,brightly,198,34017633,98.0067915193,_100,8,>100
9476,wolves,198,34017831,98.0073619688,_100,6,>100
9477,rap,198,34018029,98.0079324184,_100,3,>100
9478,disneyland,198,34018227,98.008502868,_100,10,>100
9479,staggering,197,34018424,98.0090704366,_100,10,>100
9480,contemplate,197,34018621,98.0096380051,_100,11,>100
9481,zuma,197,34018818,98.0102055736,_100,4,>100
9482,hughes,197,34019015,98.0107731421,_100,6,>100
9483,arose,197,34019212,98.0113407107,_100,5,>100
9484,swiftly,197,34019409,98.0119082792,_100,7,>100
9485,underway,197,34019606,98.0124758477,_100,8,>100
9486,composer,197,34019803,98.0130434163,_100,8,>100
9487,targeting,197,34020000,98.0136109848,_100,9,>100
9488,sharon,197,34020197,98.0141785533,_100,6,>100
9489,trinity,197,34020394,98.0147461218,_100,7,>100
9490,grieving,197,34020591,98.0153136904,_100,8,>100
9491,plight,197,34020788,98.0158812589,_100,6,>100
9492,travis,197,34020985,98.0164488274,_100,6,>100
9493,flush,197,34021182,98.017016396,_100,5,>100
9494,naughty,197,34021379,98.0175839645,_100,7,>100
9495,prestigious,197,34021576,98.018151533,_100,11,>100
9496,snakes,197,34021773,98.0187191015,_100,6,>100
9497,funniest,197,34021970,98.0192866701,_100,8,>100
9498,softer,197,34022167,98.0198542386,_100,6,>100
9499,arises,197,34022364,98.0204218071,_100,6,>100
9500,ski,197,34022561,98.0209893757,_100,3,>100
9501,addictive,197,34022758,98.0215569442,_100,9,>100
9502,envelopes,197,34022955,98.0221245127,_100,9,>100
9503,miraculous,197,34023152,98.0226920813,_100,10,>100
9504,goofy,197,34023349,98.0232596498,_100,5,>100
9505,brushes,197,34023546,98.0238272183,_100,7,>100
9506,tuna,196,34023742,98.0243919058,_100,4,>100
9507,vine,196,34023938,98.0249565933,_100,4,>100
9508,enduring,196,34024134,98.0255212807,_100,8,>100
9509,forgiving,196,34024330,98.0260859682,_100,9,>100
9510,cbs,196,34024526,98.0266506557,_100,3,>100
9511,vest,196,34024722,98.0272153431,_100,4,>100
9512,penn,196,34024918,98.0277800306,_100,4,>100
9513,unusually,196,34025114,98.0283447181,_100,9,>100
9514,bulbs,196,34025310,98.0289094055,_100,5,>100
9515,gravel,196,34025506,98.029474093,_100,6,>100
9516,nobel,196,34025702,98.0300387805,_100,5,>100
9517,joey,196,34025898,98.030603468,_100,4,>100
9518,bankruptcy,196,34026094,98.0311681554,_100,10,>100
9519,martial,196,34026290,98.0317328429,_100,7,>100
9520,extras,196,34026486,98.0322975304,_100,6,>100
9521,cheltenham,196,34026682,98.0328622178,_100,10,>100
9522,explicitly,196,34026878,98.0334269053,_100,10,>100
9523,stan,196,34027074,98.0339915928,_100,4,>100
9524,grad,196,34027270,98.0345562803,_100,4,>100
9525,manga,196,34027466,98.0351209677,_100,5,>100
9526,kenny,196,34027662,98.0356856552,_100,5,>100
9527,pitcher,196,34027858,98.0362503427,_100,7,>100
9528,lending,196,34028054,98.0368150301,_100,7,>100
9529,gigs,196,34028250,98.0373797176,_100,4,>100
9530,reproductive,196,34028446,98.0379444051,_100,12,>100
9531,aching,196,34028642,98.0385090925,_100,6,>100
9532,particles,196,34028838,98.03907378,_100,9,>100
9533,swollen,196,34029034,98.0396384675,_100,7,>100
9534,marketplace,196,34029230,98.040203155,_100,11,>100
9535,interface,196,34029426,98.0407678424,_100,9,>100
9536,pumped,195,34029621,98.0413296488,_100,6,>100
9537,wii,195,34029816,98.0418914553,_100,3,>100
9538,counseling,195,34030011,98.0424532617,_100,10,>100
9539,sensitivity,195,34030206,98.0430150681,_100,11,>100
9540,wheelchair,195,34030401,98.0435768745,_100,10,>100
9541,disasters,195,34030596,98.0441386809,_100,9,>100
9542,revision,195,34030791,98.0447004873,_100,8,>100
9543,declining,195,34030986,98.0452622937,_100,9,>100
9544,mediterranean,195,34031181,98.0458241001,_100,13,>100
9545,graduating,195,34031376,98.0463859066,_100,10,>100
9546,demonstrating,195,34031571,98.046947713,_100,13,>100
9547,humidity,195,34031766,98.0475095194,_100,8,>100
9548,respectable,195,34031961,98.0480713258,_100,11,>100
9549,fatty,195,34032156,98.0486331322,_100,5,>100
9550,metres,195,34032351,98.0491949386,_100,6,>100
9551,reservation,195,34032546,98.049756745,_100,11,>100
9552,kettle,195,34032741,98.0503185514,_100,6,>100
9553,shimmer,195,34032936,98.0508803579,_100,7,>100
9554,sewed,195,34033131,98.0514421643,_100,5,>100
9555,cinematic,195,34033326,98.0520039707,_100,9,>100
9556,groove,195,34033521,98.0525657771,_100,6,>100
9557,curb,195,34033716,98.0531275835,_100,4,>100
9558,hypocrisy,195,34033911,98.0536893899,_100,9,>100
9559,richer,195,34034106,98.0542511963,_100,6,>100
9560,jude,195,34034301,98.0548130027,_100,4,>100
9561,relaxation,195,34034496,98.0553748091,_100,10,>100
9562,cds,195,34034691,98.0559366156,_100,3,>100
9563,relentless,195,34034886,98.056498422,_100,10,>100
9564,exposing,194,34035080,98.0570573473,_100,8,>100
9565,bowling,194,34035274,98.0576162727,_100,7,>100
9566,dora,194,34035468,98.058175198,_100,4,>100
9567,shaken,194,34035662,98.0587341234,_100,6,>100
9568,receiver,194,34035856,98.0592930487,_100,8,>100
9569,locks,194,34036050,98.0598519741,_100,5,>100
9570,consult,194,34036244,98.0604108994,_100,7,>100
9571,collectively,194,34036438,98.0609698248,_100,12,>100
9572,eccentric,194,34036632,98.0615287502,_100,9,>100
9573,tapping,194,34036826,98.0620876755,_100,7,>100
9574,tee,194,34037020,98.0626466009,_100,3,>100
9575,slippery,194,34037214,98.0632055262,_100,8,>100
9576,submitting,194,34037408,98.0637644516,_100,10,>100
9577,tow,194,34037602,98.0643233769,_100,3,>100
9578,nora,194,34037796,98.0648823023,_100,4,>100
9579,pam,194,34037990,98.0654412276,_100,3,>100
9580,traced,194,34038184,98.066000153,_100,6,>100
9581,angst,194,34038378,98.0665590783,_100,5,>100
9582,cuban,194,34038572,98.0671180037,_100,5,>100
9583,nutritional,194,34038766,98.067676929,_100,11,>100
9584,baths,194,34038960,98.0682358544,_100,5,>100
9585,twenties,194,34039154,98.0687947798,_100,8,>100
9586,davies,194,34039348,98.0693537051,_100,6,>100
9587,regrets,194,34039542,98.0699126305,_100,7,>100
9588,explicit,194,34039736,98.0704715558,_100,8,>100
9589,sugars,194,34039930,98.0710304812,_100,6,>100
9590,rebuild,194,34040124,98.0715894065,_100,7,>100
9591,preached,194,34040318,98.0721483319,_100,8,>100
9592,budgets,194,34040512,98.0727072572,_100,7,>100
9593,bastard,194,34040706,98.0732661826,_100,7,>100
9594,greased,194,34040900,98.0738251079,_100,7,>100
9595,mechanics,194,34041094,98.0743840333,_100,9,>100
9596,editions,194,34041288,98.0749429586,_100,8,>100
9597,owed,193,34041481,98.0754990029,_100,4,>100
9598,eventual,193,34041674,98.0760550472,_100,8,>100
9599,ripping,193,34041867,98.0766110915,_100,7,>100
9600,feather,193,34042060,98.0771671358,_100,7,>100
9601,charities,193,34042253,98.0777231801,_100,9,>100
9602,pti,193,34042446,98.0782792244,_100,3,>100
9603,tendencies,193,34042639,98.0788352687,_100,10,>100
9604,chore,193,34042832,98.079391313,_100,5,>100
9605,quinoa,193,34043025,98.0799473573,_100,6,>100
9606,bronze,193,34043218,98.0805034016,_100,6,>100
9607,scales,193,34043411,98.0810594459,_100,6,>100
9608,buns,193,34043604,98.0816154902,_100,4,>100
9609,drowned,193,34043797,98.0821715345,_100,7,>100
9610,rusty,193,34043990,98.0827275788,_100,5,>100
9611,hindu,193,34044183,98.0832836231,_100,5,>100
9612,vaccination,193,34044376,98.0838396674,_100,11,>100
9613,jackets,193,34044569,98.0843957117,_100,7,>100
9614,villains,193,34044762,98.084951756,_100,8,>100
9615,md,193,34044955,98.0855078002,_100,2,>100
9616,plaza,193,34045148,98.0860638445,_100,5,>100
9617,operator,193,34045341,98.0866198888,_100,8,>100
9618,jeffrey,193,34045534,98.0871759331,_100,7,>100
9619,slammed,193,34045727,98.0877319774,_100,7,>100
9620,calf,193,34045920,98.0882880217,_100,4,>100
9621,liberties,192,34046112,98.088841185,_100,9,>100
9622,gypsy,192,34046304,98.0893943482,_100,5,>100
9623,vietnamese,192,34046496,98.0899475114,_100,10,>100
9624,palestine,192,34046688,98.0905006747,_100,9,>100
9625,enlightenment,192,34046880,98.0910538379,_100,13,>100
9626,effectiveness,192,34047072,98.0916070011,_100,13,>100
9627,threshold,192,34047264,98.0921601644,_100,9,>100
9628,detect,192,34047456,98.0927133276,_100,6,>100
9629,announcements,192,34047648,98.0932664909,_100,13,>100
9630,prof,192,34047840,98.0938196541,_100,4,>100
9631,parental,192,34048032,98.0943728173,_100,8,>100
9632,determining,192,34048224,98.0949259806,_100,11,>100
9633,ditch,192,34048416,98.0954791438,_100,5,>100
9634,adored,192,34048608,98.096032307,_100,6,>100
9635,refrain,192,34048800,98.0965854703,_100,7,>100
9636,purity,192,34048992,98.0971386335,_100,6,>100
9637,lung,192,34049184,98.0976917967,_100,4,>100
9638,solidarity,192,34049376,98.09824496,_100,10,>100
9639,viral,192,34049568,98.0987981232,_100,5,>100
9640,chad,192,34049760,98.0993512865,_100,4,>100
9641,exaggerated,192,34049952,98.0999044497,_100,11,>100
9642,disappearing,192,34050144,98.1004576129,_100,12,>100
9643,vaccines,192,34050336,98.1010107762,_100,8,>100
9644,await,192,34050528,98.1015639394,_100,5,>100
9645,oriented,192,34050720,98.1021171026,_100,8,>100
9646,thief,191,34050911,98.1026673848,_100,5,>100
9647,breeding,191,34051102,98.103217667,_100,8,>100
9648,premiere,191,34051293,98.1037679492,_100,8,>100
9649,spun,191,34051484,98.1043182314,_100,4,>100
9650,brow,191,34051675,98.1048685135,_100,4,>100
9651,pecans,191,34051866,98.1054187957,_100,6,>100
9652,glen,191,34052057,98.1059690779,_100,4,>100
9653,wwii,191,34052248,98.1065193601,_100,4,>100
9654,commissioner,191,34052439,98.1070696422,_100,12,>100
9655,kitten,191,34052630,98.1076199244,_100,6,>100
9656,sentimental,191,34052821,98.1081702066,_100,11,>100
9657,boer,191,34053012,98.1087204888,_100,4,>100
9658,violin,191,34053203,98.109270771,_100,6,>100
9659,surfing,191,34053394,98.1098210531,_100,7,>100
9660,stupidity,191,34053585,98.1103713353,_100,9,>100
9661,gdp,191,34053776,98.1109216175,_100,3,>100
9662,imminent,191,34053967,98.1114718997,_100,8,>100
9663,outward,191,34054158,98.1120221818,_100,7,>100
9664,cs,191,34054349,98.112572464,_100,2,>100
9665,itching,191,34054540,98.1131227462,_100,7,>100
9666,oakland,191,34054731,98.1136730284,_100,7,>100
9667,deed,191,34054922,98.1142233106,_100,4,>100
9668,distracting,191,34055113,98.1147735927,_100,11,>100
9669,obliged,191,34055304,98.1153238749,_100,7,>100
9670,facilitate,191,34055495,98.1158741571,_100,10,>100
9671,spilled,191,34055686,98.1164244393,_100,7,>100
9672,revelations,191,34055877,98.1169747214,_100,11,>100
9673,appealed,191,34056068,98.1175250036,_100,8,>100
9674,originated,190,34056258,98.1180724047,_100,10,>100
9675,promotes,190,34056448,98.1186198059,_100,8,>100
9676,inferior,190,34056638,98.119167207,_100,8,>100
9677,bernard,190,34056828,98.1197146081,_100,7,>100
9678,butler,190,34057018,98.1202620092,_100,6,>100
9679,ensemble,190,34057208,98.1208094103,_100,8,>100
9680,mondays,190,34057398,98.1213568115,_100,7,>100
9681,maid,190,34057588,98.1219042126,_100,4,>100
9682,bumps,190,34057778,98.1224516137,_100,5,>100
9683,northwest,190,34057968,98.1229990148,_100,9,>100
9684,solitary,190,34058158,98.1235464159,_100,8,>100
9685,pursued,190,34058348,98.1240938171,_100,7,>100
9686,tweeted,190,34058538,98.1246412182,_100,7,>100
9687,creators,190,34058728,98.1251886193,_100,8,>100
9688,rampant,190,34058918,98.1257360204,_100,7,>100
9689,biology,190,34059108,98.1262834215,_100,7,>100
9690,dimensional,190,34059298,98.1268308227,_100,11,>100
9691,proclaim,190,34059488,98.1273782238,_100,8,>100
9692,thereafter,190,34059678,98.1279256249,_100,10,>100
9693,condemn,190,34059868,98.128473026,_100,7,>100
9694,capitalist,190,34060058,98.1290204271,_100,10,>100
9695,predictions,190,34060248,98.1295678283,_100,11,>100
9696,catchy,190,34060438,98.1301152294,_100,6,>100
9697,profitable,190,34060628,98.1306626305,_100,10,>100
9698,derby,190,34060818,98.1312100316,_100,5,>100
9699,danish,190,34061008,98.1317574327,_100,6,>100
9700,heap,190,34061198,98.1323048339,_100,4,>100
9701,riches,190,34061388,98.132852235,_100,6,>100
9702,recalls,190,34061578,98.1333996361,_100,7,>100
9703,sanctuary,190,34061768,98.1339470372,_100,9,>100
9704,prophecy,190,34061958,98.1344944383,_100,8,>100
9705,loading,190,34062148,98.1350418395,_100,7,>100
9706,manifestation,189,34062337,98.1355863595,_100,13,>100
9707,respects,189,34062526,98.1361308796,_100,8,>100
9708,tx,189,34062715,98.1366753996,_100,2,>100
9709,timber,189,34062904,98.1372199197,_100,6,>100
9710,applicable,189,34063093,98.1377644398,_100,10,>100
9711,commute,189,34063282,98.1383089598,_100,7,>100
9712,roar,189,34063471,98.1388534799,_100,4,>100
9713,unconditional,189,34063660,98.1393979999,_100,13,>100
9714,formally,189,34063849,98.13994252,_100,8,>100
9715,ie,189,34064038,98.1404870401,_100,2,>100
9716,restless,189,34064227,98.1410315601,_100,8,>100
9717,cos,189,34064416,98.1415760802,_100,3,>100
9718,horns,189,34064605,98.1421206002,_100,5,>100
9719,corrected,189,34064794,98.1426651203,_100,9,>100
9720,phd,189,34064983,98.1432096404,_100,3,>100
9721,sarcastic,189,34065172,98.1437541604,_100,9,>100
9722,swirling,188,34065360,98.1442957994,_100,8,>100
9723,hiatus,188,34065548,98.1448374384,_100,6,>100
9724,exploit,188,34065736,98.1453790774,_100,7,>100
9725,herbal,188,34065924,98.1459207164,_100,6,>100
9726,supplement,188,34066112,98.1464623554,_100,10,>100
9727,shotgun,188,34066300,98.1470039944,_100,7,>100
9728,efficiently,188,34066488,98.1475456334,_100,11,>100
9729,recreate,188,34066676,98.1480872724,_100,8,>100
9730,pledge,188,34066864,98.1486289115,_100,6,>100
9731,defended,188,34067052,98.1491705505,_100,8,>100
9732,theaters,188,34067240,98.1497121895,_100,8,>100
9733,workforce,188,34067428,98.1502538285,_100,9,>100
9734,gritty,188,34067616,98.1507954675,_100,6,>100
9735,trendy,188,34067804,98.1513371065,_100,6,>100
9736,advertised,188,34067992,98.1518787455,_100,10,>100
9737,piping,188,34068180,98.1524203845,_100,6,>100
9738,transactions,188,34068368,98.1529620235,_100,12,>100
9739,ecstatic,188,34068556,98.1535036625,_100,8,>100
9740,lick,188,34068744,98.1540453015,_100,4,>100
9741,lemons,188,34068932,98.1545869405,_100,6,>100
9742,giggling,188,34069120,98.1551285795,_100,8,>100
9743,rev,188,34069308,98.1556702185,_100,3,>100
9744,relied,188,34069496,98.1562118575,_100,6,>100
9745,mastered,188,34069684,98.1567534965,_100,8,>100
9746,peeps,188,34069872,98.1572951355,_100,5,>100
9747,dvds,188,34070060,98.1578367745,_100,4,>100
9748,landscapes,188,34070248,98.1583784135,_100,10,>100
9749,bittersweet,188,34070436,98.1589200525,_100,11,>100
9750,hebrews,188,34070624,98.1594616915,_100,7,>100
9751,allergic,188,34070812,98.1600033305,_100,8,>100
9752,rests,188,34071000,98.1605449695,_100,5,>100
9753,phenomena,187,34071187,98.1610837275,_100,9,>100
9754,tapped,187,34071374,98.1616224854,_100,6,>100
9755,parish,187,34071561,98.1621612433,_100,6,>100
9756,imaginative,187,34071748,98.1627000013,_100,11,>100
9757,bind,187,34071935,98.1632387592,_100,4,>100
9758,worms,187,34072122,98.1637775172,_100,5,>100
9759,conjunction,187,34072309,98.1643162751,_100,11,>100
9760,distinctly,187,34072496,98.1648550331,_100,10,>100
9761,bunnies,187,34072683,98.165393791,_100,7,>100
9762,protestant,187,34072870,98.1659325489,_100,10,>100
9763,breathed,187,34073057,98.1664713069,_100,8,>100
9764,icelandic,187,34073244,98.1670100648,_100,9,>100
9765,midwife,187,34073431,98.1675488228,_100,7,>100
9766,hugo,187,34073618,98.1680875807,_100,4,>100
9767,steering,187,34073805,98.1686263387,_100,8,>100
9768,columns,187,34073992,98.1691650966,_100,7,>100
9769,pagan,187,34074179,98.1697038546,_100,5,>100
9770,melts,187,34074366,98.1702426125,_100,5,>100
9771,equals,187,34074553,98.1707813704,_100,6,>100
9772,stocking,187,34074740,98.1713201284,_100,8,>100
9773,apologized,187,34074927,98.1718588863,_100,10,>100
9774,plausible,187,34075114,98.1723976443,_100,9,>100
9775,stumbling,187,34075301,98.1729364022,_100,9,>100
9776,nurture,187,34075488,98.1734751602,_100,7,>100
9777,turmoil,187,34075675,98.1740139181,_100,7,>100
9778,meats,187,34075862,98.174552676,_100,5,>100
9779,eugene,187,34076049,98.175091434,_100,6,>100
9780,geared,187,34076236,98.1756301919,_100,6,>100
9781,stride,187,34076423,98.1761689499,_100,6,>100
9782,hiv,187,34076610,98.1767077078,_100,3,>100
9783,endurance,187,34076797,98.1772464658,_100,9,>100
9784,biscuit,187,34076984,98.1777852237,_100,7,>100
9785,flea,187,34077171,98.1783239817,_100,4,>100
9786,voluntary,187,34077358,98.1788627396,_100,9,>100
9787,remark,186,34077544,98.1793986165,_100,6,>100
9788,lesbian,186,34077730,98.1799344934,_100,7,>100
9789,imprint,186,34077916,98.1804703703,_100,7,>100
9790,mounting,186,34078102,98.1810062471,_100,8,>100
9791,finn,186,34078288,98.181542124,_100,4,>100
9792,beam,186,34078474,98.1820780009,_100,4,>100
9793,memphis,186,34078660,98.1826138778,_100,7,>100
9794,blades,186,34078846,98.1831497547,_100,6,>100
9795,guinness,186,34079032,98.1836856316,_100,8,>100
9796,reversed,186,34079218,98.1842215085,_100,8,>100
9797,puppies,186,34079404,98.1847573853,_100,7,>100
9798,freshman,186,34079590,98.1852932622,_100,8,>100
9799,weighs,186,34079776,98.1858291391,_100,6,>100
9800,dorothy,186,34079962,98.186365016,_100,7,>100
9801,leak,186,34080148,98.1869008929,_100,4,>100
9802,articulate,186,34080334,98.1874367698,_100,10,>100
9803,antics,186,34080520,98.1879726467,_100,6,>100
9804,selecting,186,34080706,98.1885085235,_100,9,>100
9805,thinly,186,34080892,98.1890444004,_100,6,>100
9806,coolest,186,34081078,98.1895802773,_100,7,>100
9807,freebie,186,34081264,98.1901161542,_100,7,>100
9808,audrey,186,34081450,98.1906520311,_100,6,>100
9809,packaged,186,34081636,98.191187908,_100,8,>100
9810,render,186,34081822,98.1917237849,_100,6,>100
9811,mansion,186,34082008,98.1922596617,_100,7,>100
9812,baptism,186,34082194,98.1927955386,_100,7,>100
9813,raced,186,34082380,98.1933314155,_100,5,>100
9814,lice,186,34082566,98.1938672924,_100,4,>100
9815,czech,186,34082752,98.1944031693,_100,5,>100
9816,eighteen,186,34082938,98.1949390462,_100,8,>100
9817,substantially,186,34083124,98.1954749231,_100,13,>100
9818,worldview,186,34083310,98.1960107999,_100,9,>100
9819,flavored,186,34083496,98.1965466768,_100,8,>100
9820,offence,186,34083682,98.1970825537,_100,7,>100
9821,peru,185,34083867,98.1976155495,_100,4,>100
9822,filthy,185,34084052,98.1981485454,_100,6,>100
9823,informal,185,34084237,98.1986815412,_100,8,>100
9824,skype,185,34084422,98.199214537,_100,5,>100
9825,housed,185,34084607,98.1997475328,_100,6,>100
9826,variable,185,34084792,98.2002805287,_100,8,>100
9827,salted,185,34084977,98.2008135245,_100,6,>100
9828,decidedly,185,34085162,98.2013465203,_100,9,>100
9829,raymond,185,34085347,98.2018795161,_100,7,>100
9830,cranky,185,34085532,98.202412512,_100,6,>100
9831,relish,185,34085717,98.2029455078,_100,6,>100
9832,privately,185,34085902,98.2034785036,_100,9,>100
9833,crushing,185,34086087,98.2040114995,_100,8,>100
9834,adhered,185,34086272,98.2045444953,_100,7,>100
9835,debris,185,34086457,98.2050774911,_100,6,>100
9836,rained,185,34086642,98.2056104869,_100,6,>100
9837,disguise,185,34086827,98.2061434828,_100,8,>100
9838,singh,185,34087012,98.2066764786,_100,5,>100
9839,ephesians,185,34087197,98.2072094744,_100,9,>100
9840,bloke,185,34087382,98.2077424702,_100,5,>100
9841,freed,185,34087567,98.2082754661,_100,5,>100
9842,sinners,185,34087752,98.2088084619,_100,7,>100
9843,calvin,185,34087937,98.2093414577,_100,6,>100
9844,meg,185,34088122,98.2098744536,_100,3,>100
9845,bartender,185,34088307,98.2104074494,_100,9,>100
9846,perpetual,185,34088492,98.2109404452,_100,9,>100
9847,speeding,185,34088677,98.211473441,_100,8,>100
9848,torch,185,34088862,98.2120064369,_100,5,>100
9849,stains,185,34089047,98.2125394327,_100,6,>100
9850,spokesperson,185,34089232,98.2130724285,_100,12,>100
9851,connecticut,185,34089417,98.2136054243,_100,11,>100
9852,traumatic,185,34089602,98.2141384202,_100,9,>100
9853,bum,185,34089787,98.214671416,_100,3,>100
9854,insisting,185,34089972,98.2152044118,_100,9,>100
9855,chipboard,185,34090157,98.2157374076,_100,9,>100
9856,conditioned,185,34090342,98.2162704035,_100,11,>100
9857,noses,185,34090527,98.2168033993,_100,5,>100
9858,donating,184,34090711,98.2173335141,_100,8,>100
9859,blatant,184,34090895,98.2178636288,_100,7,>100
9860,export,184,34091079,98.2183937436,_100,6,>100
9861,arse,184,34091263,98.2189238584,_100,4,>100
9862,carriage,184,34091447,98.2194539731,_100,8,>100
9863,hamas,184,34091631,98.2199840879,_100,5,>100
9864,understatement,184,34091815,98.2205142027,_100,14,>100
9865,sloppy,184,34091999,98.2210443175,_100,6,>100
9866,skating,184,34092183,98.2215744322,_100,7,>100
9867,disregard,184,34092367,98.222104547,_100,9,>100
9868,harmless,184,34092551,98.2226346618,_100,8,>100
9869,summers,184,34092735,98.2231647765,_100,7,>100
9870,hampshire,184,34092919,98.2236948913,_100,9,>100
9871,shove,184,34093103,98.2242250061,_100,5,>100
9872,chanting,184,34093287,98.2247551208,_100,8,>100
9873,monroe,184,34093471,98.2252852356,_100,6,>100
9874,recognizes,184,34093655,98.2258153504,_100,10,>100
9875,repairs,184,34093839,98.2263454651,_100,7,>100
9876,scripts,184,34094023,98.2268755799,_100,7,>100
9877,listens,184,34094207,98.2274056947,_100,7,>100
9878,attendees,184,34094391,98.2279358094,_100,9,>100
9879,incomplete,184,34094575,98.2284659242,_100,10,>100
9880,sideways,184,34094759,98.228996039,_100,8,>100
9881,browser,184,34094943,98.2295261537,_100,7,>100
9882,diameter,184,34095127,98.2300562685,_100,8,>100
9883,decreased,184,34095311,98.2305863833,_100,9,>100
9884,sting,184,34095495,98.2311164981,_100,5,>100
9885,visa,184,34095679,98.2316466128,_100,4,>100
9886,persecution,184,34095863,98.2321767276,_100,11,>100
9887,quiz,184,34096047,98.2327068424,_100,4,>100
9888,skins,184,34096231,98.2332369571,_100,5,>100
9889,mae,184,34096415,98.2337670719,_100,3,>100
9890,ac,184,34096599,98.2342971867,_100,2,>100
9891,spiders,183,34096782,98.2348244204,_100,7,>100
9892,ruthless,183,34096965,98.2353516541,_100,8,>100
9893,uplifting,183,34097148,98.2358788878,_100,9,>100
9894,drought,183,34097331,98.2364061215,_100,7,>100
9895,neighbourhood,183,34097514,98.2369333552,_100,13,>100
9896,yearly,183,34097697,98.2374605889,_100,6,>100
9897,recommends,183,34097880,98.2379878226,_100,10,>100
9898,adrian,183,34098063,98.2385150563,_100,6,>100
9899,hesitation,183,34098246,98.23904229,_100,10,>100
9900,corridor,183,34098429,98.2395695238,_100,8,>100
9901,uploaded,183,34098612,98.2400967575,_100,8,>100
9902,adverse,183,34098795,98.2406239912,_100,7,>100
9903,saddle,183,34098978,98.2411512249,_100,6,>100
9904,youthful,183,34099161,98.2416784586,_100,8,>100
9905,confirms,183,34099344,98.2422056923,_100,8,>100
9906,notch,183,34099527,98.242732926,_100,5,>100
9907,inequality,183,34099710,98.2432601597,_100,10,>100
9908,corresponding,183,34099893,98.2437873934,_100,13,>100
9909,reserves,183,34100076,98.2443146271,_100,8,>100
9910,bodily,183,34100259,98.2448418609,_100,6,>100
9911,witches,183,34100442,98.2453690946,_100,7,>100
9912,earl,183,34100625,98.2458963283,_100,4,>100
9913,den,183,34100808,98.246423562,_100,3,>100
9914,kat,183,34100991,98.2469507957,_100,3,>100
9915,wary,183,34101174,98.2474780294,_100,4,>100
9916,chanel,183,34101357,98.2480052631,_100,6,>100
9917,simplest,183,34101540,98.2485324968,_100,8,>100
9918,valentines,183,34101723,98.2490597305,_100,10,>100
9919,profiles,183,34101906,98.2495869642,_100,8,>100
9920,headaches,182,34102088,98.2501113169,_100,9,>100
9921,ranking,182,34102270,98.2506356696,_100,7,>100
9922,homage,182,34102452,98.2511600222,_100,6,>100
9923,populated,182,34102634,98.2516843749,_100,9,>100
9924,scheduling,182,34102816,98.2522087275,_100,10,>100
9925,gadgets,182,34102998,98.2527330802,_100,7,>100
9926,heed,182,34103180,98.2532574328,_100,4,>100
9927,liar,182,34103362,98.2537817855,_100,4,>100
9928,organizers,182,34103544,98.2543061381,_100,10,>100
9929,ornament,182,34103726,98.2548304908,_100,8,>100
9930,fats,182,34103908,98.2553548434,_100,4,>100
9931,edgar,182,34104090,98.2558791961,_100,5,>100
9932,tacos,182,34104272,98.2564035487,_100,5,>100
9933,academics,182,34104454,98.2569279014,_100,9,>100
9934,proposition,182,34104636,98.257452254,_100,11,>100
9935,terrain,182,34104818,98.2579766067,_100,7,>100
9936,generator,182,34105000,98.2585009593,_100,9,>100
9937,trophy,182,34105182,98.259025312,_100,6,>100
9938,insanely,182,34105364,98.2595496646,_100,8,>100
9939,combines,182,34105546,98.2600740173,_100,8,>100
9940,journaling,182,34105728,98.2605983699,_100,10,>100
9941,stool,182,34105910,98.2611227226,_100,5,>100
9942,branded,181,34106091,98.2616441942,_100,7,>100
9943,fullness,181,34106272,98.2621656658,_100,8,>100
9944,courageous,181,34106453,98.2626871374,_100,10,>100
9945,trusty,181,34106634,98.2632086089,_100,6,>100
9946,thickness,181,34106815,98.2637300805,_100,9,>100
9947,chemo,181,34106996,98.2642515521,_100,5,>100
9948,willie,181,34107177,98.2647730237,_100,6,>100
9949,thirst,181,34107358,98.2652944953,_100,6,>100
9950,coherent,181,34107539,98.2658159669,_100,8,>100
9951,rectangle,181,34107720,98.2663374385,_100,9,>100
9952,ambitions,181,34107901,98.2668589101,_100,9,>100
9953,greenhouse,181,34108082,98.2673803817,_100,10,>100
9954,whipping,181,34108263,98.2679018533,_100,8,>100
9955,haunt,181,34108444,98.2684233249,_100,5,>100
9956,preservation,181,34108625,98.2689447965,_100,12,>100
9957,html,181,34108806,98.2694662681,_100,4,>100
9958,escaping,181,34108987,98.2699877397,_100,8,>100
9959,applicant,181,34109168,98.2705092112,_100,9,>100
9960,philosopher,181,34109349,98.2710306828,_100,11,>100
9961,mel,181,34109530,98.2715521544,_100,3,>100
9962,moscow,181,34109711,98.272073626,_100,6,>100
9963,bleak,181,34109892,98.2725950976,_100,5,>100
9964,triggered,181,34110073,98.2731165692,_100,9,>100
9965,flashes,181,34110254,98.2736380408,_100,7,>100
9966,refund,181,34110435,98.2741595124,_100,6,>100
9967,entrepreneurs,181,34110616,98.274680984,_100,13,>100
9968,deprived,181,34110797,98.2752024556,_100,8,>100
9969,slapped,181,34110978,98.2757239272,_100,7,>100
9970,mineral,181,34111159,98.2762453988,_100,7,>100
9971,protects,181,34111340,98.2767668704,_100,8,>100
9972,robbed,181,34111521,98.277288342,_100,6,>100
9973,constructive,181,34111702,98.2778098135,_100,12,>100
9974,torah,181,34111883,98.2783312851,_100,5,>100
9975,fleeting,181,34112064,98.2788527567,_100,8,>100
9976,highlighting,181,34112245,98.2793742283,_100,12,>100
9977,guru,181,34112426,98.2798956999,_100,4,>100
9978,leisure,181,34112607,98.2804171715,_100,7,>100
9979,drafted,181,34112788,98.2809386431,_100,7,>100
9980,logs,181,34112969,98.2814601147,_100,4,>100
9981,laps,180,34113149,98.2819787052,_100,4,>100
9982,celebrates,180,34113329,98.2824972958,_100,10,>100
9983,preferably,180,34113509,98.2830158863,_100,10,>100
9984,validity,180,34113689,98.2835344768,_100,8,>100
9985,whim,180,34113869,98.2840530674,_100,4,>100
9986,speeds,180,34114049,98.2845716579,_100,6,>100
9987,servings,180,34114229,98.2850902484,_100,8,>100
9988,malaysians,180,34114409,98.285608839,_100,10,>100
9989,forefront,180,34114589,98.2861274295,_100,9,>100
9990,limb,180,34114769,98.28664602,_100,4,>100
9991,constraints,180,34114949,98.2871646106,_100,11,>100
9992,breivik,180,34115129,98.2876832011,_100,7,>100
9993,narratives,180,34115309,98.2882017916,_100,10,>100
9994,eerie,180,34115489,98.2887203822,_100,5,>100
9995,trevor,180,34115669,98.2892389727,_100,6,>100
9996,illnesses,180,34115849,98.2897575632,_100,9,>100
9997,cathy,180,34116029,98.2902761538,_100,5,>100
9998,imprisoned,180,34116209,98.2907947443,_100,10,>100
9999,crystals,180,34116389,98.2913133348,_100,8,>100
10000,connects,180,34116569,98.2918319254,_100,8,>100
10001,brilliance,180,34116749,98.2923505159,_100,10,>100
10002,jess,180,34116929,98.2928691065,_100,4,>100
10003,lifts,180,34117109,98.293387697,_100,5,>100
10004,marrying,180,34117289,98.2939062875,_100,8,>100
10005,nutty,180,34117469,98.2944248781,_100,5,>100
10006,loser,180,34117649,98.2949434686,_100,5,>100
10007,charitable,180,34117829,98.2954620591,_100,10,>100
10008,conform,180,34118009,98.2959806497,_100,7,>100
10009,cleanse,180,34118189,98.2964992402,_100,7,>100
10010,prevalent,180,34118369,98.2970178307,_100,9,>100
10011,180,180,34118549,98.2975364213,_100,3,>100
10012,relies,180,34118729,98.2980550118,_100,6,>100
10013,harrison,180,34118909,98.2985736023,_100,8,>100
10014,floyd,180,34119089,98.2990921929,_100,5,>100
10015,ticking,180,34119269,98.2996107834,_100,7,>100
10016,insightful,180,34119449,98.3001293739,_100,10,>100
10017,thirsty,180,34119629,98.3006479645,_100,7,>100
10018,immersed,180,34119809,98.301166555,_100,8,>100
10019,orthodox,180,34119989,98.3016851455,_100,8,>100
10020,collectors,179,34120168,98.302200855,_100,10,>100
10021,comeback,179,34120347,98.3027165645,_100,8,>100
10022,captive,179,34120526,98.303232274,_100,7,>100
10023,evangelical,179,34120705,98.3037479834,_100,11,>100
10024,cincinnati,179,34120884,98.3042636929,_100,10,>100
10025,stocked,179,34121063,98.3047794024,_100,7,>100
10026,tortilla,179,34121242,98.3052951119,_100,8,>100
10027,blond,179,34121421,98.3058108213,_100,5,>100
10028,messiah,179,34121600,98.3063265308,_100,7,>100
10029,thugs,179,34121779,98.3068422403,_100,5,>100
10030,jurisdiction,179,34121958,98.3073579498,_100,12,>100
10031,irresponsible,179,34122137,98.3078736592,_100,13,>100
10032,merchandise,179,34122316,98.3083893687,_100,11,>100
10033,invaluable,179,34122495,98.3089050782,_100,10,>100
10034,slope,179,34122674,98.3094207877,_100,5,>100
10035,graciously,179,34122853,98.3099364971,_100,10,>100
10036,flaw,179,34123032,98.3104522066,_100,4,>100
10037,archive,179,34123211,98.3109679161,_100,7,>100
10038,households,179,34123390,98.3114836256,_100,10,>100
10039,postcard,179,34123569,98.3119993351,_100,8,>100
10040,tuition,179,34123748,98.3125150445,_100,7,>100
10041,ammunition,179,34123927,98.313030754,_100,10,>100
10042,elijah,179,34124106,98.3135464635,_100,6,>100
10043,convictions,179,34124285,98.314062173,_100,11,>100
10044,proximity,179,34124464,98.3145778824,_100,9,>100
10045,confuse,179,34124643,98.3150935919,_100,7,>100
10046,dam,179,34124822,98.3156093014,_100,3,>100
10047,drastically,179,34125001,98.3161250109,_100,11,>100
10048,volunteering,179,34125180,98.3166407203,_100,12,>100
10049,distractions,179,34125359,98.3171564298,_100,12,>100
10050,interpretations,179,34125538,98.3176721393,_100,15,>100
10051,ellie,179,34125717,98.3181878488,_100,5,>100
10052,cellar,178,34125895,98.3187006772,_100,6,>100
10053,plotting,178,34126073,98.3192135056,_100,8,>100
10054,interacting,178,34126251,98.319726334,_100,11,>100
10055,distorted,178,34126429,98.3202391624,_100,9,>100
10056,exile,178,34126607,98.3207519908,_100,5,>100
10057,extensively,178,34126785,98.3212648193,_100,11,>100
10058,polka,178,34126963,98.3217776477,_100,5,>100
10059,killings,178,34127141,98.3222904761,_100,8,>100
10060,reflective,178,34127319,98.3228033045,_100,10,>100
10061,header,178,34127497,98.3233161329,_100,6,>100
10062,earthy,178,34127675,98.3238289614,_100,6,>100
10063,revisit,178,34127853,98.3243417898,_100,7,>100
10064,pints,178,34128031,98.3248546182,_100,5,>100
10065,denim,178,34128209,98.3253674466,_100,5,>100
10066,rabbits,178,34128387,98.325880275,_100,7,>100
10067,mozzarella,178,34128565,98.3263931034,_100,10,>100
10068,eliminating,178,34128743,98.3269059319,_100,11,>100
10069,hose,178,34128921,98.3274187603,_100,4,>100
10070,brethren,178,34129099,98.3279315887,_100,8,>100
10071,gen,178,34129277,98.3284444171,_100,3,>100
10072,aches,178,34129455,98.3289572455,_100,5,>100
10073,cardigan,178,34129633,98.3294700739,_100,8,>100
10074,bullied,178,34129811,98.3299829024,_100,7,>100
10075,mourning,178,34129989,98.3304957308,_100,8,>100
10076,allergy,178,34130167,98.3310085592,_100,7,>100
10077,happenings,178,34130345,98.3315213876,_100,10,>100
10078,preacher,178,34130523,98.332034216,_100,8,>100
10079,sanctions,178,34130701,98.3325470444,_100,9,>100
10080,shave,178,34130879,98.3330598729,_100,5,>100
10081,kristen,178,34131057,98.3335727013,_100,7,>100
10082,frenzy,178,34131235,98.3340855297,_100,6,>100
10083,persuaded,178,34131413,98.3345983581,_100,9,>100
10084,detention,178,34131591,98.3351111865,_100,9,>100
10085,legends,178,34131769,98.3356240149,_100,7,>100
10086,apologise,178,34131947,98.3361368434,_100,9,>100
10087,calorie,178,34132125,98.3366496718,_100,7,>100
10088,brads,178,34132303,98.3371625002,_100,5,>100
10089,swallowed,178,34132481,98.3376753286,_100,9,>100
10090,slaughter,178,34132659,98.338188157,_100,9,>100
10091,posing,178,34132837,98.3387009855,_100,6,>100
10092,echoes,177,34133014,98.3392109328,_100,6,>100
10093,spam,177,34133191,98.3397208802,_100,4,>100
10094,spectacle,177,34133368,98.3402308275,_100,9,>100
10095,comedian,177,34133545,98.3407407749,_100,8,>100
10096,imperative,177,34133722,98.3412507222,_100,10,>100
10097,rash,177,34133899,98.3417606696,_100,4,>100
10098,woo,177,34134076,98.342270617,_100,3,>100
10099,pun,177,34134253,98.3427805643,_100,3,>100
10100,thinner,177,34134430,98.3432905117,_100,7,>100
10101,tagged,177,34134607,98.343800459,_100,6,>100
10102,deception,177,34134784,98.3443104064,_100,9,>100
10103,personalized,177,34134961,98.3448203538,_100,12,>100
10104,steer,177,34135138,98.3453303011,_100,5,>100
10105,stalls,177,34135315,98.3458402485,_100,6,>100
10106,slowing,177,34135492,98.3463501958,_100,7,>100
10107,tents,177,34135669,98.3468601432,_100,5,>100
10108,drifting,177,34135846,98.3473700906,_100,8,>100
10109,ants,177,34136023,98.3478800379,_100,4,>100
10110,xu,177,34136200,98.3483899853,_100,2,>100
10111,complement,177,34136377,98.3488999326,_100,10,>100
10112,diamonds,177,34136554,98.34940988,_100,8,>100
10113,attire,177,34136731,98.3499198273,_100,6,>100
10114,scarves,177,34136908,98.3504297747,_100,7,>100
10115,dedicate,177,34137085,98.3509397221,_100,8,>100
10116,watercolor,177,34137262,98.3514496694,_100,10,>100
10117,destinations,177,34137439,98.3519596168,_100,12,>100
10118,burial,177,34137616,98.3524695641,_100,6,>100
10119,fences,177,34137793,98.3529795115,_100,6,>100
10120,pony,177,34137970,98.3534894589,_100,4,>100
10121,authenticity,177,34138147,98.3539994062,_100,12,>100
10122,vanished,177,34138324,98.3545093536,_100,8,>100
10123,revival,177,34138501,98.3550193009,_100,7,>100
10124,bladder,177,34138678,98.3555292483,_100,7,>100
10125,underwater,177,34138855,98.3560391956,_100,10,>100
10126,preliminary,177,34139032,98.356549143,_100,11,>100
10127,escapes,177,34139209,98.3570590904,_100,7,>100
10128,brushing,177,34139386,98.3575690377,_100,8,>100
10129,chatter,177,34139563,98.3580789851,_100,7,>100
10130,wholesome,177,34139740,98.3585889324,_100,9,>100
10131,bradford,176,34139916,98.3590959987,_100,8,>100
10132,insignificant,176,34140092,98.359603065,_100,13,>100
10133,brett,176,34140268,98.3601101313,_100,5,>100
10134,belle,176,34140444,98.3606171976,_100,5,>100
10135,temps,176,34140620,98.3611242639,_100,5,>100
10136,advocacy,176,34140796,98.3616313302,_100,8,>100
10137,ranges,176,34140972,98.3621383965,_100,6,>100
10138,rebels,176,34141148,98.3626454628,_100,6,>100
10139,distances,176,34141324,98.3631525291,_100,9,>100
10140,obsessive,176,34141500,98.3636595954,_100,9,>100
10141,newt,176,34141676,98.3641666617,_100,4,>100
10142,tipped,176,34141852,98.364673728,_100,6,>100
10143,manning,176,34142028,98.3651807943,_100,7,>100
10144,comply,176,34142204,98.3656878606,_100,6,>100
10145,vase,176,34142380,98.3661949269,_100,4,>100
10146,excluded,176,34142556,98.3667019932,_100,8,>100
10147,dyed,176,34142732,98.3672090595,_100,4,>100
10148,lindsay,176,34142908,98.3677161258,_100,7,>100
10149,flavorful,176,34143084,98.3682231921,_100,9,>100
10150,carbonation,176,34143260,98.3687302584,_100,11,>100
10151,paced,176,34143436,98.3692373247,_100,5,>100
10152,drastic,176,34143612,98.369744391,_100,7,>100
10153,evan,176,34143788,98.3702514573,_100,4,>100
10154,brownie,175,34143963,98.3707556426,_100,7,>100
10155,exclaimed,175,34144138,98.3712598278,_100,9,>100
10156,makeover,175,34144313,98.3717640131,_100,8,>100
10157,belongings,175,34144488,98.3722681983,_100,10,>100
10158,tiring,175,34144663,98.3727723836,_100,6,>100
10159,savvy,175,34144838,98.3732765688,_100,5,>100
10160,sacrificed,175,34145013,98.373780754,_100,10,>100
10161,morally,175,34145188,98.3742849393,_100,7,>100
10162,sensory,175,34145363,98.3747891245,_100,7,>100
10163,packets,175,34145538,98.3752933098,_100,7,>100
10164,cuddle,175,34145713,98.375797495,_100,6,>100
10165,hides,175,34145888,98.3763016802,_100,5,>100
10166,turtle,175,34146063,98.3768058655,_100,6,>100
10167,boulevard,175,34146238,98.3773100507,_100,9,>100
10168,structural,175,34146413,98.377814236,_100,10,>100
10169,collector,175,34146588,98.3783184212,_100,9,>100
10170,sank,175,34146763,98.3788226065,_100,4,>100
10171,dotted,175,34146938,98.3793267917,_100,6,>100
10172,negativity,175,34147113,98.3798309769,_100,10,>100
10173,chess,175,34147288,98.3803351622,_100,5,>100
10174,bj,175,34147463,98.3808393474,_100,2,>100
10175,awoke,175,34147638,98.3813435327,_100,5,>100
10176,traces,175,34147813,98.3818477179,_100,6,>100
10177,sellers,175,34147988,98.3823519031,_100,7,>100
10178,vacations,175,34148163,98.3828560884,_100,9,>100
10179,battered,175,34148338,98.3833602736,_100,8,>100
10180,cholesterol,175,34148513,98.3838644589,_100,11,>100
10181,attractions,175,34148688,98.3843686441,_100,11,>100
10182,governing,175,34148863,98.3848728294,_100,9,>100
10183,levi,175,34149038,98.3853770146,_100,4,>100
10184,hardy,175,34149213,98.3858811998,_100,5,>100
10185,unnoticed,175,34149388,98.3863853851,_100,9,>100
10186,overlook,175,34149563,98.3868895703,_100,8,>100
10187,andrews,175,34149738,98.3873937556,_100,7,>100
10188,hedge,175,34149913,98.3878979408,_100,5,>100
10189,advent,175,34150088,98.388402126,_100,6,>100
10190,bottoms,175,34150263,98.3889063113,_100,7,>100
10191,discounts,175,34150438,98.3894104965,_100,9,>100
10192,drake,175,34150613,98.3899146818,_100,5,>100
10193,roosevelt,175,34150788,98.390418867,_100,9,>100
10194,waiter,175,34150963,98.3909230523,_100,6,>100
10195,incorporating,175,34151138,98.3914272375,_100,13,>100
10196,deserving,175,34151313,98.3919314227,_100,9,>100
10197,greasy,175,34151488,98.392435608,_100,6,>100
10198,glenn,175,34151663,98.3929397932,_100,5,>100
10199,fave,175,34151838,98.3934439785,_100,4,>100
10200,descendants,174,34152012,98.3939452826,_100,11,>100
10201,declares,174,34152186,98.3944465868,_100,8,>100
10202,ordeal,174,34152360,98.394947891,_100,6,>100
10203,educators,174,34152534,98.3954491952,_100,9,>100
10204,conducting,174,34152708,98.3959504994,_100,10,>100
10205,bollywood,174,34152882,98.3964518036,_100,9,>100
10206,psychologist,174,34153056,98.3969531077,_100,12,>100
10207,condensed,174,34153230,98.3974544119,_100,9,>100
10208,waterfall,174,34153404,98.3979557161,_100,9,>100
10209,reckon,174,34153578,98.3984570203,_100,6,>100
10210,reside,174,34153752,98.3989583245,_100,6,>100
10211,headphones,174,34153926,98.3994596287,_100,10,>100
10212,unrealistic,174,34154100,98.3999609328,_100,11,>100
10213,homeschool,174,34154274,98.400462237,_100,10,>100
10214,simpson,174,34154448,98.4009635412,_100,7,>100
10215,venice,174,34154622,98.4014648454,_100,6,>100
10216,earnest,174,34154796,98.4019661496,_100,7,>100
10217,troubling,174,34154970,98.4024674538,_100,9,>100
10218,crayons,174,34155144,98.4029687579,_100,7,>100
10219,detailing,174,34155318,98.4034700621,_100,9,>100
10220,thieves,174,34155492,98.4039713663,_100,7,>100
10221,elders,174,34155666,98.4044726705,_100,6,>100
10222,hub,174,34155840,98.4049739747,_100,3,>100
10223,aggression,174,34156014,98.4054752789,_100,10,>100
10224,humbled,174,34156188,98.405976583,_100,7,>100
10225,scam,174,34156362,98.4064778872,_100,4,>100
10226,laser,173,34156535,98.4069763104,_100,5,>100
10227,exhibits,173,34156708,98.4074747335,_100,8,>100
10228,undermine,173,34156881,98.4079731566,_100,9,>100
10229,counters,173,34157054,98.4084715797,_100,8,>100
10230,snaps,173,34157227,98.4089700029,_100,5,>100
10231,theoretical,173,34157400,98.409468426,_100,11,>100
10232,illegally,173,34157573,98.4099668491,_100,9,>100
10233,boxing,173,34157746,98.4104652722,_100,6,>100
10234,departed,173,34157919,98.4109636953,_100,8,>100
10235,shane,173,34158092,98.4114621185,_100,5,>100
10236,cured,173,34158265,98.4119605416,_100,5,>100
10237,tongues,173,34158438,98.4124589647,_100,7,>100
10238,violations,173,34158611,98.4129573878,_100,10,>100
10239,athens,173,34158784,98.413455811,_100,6,>100
10240,almighty,173,34158957,98.4139542341,_100,8,>100
10241,surge,173,34159130,98.4144526572,_100,5,>100
10242,grumpy,173,34159303,98.4149510803,_100,6,>100
10243,clan,173,34159476,98.4154495035,_100,4,>100
10244,discarded,173,34159649,98.4159479266,_100,9,>100
10245,compliance,173,34159822,98.4164463497,_100,10,>100
10246,measurement,173,34159995,98.4169447728,_100,11,>100
10247,storing,173,34160168,98.417443196,_100,7,>100
10248,parisian,173,34160341,98.4179416191,_100,8,>100
10249,boundary,173,34160514,98.4184400422,_100,8,>100
10250,layering,173,34160687,98.4189384653,_100,8,>100
10251,snapping,173,34160860,98.4194368885,_100,8,>100
10252,curtis,173,34161033,98.4199353116,_100,6,>100
10253,conveniently,173,34161206,98.4204337347,_100,12,>100
10254,generating,173,34161379,98.4209321578,_100,10,>100
10255,dime,173,34161552,98.421430581,_100,4,>100
10256,renaissance,173,34161725,98.4219290041,_100,11,>100
10257,radioactive,173,34161898,98.4224274272,_100,11,>100
10258,bio,173,34162071,98.4229258503,_100,3,>100
10259,cinderella,173,34162244,98.4234242735,_100,10,>100
10260,rider,173,34162417,98.4239226966,_100,5,>100
10261,fisher,173,34162590,98.4244211197,_100,6,>100
10262,factions,172,34162762,98.4249166618,_100,8,>100
10263,riders,172,34162934,98.4254122038,_100,6,>100
10264,nina,172,34163106,98.4259077459,_100,4,>100
10265,bald,172,34163278,98.426403288,_100,4,>100
10266,interfere,172,34163450,98.42689883,_100,9,>100
10267,rim,172,34163622,98.4273943721,_100,3,>100
10268,enthusiasts,172,34163794,98.4278899142,_100,11,>100
10269,invent,172,34163966,98.4283854562,_100,6,>100
10270,surveys,172,34164138,98.4288809983,_100,7,>100
10271,landlord,172,34164310,98.4293765404,_100,8,>100
10272,continuity,172,34164482,98.4298720824,_100,10,>100
10273,cauliflower,172,34164654,98.4303676245,_100,11,>100
10274,barking,172,34164826,98.4308631666,_100,7,>100
10275,splendid,172,34164998,98.4313587086,_100,8,>100
10276,psyche,172,34165170,98.4318542507,_100,6,>100
10277,bloomberg,172,34165342,98.4323497928,_100,9,>100
10278,sabbath,172,34165514,98.4328453348,_100,7,>100
10279,reckless,172,34165686,98.4333408769,_100,8,>100
10280,wtf,172,34165858,98.433836419,_100,3,>100
10281,singular,172,34166030,98.434331961,_100,8,>100
10282,racks,172,34166202,98.4348275031,_100,5,>100
10283,coffin,172,34166374,98.4353230452,_100,6,>100
10284,sweetheart,172,34166546,98.4358185872,_100,10,>100
10285,listeners,172,34166718,98.4363141293,_100,9,>100
10286,receipt,172,34166890,98.4368096714,_100,7,>100
10287,motivate,172,34167062,98.4373052134,_100,8,>100
10288,infections,172,34167234,98.4378007555,_100,10,>100
10289,ketchup,172,34167406,98.4382962976,_100,7,>100
10290,cherished,172,34167578,98.4387918396,_100,9,>100
10291,crumble,172,34167750,98.4392873817,_100,7,>100
10292,waits,172,34167922,98.4397829238,_100,5,>100
10293,presidency,172,34168094,98.4402784658,_100,10,>100
10294,locker,172,34168266,98.4407740079,_100,6,>100
10295,buzzing,172,34168438,98.44126955,_100,7,>100
10296,hairs,172,34168610,98.441765092,_100,5,>100
10297,stale,172,34168782,98.4422606341,_100,5,>100
10298,precision,172,34168954,98.4427561762,_100,9,>100
10299,gripping,172,34169126,98.4432517182,_100,8,>100
10300,cardio,172,34169298,98.4437472603,_100,6,>100
10301,maintains,172,34169470,98.4442428024,_100,9,>100
10302,violated,172,34169642,98.4447383444,_100,8,>100
10303,motions,171,34169813,98.4452310054,_100,7,>100
10304,shoved,171,34169984,98.4457236664,_100,6,>100
10305,criticized,171,34170155,98.4462163274,_100,10,>100
10306,teasing,171,34170326,98.4467089885,_100,7,>100
10307,saga,171,34170497,98.4472016495,_100,4,>100
10308,acclaimed,171,34170668,98.4476943105,_100,9,>100
10309,preceding,171,34170839,98.4481869715,_100,9,>100
10310,backward,171,34171010,98.4486796325,_100,8,>100
10311,prolific,171,34171181,98.4491722935,_100,8,>100
10312,tensions,171,34171352,98.4496649545,_100,8,>100
10313,malts,171,34171523,98.4501576155,_100,5,>100
10314,mechanisms,171,34171694,98.4506502765,_100,10,>100
10315,cheeses,171,34171865,98.4511429375,_100,7,>100
10316,acknowledging,171,34172036,98.4516355985,_100,13,>100
10317,journeys,171,34172207,98.4521282595,_100,8,>100
10318,canadians,171,34172378,98.4526209205,_100,9,>100
10319,dale,171,34172549,98.4531135816,_100,4,>100
10320,beverages,171,34172720,98.4536062426,_100,9,>100
10321,gangs,171,34172891,98.4540989036,_100,5,>100
10322,confrontation,171,34173062,98.4545915646,_100,13,>100
10323,kenneth,171,34173233,98.4550842256,_100,7,>100
10324,autistic,171,34173404,98.4555768866,_100,8,>100
10325,occurrence,171,34173575,98.4560695476,_100,10,>100
10326,krishna,171,34173746,98.4565622086,_100,7,>100
10327,hex,171,34173917,98.4570548696,_100,3,>100
10328,despise,171,34174088,98.4575475306,_100,7,>100
10329,suppliers,171,34174259,98.4580401916,_100,9,>100
10330,scrub,171,34174430,98.4585328526,_100,5,>100
10331,decay,171,34174601,98.4590255136,_100,5,>100
10332,missionary,171,34174772,98.4595181747,_100,10,>100
10333,sweaters,171,34174943,98.4600108357,_100,8,>100
10334,handbag,171,34175114,98.4605034967,_100,7,>100
10335,snowy,171,34175285,98.4609961577,_100,5,>100
10336,idaho,171,34175456,98.4614888187,_100,5,>100
10337,correction,171,34175627,98.4619814797,_100,10,>100
10338,tackling,171,34175798,98.4624741407,_100,8,>100
10339,lords,171,34175969,98.4629668017,_100,5,>100
10340,metropolitan,171,34176140,98.4634594627,_100,12,>100
10341,manageable,171,34176311,98.4639521237,_100,10,>100
10342,furry,171,34176482,98.4644447847,_100,5,>100
10343,biking,170,34176652,98.4649345647,_100,6,>100
10344,stab,170,34176822,98.4654243446,_100,4,>100
10345,prediction,170,34176992,98.4659141246,_100,10,>100
10346,sectors,170,34177162,98.4664039045,_100,7,>100
10347,acne,170,34177332,98.4668936845,_100,4,>100
10348,proverbs,170,34177502,98.4673834644,_100,8,>100
10349,voter,170,34177672,98.4678732444,_100,5,>100
10350,hindsight,170,34177842,98.4683630243,_100,9,>100
10351,hacking,170,34178012,98.4688528043,_100,7,>100
10352,uganda,170,34178182,98.4693425842,_100,6,>100
10353,pleaded,170,34178352,98.4698323642,_100,7,>100
10354,chord,170,34178522,98.4703221441,_100,5,>100
10355,prospective,170,34178692,98.4708119241,_100,11,>100
10356,vile,170,34178862,98.471301704,_100,4,>100
10357,drone,170,34179032,98.471791484,_100,5,>100
10358,definitive,170,34179202,98.4722812639,_100,10,>100
10359,smartphone,170,34179372,98.4727710439,_100,10,>100
10360,170,170,34179542,98.4732608238,_100,3,>100
10361,seas,170,34179712,98.4737506038,_100,4,>100
10362,gaga,170,34179882,98.4742403837,_100,4,>100
10363,cluster,170,34180052,98.4747301637,_100,7,>100
10364,urgency,170,34180222,98.4752199436,_100,7,>100
10365,superficial,170,34180392,98.4757097236,_100,11,>100
10366,fulfillment,170,34180562,98.4761995035,_100,11,>100
10367,dissolve,170,34180732,98.4766892835,_100,8,>100
10368,fussy,170,34180902,98.4771790634,_100,5,>100
10369,whereby,170,34181072,98.4776688434,_100,7,>100
10370,beckett,170,34181242,98.4781586233,_100,7,>100
10371,appalling,170,34181412,98.4786484033,_100,9,>100
10372,debating,170,34181582,98.4791381832,_100,8,>100
10373,pennies,170,34181752,98.4796279632,_100,7,>100
10374,hoppy,170,34181922,98.4801177431,_100,5,>100
10375,contestants,170,34182092,98.480607523,_100,11,>100
10376,malema,170,34182262,98.481097303,_100,6,>100
10377,regulatory,169,34182431,98.4815842019,_100,10,>100
10378,seniors,169,34182600,98.4820711008,_100,7,>100
10379,gradual,169,34182769,98.4825579997,_100,7,>100
10380,chewy,169,34182938,98.4830448986,_100,5,>100
10381,trades,169,34183107,98.4835317975,_100,6,>100
10382,bon,169,34183276,98.4840186963,_100,3,>100
10383,gloss,169,34183445,98.4845055952,_100,5,>100
10384,needy,169,34183614,98.4849924941,_100,5,>100
10385,opaque,169,34183783,98.485479393,_100,6,>100
10386,portugal,169,34183952,98.4859662919,_100,8,>100
10387,sculptures,169,34184121,98.4864531908,_100,10,>100
10388,lure,169,34184290,98.4869400897,_100,4,>100
10389,naps,169,34184459,98.4874269886,_100,4,>100
10390,zach,169,34184628,98.4879138875,_100,4,>100
10391,joyous,169,34184797,98.4884007864,_100,6,>100
10392,cement,169,34184966,98.4888876852,_100,6,>100
10393,arbitrary,169,34185135,98.4893745841,_100,9,>100
10394,frustrations,169,34185304,98.489861483,_100,12,>100
10395,coop,169,34185473,98.4903483819,_100,4,>100
10396,viewpoint,169,34185642,98.4908352808,_100,9,>100
10397,extremes,169,34185811,98.4913221797,_100,8,>100
10398,execute,169,34185980,98.4918090786,_100,7,>100
10399,segments,169,34186149,98.4922959775,_100,8,>100
10400,yorkshire,169,34186318,98.4927828764,_100,9,>100
10401,immortal,169,34186487,98.4932697753,_100,8,>100
10402,abide,169,34186656,98.4937566742,_100,5,>100
10403,fairies,169,34186825,98.494243573,_100,7,>100
10404,reproduction,169,34186994,98.4947304719,_100,12,>100
10405,citing,169,34187163,98.4952173708,_100,6,>100
10406,certification,169,34187332,98.4957042697,_100,13,>100
10407,hilton,169,34187501,98.4961911686,_100,6,>100
10408,dubious,169,34187670,98.4966780675,_100,7,>100
10409,isabel,169,34187839,98.4971649664,_100,6,>100
10410,investigators,169,34188008,98.4976518653,_100,13,>100
10411,intuition,169,34188177,98.4981387642,_100,9,>100
10412,clinging,169,34188346,98.4986256631,_100,8,>100
10413,ethiopia,169,34188515,98.4991125619,_100,8,>100
10414,transforming,169,34188684,98.4995994608,_100,12,>100
10415,devote,169,34188853,98.5000863597,_100,6,>100
10416,skipping,169,34189022,98.5005732586,_100,8,>100
10417,offend,169,34189191,98.5010601575,_100,6,>100
10418,ceased,169,34189360,98.5015470564,_100,6,>100
10419,chuckle,169,34189529,98.5020339553,_100,7,>100
10420,philly,169,34189698,98.5025208542,_100,6,>100
10421,gt,169,34189867,98.5030077531,_100,2,>100
10422,horrors,169,34190036,98.503494652,_100,7,>100
10423,luxurious,169,34190205,98.5039815509,_100,9,>100
10424,ava,169,34190374,98.5044684497,_100,3,>100
10425,whale,169,34190543,98.5049553486,_100,5,>100
10426,humiliation,169,34190712,98.5054422475,_100,11,>100
10427,infused,169,34190881,98.5059291464,_100,7,>100
10428,penguin,169,34191050,98.5064160453,_100,7,>100
10429,spanking,169,34191219,98.5069029442,_100,8,>100
10430,restraint,169,34191388,98.5073898431,_100,9,>100
10431,plethora,168,34191556,98.5078738609,_100,8,>100
10432,boo,168,34191724,98.5083578788,_100,3,>100
10433,logged,168,34191892,98.5088418966,_100,6,>100
10434,primer,168,34192060,98.5093259144,_100,6,>100
10435,frankenstein,168,34192228,98.5098099322,_100,12,>100
10436,tangled,168,34192396,98.5102939501,_100,7,>100
10437,dominance,168,34192564,98.5107779679,_100,9,>100
10438,boers,168,34192732,98.5112619857,_100,5,>100
10439,discoveries,168,34192900,98.5117460036,_100,11,>100
10440,tara,168,34193068,98.5122300214,_100,4,>100
10441,upbringing,168,34193236,98.5127140392,_100,10,>100
10442,pickup,168,34193404,98.5131980571,_100,6,>100
10443,scar,168,34193572,98.5136820749,_100,4,>100
10444,spoons,168,34193740,98.5141660927,_100,6,>100
10445,travelers,168,34193908,98.5146501106,_100,9,>100
10446,sneakers,168,34194076,98.5151341284,_100,8,>100
10447,oceans,168,34194244,98.5156181462,_100,6,>100
10448,blouse,168,34194412,98.5161021641,_100,6,>100
10449,temp,168,34194580,98.5165861819,_100,4,>100
10450,compatible,168,34194748,98.5170701997,_100,10,>100
10451,showcasing,168,34194916,98.5175542176,_100,10,>100
10452,awakening,168,34195084,98.5180382354,_100,9,>100
10453,conventions,168,34195252,98.5185222532,_100,11,>100
10454,dudes,168,34195420,98.5190062711,_100,5,>100
10455,whistle,168,34195588,98.5194902889,_100,7,>100
10456,surf,168,34195756,98.5199743067,_100,4,>100
10457,ne,168,34195924,98.5204583246,_100,2,>100
10458,microphone,168,34196092,98.5209423424,_100,10,>100
10459,delays,168,34196260,98.5214263602,_100,6,>100
10460,tighter,168,34196428,98.521910378,_100,7,>100
10461,flattering,168,34196596,98.5223943959,_100,10,>100
10462,worldly,168,34196764,98.5228784137,_100,7,>100
10463,paddle,168,34196932,98.5233624315,_100,6,>100
10464,calming,168,34197100,98.5238464494,_100,7,>100
10465,tenants,168,34197268,98.5243304672,_100,7,>100
10466,violently,168,34197436,98.524814485,_100,9,>100
10467,pricey,168,34197604,98.5252985029,_100,6,>100
10468,utilized,168,34197772,98.5257825207,_100,8,>100
10469,lightweight,168,34197940,98.5262665385,_100,11,>100
10470,unlock,168,34198108,98.5267505564,_100,6,>100
10471,greeks,168,34198276,98.5272345742,_100,6,>100
10472,lunchtime,167,34198443,98.527715711,_100,9,>100
10473,rv,167,34198610,98.5281968477,_100,2,>100
10474,resignation,167,34198777,98.5286779845,_100,11,>100
10475,addison,167,34198944,98.5291591213,_100,7,>100
10476,iced,167,34199111,98.5296402581,_100,4,>100
10477,ace,167,34199278,98.5301213948,_100,3,>100
10478,laurie,167,34199445,98.5306025316,_100,6,>100
10479,marley,167,34199612,98.5310836684,_100,6,>100
10480,dictate,167,34199779,98.5315648052,_100,7,>100
10481,mi,167,34199946,98.5320459419,_100,2,>100
10482,obtaining,167,34200113,98.5325270787,_100,9,>100
10483,pitching,167,34200280,98.5330082155,_100,8,>100
10484,muster,167,34200447,98.5334893523,_100,6,>100
10485,twisting,167,34200614,98.533970489,_100,8,>100
10486,calmed,167,34200781,98.5344516258,_100,6,>100
10487,solitude,167,34200948,98.5349327626,_100,8,>100
10488,guan,167,34201115,98.5354138993,_100,4,>100
10489,temples,167,34201282,98.5358950361,_100,7,>100
10490,savannah,167,34201449,98.5363761729,_100,8,>100
10491,frantic,167,34201616,98.5368573097,_100,7,>100
10492,raspberries,167,34201783,98.5373384464,_100,11,>100
10493,stalking,167,34201950,98.5378195832,_100,8,>100
10494,saturated,167,34202117,98.53830072,_100,9,>100
10495,oprah,167,34202284,98.5387818568,_100,5,>100
10496,stockings,167,34202451,98.5392629935,_100,9,>100
10497,witnessing,167,34202618,98.5397441303,_100,10,>100
10498,templates,167,34202785,98.5402252671,_100,9,>100
10499,haze,167,34202952,98.5407064039,_100,4,>100
10500,arch,167,34203119,98.5411875406,_100,4,>100
10501,succession,167,34203286,98.5416686774,_100,10,>100
10502,retrieve,167,34203453,98.5421498142,_100,8,>100
10503,mattered,167,34203620,98.542630951,_100,8,>100
10504,desktop,167,34203787,98.5431120877,_100,7,>100
10505,visuals,167,34203954,98.5435932245,_100,7,>100
10506,quaint,167,34204121,98.5440743613,_100,6,>100
10507,zimbabwe,167,34204288,98.544555498,_100,8,>100
10508,iris,167,34204455,98.5450366348,_100,4,>100
10509,esther,167,34204622,98.5455177716,_100,6,>100
10510,hostel,167,34204789,98.5459989084,_100,6,>100
10511,peacefully,167,34204956,98.5464800451,_100,10,>100
10512,supplements,167,34205123,98.5469611819,_100,11,>100
10513,armies,167,34205290,98.5474423187,_100,6,>100
10514,honors,167,34205457,98.5479234555,_100,6,>100
10515,reluctantly,167,34205624,98.5484045922,_100,11,>100
10516,rogue,167,34205791,98.548885729,_100,5,>100
10517,reviewer,167,34205958,98.5493668658,_100,8,>100
10518,genetically,167,34206125,98.5498480026,_100,11,>100
10519,recipients,167,34206292,98.5503291393,_100,10,>100
10520,patricia,167,34206459,98.5508102761,_100,8,>100
10521,charter,167,34206626,98.5512914129,_100,7,>100
10522,lethal,167,34206793,98.5517725496,_100,6,>100
10523,gag,167,34206960,98.5522536864,_100,3,>100
10524,remnants,166,34207126,98.5527319421,_100,8,>100
10525,gasoline,166,34207292,98.5532101979,_100,8,>100
10526,lends,166,34207458,98.5536884536,_100,5,>100
10527,reinforce,166,34207624,98.5541667093,_100,9,>100
10528,ankles,166,34207790,98.554644965,_100,6,>100
10529,grams,166,34207956,98.5551232207,_100,5,>100
10530,darwin,166,34208122,98.5556014764,_100,6,>100
10531,slam,166,34208288,98.5560797321,_100,4,>100
10532,carson,166,34208454,98.5565579879,_100,6,>100
10533,inclusive,166,34208620,98.5570362436,_100,9,>100
10534,endings,166,34208786,98.5575144993,_100,7,>100
10535,tails,166,34208952,98.557992755,_100,5,>100
10536,habitat,166,34209118,98.5584710107,_100,7,>100
10537,lotion,166,34209284,98.5589492664,_100,6,>100
10538,robots,166,34209450,98.5594275221,_100,6,>100
10539,overdue,166,34209616,98.5599057779,_100,7,>100
10540,meme,166,34209782,98.5603840336,_100,4,>100
10541,mon,166,34209948,98.5608622893,_100,3,>100
10542,bullies,166,34210114,98.561340545,_100,7,>100
10543,cue,166,34210280,98.5618188007,_100,3,>100
10544,requesting,166,34210446,98.5622970564,_100,10,>100
10545,shampoo,166,34210612,98.5627753122,_100,7,>100
10546,beck,166,34210778,98.5632535679,_100,4,>100
10547,actuality,166,34210944,98.5637318236,_100,9,>100
10548,regulate,166,34211110,98.5642100793,_100,8,>100
10549,meyer,166,34211276,98.564688335,_100,5,>100
10550,trailers,166,34211442,98.5651665907,_100,8,>100
10551,attain,166,34211608,98.5656448464,_100,6,>100
10552,evolutionary,166,34211774,98.5661231022,_100,12,>100
10553,platter,166,34211940,98.5666013579,_100,7,>100
10554,clown,166,34212106,98.5670796136,_100,5,>100
10555,baptized,166,34212272,98.5675578693,_100,8,>100
10556,juvenile,166,34212438,98.568036125,_100,8,>100
10557,compact,166,34212604,98.5685143807,_100,7,>100
10558,parcel,165,34212769,98.5689897554,_100,6,>100
10559,bathrooms,165,34212934,98.56946513,_100,9,>100
10560,adhesive,165,34213099,98.5699405047,_100,8,>100
10561,rigid,165,34213264,98.5704158794,_100,5,>100
10562,relieve,165,34213429,98.570891254,_100,7,>100
10563,sibling,165,34213594,98.5713666287,_100,7,>100
10564,claus,165,34213759,98.5718420033,_100,5,>100
10565,utmost,165,34213924,98.572317378,_100,6,>100
10566,gals,165,34214089,98.5727927526,_100,4,>100
10567,humid,165,34214254,98.5732681273,_100,5,>100
10568,yolks,165,34214419,98.573743502,_100,5,>100
10569,theatrical,165,34214584,98.5742188766,_100,10,>100
10570,globally,165,34214749,98.5746942513,_100,8,>100
10571,critically,165,34214914,98.5751696259,_100,10,>100
10572,mick,165,34215079,98.5756450006,_100,4,>100
10573,hem,165,34215244,98.5761203752,_100,3,>100
10574,jericho,165,34215409,98.5765957499,_100,7,>100
10575,zoe,165,34215574,98.5770711245,_100,3,>100
10576,drilling,165,34215739,98.5775464992,_100,8,>100
10577,fingertips,165,34215904,98.5780218739,_100,10,>100
10578,veg,165,34216069,98.5784972485,_100,3,>100
10579,thigh,165,34216234,98.5789726232,_100,5,>100
10580,shirley,165,34216399,98.5794479978,_100,7,>100
10581,eighth,165,34216564,98.5799233725,_100,6,>100
10582,telegraph,165,34216729,98.5803987471,_100,9,>100
10583,mellow,165,34216894,98.5808741218,_100,6,>100
10584,wipes,165,34217059,98.5813494965,_100,5,>100
10585,walt,165,34217224,98.5818248711,_100,4,>100
10586,pulp,165,34217389,98.5823002458,_100,4,>100
10587,preserving,165,34217554,98.5827756204,_100,10,>100
10588,stares,165,34217719,98.5832509951,_100,6,>100
10589,hating,165,34217884,98.5837263697,_100,6,>100
10590,marched,165,34218049,98.5842017444,_100,7,>100
10591,diets,165,34218214,98.5846771191,_100,5,>100
10592,strands,165,34218379,98.5851524937,_100,7,>100
10593,beasts,165,34218544,98.5856278684,_100,6,>100
10594,pedestrian,164,34218708,98.586100362,_100,10,>100
10595,muted,164,34218872,98.5865728556,_100,5,>100
10596,borrowing,164,34219036,98.5870453492,_100,9,>100
10597,beverly,164,34219200,98.5875178428,_100,7,>100
10598,clause,164,34219364,98.5879903364,_100,6,>100
10599,retrospect,164,34219528,98.58846283,_100,10,>100
10600,reminders,164,34219692,98.5889353235,_100,9,>100
10601,shrink,164,34219856,98.5894078171,_100,6,>100
10602,christie,164,34220020,98.5898803107,_100,8,>100
10603,posture,164,34220184,98.5903528043,_100,7,>100
10604,rag,164,34220348,98.5908252979,_100,3,>100
10605,lilly,164,34220512,98.5912977915,_100,5,>100
10606,renew,164,34220676,98.5917702851,_100,5,>100
10607,corp,164,34220840,98.5922427787,_100,4,>100
10608,observer,164,34221004,98.5927152723,_100,8,>100
10609,lloyd,164,34221168,98.5931877659,_100,5,>100
10610,sublime,164,34221332,98.5936602595,_100,7,>100
10611,financing,164,34221496,98.5941327531,_100,9,>100
10612,pierre,164,34221660,98.5946052467,_100,6,>100
10613,playlist,164,34221824,98.5950777403,_100,8,>100
10614,hp,164,34221988,98.5955502339,_100,2,>100
10615,aligned,164,34222152,98.5960227275,_100,7,>100
10616,stresses,164,34222316,98.5964952211,_100,8,>100
10617,marxist,164,34222480,98.5969677147,_100,7,>100
10618,intuitive,164,34222644,98.5974402083,_100,9,>100
10619,bothers,163,34222807,98.5979098209,_100,7,>100
10620,stevens,163,34222970,98.5983794334,_100,7,>100
10621,edits,163,34223133,98.5988490459,_100,5,>100
10622,stabbed,163,34223296,98.5993186585,_100,7,>100
10623,simmering,163,34223459,98.599788271,_100,9,>100
10624,binder,163,34223622,98.6002578835,_100,6,>100
10625,indonesian,163,34223785,98.6007274961,_100,10,>100
10626,intellect,163,34223948,98.6011971086,_100,9,>100
10627,hefty,163,34224111,98.6016667212,_100,5,>100
10628,hobbies,163,34224274,98.6021363337,_100,7,>100
10629,dolphins,163,34224437,98.6026059462,_100,8,>100
10630,drown,163,34224600,98.6030755588,_100,5,>100
10631,overflowing,163,34224763,98.6035451713,_100,11,>100
10632,proverbial,163,34224926,98.6040147839,_100,10,>100
10633,yearning,163,34225089,98.6044843964,_100,8,>100
10634,charcoal,163,34225252,98.6049540089,_100,8,>100
10635,credentials,163,34225415,98.6054236215,_100,11,>100
10636,bedding,163,34225578,98.605893234,_100,7,>100
10637,compromised,163,34225741,98.6063628466,_100,11,>100
10638,shrugged,163,34225904,98.6068324591,_100,8,>100
10639,disappearance,163,34226067,98.6073020716,_100,13,>100
10640,hovering,163,34226230,98.6077716842,_100,8,>100
10641,empowered,163,34226393,98.6082412967,_100,9,>100
10642,boast,163,34226556,98.6087109093,_100,5,>100
10643,churchill,163,34226719,98.6091805218,_100,9,>100
10644,cargo,163,34226882,98.6096501343,_100,5,>100
10645,tracked,163,34227045,98.6101197469,_100,7,>100
10646,filmmaker,163,34227208,98.6105893594,_100,9,>100
10647,behaved,163,34227371,98.611058972,_100,7,>100
10648,colder,163,34227534,98.6115285845,_100,6,>100
10649,landmark,163,34227697,98.611998197,_100,8,>100
10650,tenth,162,34227859,98.6124649285,_100,5,>100
10651,admirable,162,34228021,98.61293166,_100,9,>100
10652,vengeance,162,34228183,98.6133983915,_100,9,>100
10653,comparisons,162,34228345,98.613865123,_100,11,>100
10654,roster,162,34228507,98.6143318544,_100,6,>100
10655,planner,162,34228669,98.6147985859,_100,7,>100
10656,courtyard,162,34228831,98.6152653174,_100,9,>100
10657,muhammad,162,34228993,98.6157320489,_100,8,>100
10658,integrate,162,34229155,98.6161987804,_100,9,>100
10659,untouched,162,34229317,98.6166655118,_100,9,>100
10660,substances,162,34229479,98.6171322433,_100,10,>100
10661,mps,162,34229641,98.6175989748,_100,3,>100
10662,servers,162,34229803,98.6180657063,_100,7,>100
10663,thanking,162,34229965,98.6185324378,_100,8,>100
10664,impacted,162,34230127,98.6189991692,_100,8,>100
10665,judaism,162,34230289,98.6194659007,_100,7,>100
10666,puerto,162,34230451,98.6199326322,_100,6,>100
10667,versa,162,34230613,98.6203993637,_100,5,>100
10668,miranda,162,34230775,98.6208660952,_100,7,>100
10669,dishwasher,162,34230937,98.6213328267,_100,10,>100
10670,withdraw,162,34231099,98.6217995581,_100,8,>100
10671,cringe,162,34231261,98.6222662896,_100,6,>100
10672,swearing,162,34231423,98.6227330211,_100,8,>100
10673,scrambled,162,34231585,98.6231997526,_100,9,>100
10674,peggy,162,34231747,98.6236664841,_100,5,>100
10675,sharks,162,34231909,98.6241332155,_100,6,>100
10676,formats,162,34232071,98.624599947,_100,7,>100
10677,lulu,162,34232233,98.6250666785,_100,4,>100
10678,notebooks,162,34232395,98.62553341,_100,9,>100
10679,intimidated,162,34232557,98.6260001415,_100,11,>100
10680,whichever,162,34232719,98.6264668729,_100,9,>100
10681,quinn,162,34232881,98.6269336044,_100,5,>100
10682,resistant,162,34233043,98.6274003359,_100,9,>100
10683,warns,162,34233205,98.6278670674,_100,5,>100
10684,paradigm,162,34233367,98.6283337989,_100,8,>100
10685,vulnerability,162,34233529,98.6288005303,_100,13,>100
10686,graceful,162,34233691,98.6292672618,_100,8,>100
10687,nj,161,34233852,98.6297311122,_100,2,>100
10688,noel,161,34234013,98.6301949627,_100,4,>100
10689,coarse,161,34234174,98.6306588131,_100,6,>100
10690,magnet,161,34234335,98.6311226635,_100,6,>100
10691,knots,161,34234496,98.6315865139,_100,5,>100
10692,upbeat,161,34234657,98.6320503644,_100,6,>100
10693,attribute,161,34234818,98.6325142148,_100,9,>100
10694,startling,161,34234979,98.6329780652,_100,9,>100
10695,hispanic,161,34235140,98.6334419156,_100,8,>100
10696,cons,161,34235301,98.633905766,_100,4,>100
10697,runway,161,34235462,98.6343696165,_100,6,>100
10698,leash,161,34235623,98.6348334669,_100,5,>100
10699,fades,161,34235784,98.6352973173,_100,5,>100
10700,pals,161,34235945,98.6357611677,_100,4,>100
10701,downloading,161,34236106,98.6362250182,_100,11,>100
10702,transgender,161,34236267,98.6366888686,_100,11,>100
10703,authorized,161,34236428,98.637152719,_100,10,>100
10704,attracts,161,34236589,98.6376165694,_100,8,>100
10705,yahoo,161,34236750,98.6380804199,_100,5,>100
10706,belts,161,34236911,98.6385442703,_100,5,>100
10707,granddaughter,161,34237072,98.6390081207,_100,13,>100
10708,ricky,161,34237233,98.6394719711,_100,5,>100
10709,ignores,161,34237394,98.6399358215,_100,7,>100
10710,mohammed,161,34237555,98.640399672,_100,8,>100
10711,revolves,161,34237716,98.6408635224,_100,8,>100
10712,crawled,161,34237877,98.6413273728,_100,7,>100
10713,raven,161,34238038,98.6417912232,_100,5,>100
10714,ap,161,34238199,98.6422550737,_100,2,>100
10715,dawned,161,34238360,98.6427189241,_100,6,>100
10716,invaded,161,34238521,98.6431827745,_100,7,>100
10717,cube,161,34238682,98.6436466249,_100,4,>100
10718,awesomeness,161,34238843,98.6441104753,_100,11,>100
10719,adequately,161,34239004,98.6445743258,_100,10,>100
10720,mailbox,161,34239165,98.6450381762,_100,7,>100
10721,realism,161,34239326,98.6455020266,_100,7,>100
10722,meltdown,161,34239487,98.645965877,_100,8,>100
10723,unbearable,161,34239648,98.6464297275,_100,10,>100
10724,invariably,161,34239809,98.6468935779,_100,10,>100
10725,arrows,161,34239970,98.6473574283,_100,6,>100
10726,blends,161,34240131,98.6478212787,_100,6,>100
10727,checkout,161,34240292,98.6482851291,_100,8,>100
10728,bait,161,34240453,98.6487489796,_100,4,>100
10729,fundraiser,160,34240613,98.6492099489,_100,10,>100
10730,psychedelic,160,34240773,98.6496709183,_100,11,>100
10731,delve,160,34240933,98.6501318877,_100,5,>100
10732,pears,160,34241093,98.650592857,_100,5,>100
10733,indicator,160,34241253,98.6510538264,_100,9,>100
10734,taps,160,34241413,98.6515147957,_100,4,>100
10735,bounds,160,34241573,98.6519757651,_100,6,>100
10736,bursts,160,34241733,98.6524367345,_100,6,>100
10737,uniquely,160,34241893,98.6528977038,_100,8,>100
10738,pastel,160,34242053,98.6533586732,_100,6,>100
10739,swamp,160,34242213,98.6538196426,_100,5,>100
10740,applicants,160,34242373,98.6542806119,_100,10,>100
10741,reid,160,34242533,98.6547415813,_100,4,>100
10742,casino,160,34242693,98.6552025507,_100,6,>100
10743,stanford,160,34242853,98.65566352,_100,8,>100
10744,laziness,160,34243013,98.6561244894,_100,8,>100
10745,mobility,160,34243173,98.6565854588,_100,8,>100
10746,effortlessly,160,34243333,98.6570464281,_100,12,>100
10747,chopping,160,34243493,98.6575073975,_100,8,>100
10748,robe,160,34243653,98.6579683668,_100,4,>100
10749,refreshed,160,34243813,98.6584293362,_100,9,>100
10750,vacant,160,34243973,98.6588903056,_100,6,>100
10751,conquered,160,34244133,98.6593512749,_100,9,>100
10752,gambling,160,34244293,98.6598122443,_100,8,>100
10753,tougher,160,34244453,98.6602732137,_100,7,>100
10754,attendant,160,34244613,98.660734183,_100,9,>100
10755,policeman,160,34244773,98.6611951524,_100,9,>100
10756,startled,160,34244933,98.6616561218,_100,8,>100
10757,fusion,160,34245093,98.6621170911,_100,6,>100
10758,revisions,160,34245253,98.6625780605,_100,9,>100
10759,notified,160,34245413,98.6630390298,_100,8,>100
10760,advisor,160,34245573,98.6634999992,_100,7,>100
10761,acids,160,34245733,98.6639609686,_100,5,>100
10762,tease,160,34245893,98.6644219379,_100,5,>100
10763,hysterical,160,34246053,98.6648829073,_100,10,>100
10764,160,160,34246213,98.6653438767,_100,3,>100
10765,victories,160,34246373,98.665804846,_100,9,>100
10766,becky,160,34246533,98.6662658154,_100,5,>100
10767,doorstep,160,34246693,98.6667267848,_100,8,>100
10768,seventeen,160,34246853,98.6671877541,_100,9,>100
10769,acquaintance,160,34247013,98.6676487235,_100,12,>100
10770,applause,160,34247173,98.6681096928,_100,8,>100
10771,ebooks,159,34247332,98.6685677812,_100,6,>100
10772,embark,159,34247491,98.6690258695,_100,6,>100
10773,vip,159,34247650,98.6694839578,_100,3,>100
10774,mercedes,159,34247809,98.6699420461,_100,8,>100
10775,marianne,159,34247968,98.6704001344,_100,8,>100
10776,slack,159,34248127,98.6708582227,_100,5,>100
10777,gears,159,34248286,98.671316311,_100,5,>100
10778,pedal,159,34248445,98.6717743993,_100,5,>100
10779,retained,159,34248604,98.6722324876,_100,8,>100
10780,morals,159,34248763,98.6726905759,_100,6,>100
10781,deposits,159,34248922,98.6731486642,_100,8,>100
10782,katrina,159,34249081,98.6736067525,_100,7,>100
10783,farewell,159,34249240,98.6740648408,_100,8,>100
10784,tories,159,34249399,98.6745229291,_100,6,>100
10785,sarawak,159,34249558,98.6749810174,_100,7,>100
10786,interviewing,159,34249717,98.6754391057,_100,12,>100
10787,ag,159,34249876,98.675897194,_100,2,>100
10788,tortillas,159,34250035,98.6763552823,_100,9,>100
10789,renting,159,34250194,98.6768133706,_100,7,>100
10790,stereo,159,34250353,98.677271459,_100,6,>100
10791,famed,159,34250512,98.6777295473,_100,5,>100
10792,stint,159,34250671,98.6781876356,_100,5,>100
10793,excerpts,159,34250830,98.6786457239,_100,8,>100
10794,survivor,159,34250989,98.6791038122,_100,8,>100
10795,innate,159,34251148,98.6795619005,_100,6,>100
10796,youngsters,159,34251307,98.6800199888,_100,10,>100
10797,density,159,34251466,98.6804780771,_100,7,>100
10798,emerges,159,34251625,98.6809361654,_100,7,>100
10799,sway,159,34251784,98.6813942537,_100,4,>100
10800,specified,159,34251943,98.681852342,_100,9,>100
10801,reflections,159,34252102,98.6823104303,_100,11,>100
10802,bradley,158,34252260,98.6827656376,_100,7,>100
10803,graph,158,34252418,98.6832208448,_100,5,>100
10804,clocks,158,34252576,98.6836760521,_100,6,>100
10805,toothpick,158,34252734,98.6841312593,_100,9,>100
10806,implication,158,34252892,98.6845864665,_100,11,>100
10807,enlightened,158,34253050,98.6850416738,_100,11,>100
10808,campaigning,158,34253208,98.685496881,_100,11,>100
10809,blurry,158,34253366,98.6859520883,_100,6,>100
10810,premature,158,34253524,98.6864072955,_100,9,>100
10811,famously,158,34253682,98.6868625028,_100,8,>100
10812,intrigue,158,34253840,98.68731771,_100,8,>100
10813,presses,158,34253998,98.6877729173,_100,7,>100
10814,objections,158,34254156,98.6882281245,_100,10,>100
10815,midwest,158,34254314,98.6886833318,_100,7,>100
10816,frogs,158,34254472,98.689138539,_100,5,>100
10817,crammed,158,34254630,98.6895937463,_100,7,>100
10818,burner,158,34254788,98.6900489535,_100,6,>100
10819,municipal,158,34254946,98.6905041608,_100,9,>100
10820,fossil,158,34255104,98.690959368,_100,6,>100
10821,minimize,158,34255262,98.6914145752,_100,8,>100
10822,pesto,158,34255420,98.6918697825,_100,5,>100
10823,cones,158,34255578,98.6923249897,_100,5,>100
10824,incentives,158,34255736,98.692780197,_100,10,>100
10825,clueless,158,34255894,98.6932354042,_100,8,>100
10826,cyber,158,34256052,98.6936906115,_100,5,>100
10827,tenure,158,34256210,98.6941458187,_100,6,>100
10828,craziness,158,34256368,98.694601026,_100,9,>100
10829,administrators,158,34256526,98.6950562332,_100,14,>100
10830,organising,158,34256684,98.6955114405,_100,10,>100
10831,pastors,158,34256842,98.6959666477,_100,7,>100
10832,bruised,158,34257000,98.696421855,_100,7,>100
10833,entrepreneur,158,34257158,98.6968770622,_100,12,>100
10834,abu,158,34257316,98.6973322695,_100,3,>100
10835,punching,158,34257474,98.6977874767,_100,8,>100
10836,strand,158,34257632,98.6982426839,_100,6,>100
10837,forbid,158,34257790,98.6986978912,_100,6,>100
10838,fukushima,157,34257947,98.6991502174,_100,9,>100
10839,marshmallows,157,34258104,98.6996025436,_100,12,>100
10840,urging,157,34258261,98.7000548698,_100,6,>100
10841,worm,157,34258418,98.7005071959,_100,4,>100
10842,swore,157,34258575,98.7009595221,_100,5,>100
10843,sworn,157,34258732,98.7014118483,_100,5,>100
10844,nolan,157,34258889,98.7018641745,_100,5,>100
10845,mixes,157,34259046,98.7023165007,_100,5,>100
10846,handwriting,157,34259203,98.7027688269,_100,11,>100
10847,pancake,157,34259360,98.7032211531,_100,7,>100
10848,rhythms,157,34259517,98.7036734793,_100,7,>100
10849,acute,157,34259674,98.7041258055,_100,5,>100
10850,inheritance,157,34259831,98.7045781316,_100,11,>100
10851,coordinated,157,34259988,98.7050304578,_100,11,>100
10852,floured,157,34260145,98.705482784,_100,7,>100
10853,imposing,157,34260302,98.7059351102,_100,8,>100
10854,treasured,157,34260459,98.7063874364,_100,9,>100
10855,drifted,157,34260616,98.7068397626,_100,7,>100
10856,businessman,157,34260773,98.7072920888,_100,11,>100
10857,enabling,157,34260930,98.707744415,_100,8,>100
10858,manufacture,157,34261087,98.7081967411,_100,11,>100
10859,scanning,157,34261244,98.7086490673,_100,8,>100
10860,klein,157,34261401,98.7091013935,_100,5,>100
10861,cushion,157,34261558,98.7095537197,_100,7,>100
10862,loki,157,34261715,98.7100060459,_100,4,>100
10863,credited,157,34261872,98.7104583721,_100,8,>100
10864,sebastian,157,34262029,98.7109106983,_100,9,>100
10865,unnatural,157,34262186,98.7113630245,_100,9,>100
10866,costa,157,34262343,98.7118153507,_100,5,>100
10867,tote,157,34262500,98.7122676768,_100,4,>100
10868,drafts,157,34262657,98.712720003,_100,6,>100
10869,haiku,157,34262814,98.7131723292,_100,5,>100
10870,mets,157,34262971,98.7136246554,_100,4,>100
10871,smash,157,34263128,98.7140769816,_100,5,>100
10872,historians,157,34263285,98.7145293078,_100,10,>100
10873,marty,157,34263442,98.714981634,_100,5,>100
10874,calcium,157,34263599,98.7154339602,_100,7,>100
10875,happiest,157,34263756,98.7158862863,_100,8,>100
10876,spx,157,34263913,98.7163386125,_100,3,>100
10877,undertaking,157,34264070,98.7167909387,_100,11,>100
10878,photographing,157,34264227,98.7172432649,_100,13,>100
10879,silky,156,34264383,98.71769271,_100,5,>100
10880,colonel,156,34264539,98.7181421552,_100,7,>100
10881,yankees,156,34264695,98.7185916003,_100,7,>100
10882,familiarity,156,34264851,98.7190410454,_100,11,>100
10883,undergo,156,34265007,98.7194904906,_100,7,>100
10884,implied,156,34265163,98.7199399357,_100,7,>100
10885,arabs,156,34265319,98.7203893808,_100,5,>100
10886,arctic,156,34265475,98.720838826,_100,6,>100
10887,lows,156,34265631,98.7212882711,_100,4,>100
10888,savory,156,34265787,98.7217377162,_100,6,>100
10889,disk,156,34265943,98.7221871613,_100,4,>100
10890,paula,156,34266099,98.7226366065,_100,5,>100
10891,voyage,156,34266255,98.7230860516,_100,6,>100
10892,expresses,156,34266411,98.7235354967,_100,9,>100
10893,moderation,156,34266567,98.7239849419,_100,10,>100
10894,caleb,156,34266723,98.724434387,_100,5,>100
10895,frantically,156,34266879,98.7248838321,_100,11,>100
10896,bumper,156,34267035,98.7253332772,_100,6,>100
10897,texted,156,34267191,98.7257827224,_100,6,>100
10898,mccain,156,34267347,98.7262321675,_100,6,>100
10899,freaks,156,34267503,98.7266816126,_100,6,>100
10900,progresses,156,34267659,98.7271310578,_100,10,>100
10901,avail,156,34267815,98.7275805029,_100,5,>100
10902,phillips,156,34267971,98.728029948,_100,8,>100
10903,parallels,156,34268127,98.7284793932,_100,9,>100
10904,afternoons,156,34268283,98.7289288383,_100,10,>100
10905,downloads,156,34268439,98.7293782834,_100,9,>100
10906,researcher,156,34268595,98.7298277285,_100,10,>100
10907,postcards,156,34268751,98.7302771737,_100,9,>100
10908,unbelievably,156,34268907,98.7307266188,_100,12,>100
10909,weeping,156,34269063,98.7311760639,_100,7,>100
10910,boasts,156,34269219,98.7316255091,_100,6,>100
10911,humanitarian,156,34269375,98.7320749542,_100,12,>100
10912,sauces,156,34269531,98.7325243993,_100,6,>100
10913,collaborative,156,34269687,98.7329738445,_100,13,>100
10914,intro,156,34269843,98.7334232896,_100,5,>100
10915,lashes,156,34269999,98.7338727347,_100,6,>100
10916,envision,156,34270155,98.7343221798,_100,8,>100
10917,cranberries,156,34270311,98.734771625,_100,11,>100
10918,audition,156,34270467,98.7352210701,_100,8,>100
10919,psychiatric,156,34270623,98.7356705152,_100,11,>100
10920,endearing,156,34270779,98.7361199604,_100,9,>100
10921,insecure,156,34270935,98.7365694055,_100,8,>100
10922,mj,156,34271091,98.7370188506,_100,2,>100
10923,brotherhood,156,34271247,98.7374682958,_100,11,>100
10924,numbered,156,34271403,98.7379177409,_100,8,>100
10925,resisted,156,34271559,98.738367186,_100,8,>100
10926,attracting,156,34271715,98.7388166311,_100,10,>100
10927,token,156,34271871,98.7392660763,_100,5,>100
10928,deserted,156,34272027,98.7397155214,_100,8,>100
10929,radically,156,34272183,98.7401649665,_100,9,>100
10930,cookbooks,156,34272339,98.7406144117,_100,9,>100
10931,westminster,156,34272495,98.7410638568,_100,11,>100
10932,commons,155,34272650,98.7415104209,_100,7,>100
10933,zipper,155,34272805,98.7419569849,_100,6,>100
10934,reviewers,155,34272960,98.742403549,_100,9,>100
10935,nutmeg,155,34273115,98.7428501131,_100,6,>100
10936,winston,155,34273270,98.7432966771,_100,7,>100
10937,lad,155,34273425,98.7437432412,_100,3,>100
10938,dwelling,155,34273580,98.7441898053,_100,8,>100
10939,pasture,155,34273735,98.7446363694,_100,7,>100
10940,hideous,155,34273890,98.7450829334,_100,7,>100
10941,specialized,155,34274045,98.7455294975,_100,11,>100
10942,smokers,155,34274200,98.7459760616,_100,7,>100
10943,realms,155,34274355,98.7464226256,_100,6,>100
10944,elegance,155,34274510,98.7468691897,_100,8,>100
10945,implementing,155,34274665,98.7473157538,_100,12,>100
10946,bookshelf,155,34274820,98.7477623179,_100,9,>100
10947,shutter,155,34274975,98.7482088819,_100,7,>100
10948,screenplay,155,34275130,98.748655446,_100,10,>100
10949,provocative,155,34275285,98.7491020101,_100,11,>100
10950,hairy,155,34275440,98.7495485741,_100,5,>100
10951,confessed,155,34275595,98.7499951382,_100,9,>100
10952,troy,155,34275750,98.7504417023,_100,4,>100
10953,acquiring,155,34275905,98.7508882664,_100,9,>100
10954,colony,155,34276060,98.7513348304,_100,6,>100
10955,bounced,155,34276215,98.7517813945,_100,7,>100
10956,heartache,155,34276370,98.7522279586,_100,9,>100
10957,polishes,155,34276525,98.7526745226,_100,8,>100
10958,queries,155,34276680,98.7531210867,_100,7,>100
10959,reese,155,34276835,98.7535676508,_100,5,>100
10960,timer,155,34276990,98.7540142149,_100,5,>100
10961,fullest,155,34277145,98.7544607789,_100,7,>100
10962,contentment,155,34277300,98.754907343,_100,11,>100
10963,scratched,155,34277455,98.7553539071,_100,9,>100
10964,liberation,155,34277610,98.7558004711,_100,10,>100
10965,ceramic,155,34277765,98.7562470352,_100,7,>100
10966,illustrates,155,34277920,98.7566935993,_100,11,>100
10967,cody,155,34278075,98.7571401634,_100,4,>100
10968,minerals,155,34278230,98.7575867274,_100,8,>100
10969,devoured,155,34278385,98.7580332915,_100,8,>100
10970,cheered,155,34278540,98.7584798556,_100,7,>100
10971,dame,155,34278695,98.7589264196,_100,4,>100
10972,nationalism,155,34278850,98.7593729837,_100,11,>100
10973,postings,155,34279005,98.7598195478,_100,8,>100
10974,uneasy,155,34279160,98.7602661119,_100,6,>100
10975,prompts,155,34279315,98.7607126759,_100,7,>100
10976,tier,155,34279470,98.76115924,_100,4,>100
10977,salaries,155,34279625,98.7616058041,_100,8,>100
10978,subtly,155,34279780,98.7620523681,_100,6,>100
10979,lemonade,155,34279935,98.7624989322,_100,8,>100
10980,epa,155,34280090,98.7629454963,_100,3,>100
10981,livestock,155,34280245,98.7633920604,_100,9,>100
10982,divisions,155,34280400,98.7638386244,_100,9,>100
10983,wedges,155,34280555,98.7642851885,_100,6,>100
10984,guarantees,155,34280710,98.7647317526,_100,10,>100
10985,mindful,155,34280865,98.7651783166,_100,7,>100
10986,whirlwind,155,34281020,98.7656248807,_100,9,>100
10987,provincial,155,34281175,98.7660714448,_100,10,>100
10988,washer,154,34281329,98.7665151278,_100,6,>100
10989,predecessor,154,34281483,98.7669588108,_100,11,>100
10990,glare,154,34281637,98.7674024938,_100,5,>100
10991,buckets,154,34281791,98.7678461768,_100,7,>100
10992,separating,154,34281945,98.7682898598,_100,10,>100
10993,shutting,154,34282099,98.7687335429,_100,8,>100
10994,chronicles,154,34282253,98.7691772259,_100,10,>100
10995,testify,154,34282407,98.7696209089,_100,7,>100
10996,hierarchy,154,34282561,98.7700645919,_100,9,>100
10997,vines,154,34282715,98.7705082749,_100,5,>100
10998,mound,154,34282869,98.7709519579,_100,5,>100
10999,separates,154,34283023,98.7713956409,_100,9,>100
11000,contend,154,34283177,98.7718393239,_100,7,>100
11001,dove,154,34283331,98.772283007,_100,4,>100
11002,mills,154,34283485,98.77272669,_100,5,>100
11003,plagued,154,34283639,98.773170373,_100,7,>100
11004,obedient,154,34283793,98.773614056,_100,8,>100
11005,mousse,154,34283947,98.774057739,_100,6,>100
11006,societal,154,34284101,98.774501422,_100,8,>100
11007,peaches,154,34284255,98.774945105,_100,7,>100
11008,ottawa,154,34284409,98.775388788,_100,6,>100
11009,palms,154,34284563,98.7758324711,_100,5,>100
11010,prohibited,154,34284717,98.7762761541,_100,10,>100
11011,abound,154,34284871,98.7767198371,_100,6,>100
11012,unite,154,34285025,98.7771635201,_100,5,>100
11013,austria,154,34285179,98.7776072031,_100,7,>100
11014,gazing,154,34285333,98.7780508861,_100,6,>100
11015,mats,154,34285487,98.7784945691,_100,4,>100
11016,herman,154,34285641,98.7789382521,_100,6,>100
11017,begs,154,34285795,98.7793819352,_100,4,>100
11018,kris,154,34285949,98.7798256182,_100,4,>100
11019,appliances,154,34286103,98.7802693012,_100,10,>100
11020,decadent,154,34286257,98.7807129842,_100,8,>100
11021,hunters,154,34286411,98.7811566672,_100,7,>100
11022,gina,154,34286565,98.7816003502,_100,4,>100
11023,tsunami,153,34286718,98.7820411522,_100,7,>100
11024,puppet,153,34286871,98.7824819541,_100,6,>100
11025,highs,153,34287024,98.7829227561,_100,5,>100
11026,seize,153,34287177,98.783363558,_100,5,>100
11027,lebanon,153,34287330,98.78380436,_100,7,>100
11028,quantum,153,34287483,98.7842451619,_100,7,>100
11029,anti,153,34287636,98.7846859639,_100,4,>100
11030,counselor,153,34287789,98.7851267659,_100,9,>100
11031,bumped,153,34287942,98.7855675678,_100,6,>100
11032,blunt,153,34288095,98.7860083698,_100,5,>100
11033,anticipating,153,34288248,98.7864491717,_100,12,>100
11034,mojo,153,34288401,98.7868899737,_100,4,>100
11035,slew,153,34288554,98.7873307756,_100,4,>100
11036,mali,153,34288707,98.7877715776,_100,4,>100
11037,folders,153,34288860,98.7882123795,_100,7,>100
11038,tremendously,153,34289013,98.7886531815,_100,12,>100
11039,varies,153,34289166,98.7890939834,_100,6,>100
11040,beauties,153,34289319,98.7895347854,_100,8,>100
11041,downfall,153,34289472,98.7899755874,_100,8,>100
11042,crashes,153,34289625,98.7904163893,_100,7,>100
11043,uphold,153,34289778,98.7908571913,_100,6,>100
11044,bookstores,153,34289931,98.7912979932,_100,10,>100
11045,operational,153,34290084,98.7917387952,_100,11,>100
11046,shuttle,153,34290237,98.7921795971,_100,7,>100
11047,statues,153,34290390,98.7926203991,_100,7,>100
11048,dearest,153,34290543,98.793061201,_100,7,>100
11049,dreary,153,34290696,98.793502003,_100,6,>100
11050,accuse,153,34290849,98.7939428049,_100,6,>100
11051,presently,153,34291002,98.7943836069,_100,9,>100
11052,dystopian,153,34291155,98.7948244088,_100,9,>100
11053,outta,153,34291308,98.7952652108,_100,5,>100
11054,economically,153,34291461,98.7957060128,_100,12,>100
11055,delta,153,34291614,98.7961468147,_100,5,>100
11056,scalloped,153,34291767,98.7965876167,_100,9,>100
11057,disciplined,153,34291920,98.7970284186,_100,11,>100
11058,spouses,153,34292073,98.7974692206,_100,7,>100
11059,informs,153,34292226,98.7979100225,_100,7,>100
11060,islamist,153,34292379,98.7983508245,_100,8,>100
11061,correspondence,153,34292532,98.7987916264,_100,14,>100
11062,jacobs,153,34292685,98.7992324284,_100,6,>100
11063,coordinate,153,34292838,98.7996732303,_100,10,>100
11064,strained,153,34292991,98.8001140323,_100,8,>100
11065,oversight,153,34293144,98.8005548343,_100,9,>100
11066,fluff,153,34293297,98.8009956362,_100,5,>100
11067,marion,153,34293450,98.8014364382,_100,6,>100
11068,perseverance,152,34293602,98.8018743591,_100,12,>100
11069,corpse,152,34293754,98.80231228,_100,6,>100
11070,nailed,152,34293906,98.8027502008,_100,6,>100
11071,atrocities,152,34294058,98.8031881217,_100,10,>100
11072,erase,152,34294210,98.8036260426,_100,5,>100
11073,instagram,152,34294362,98.8040639635,_100,9,>100
11074,gruesome,152,34294514,98.8045018844,_100,8,>100
11075,hugging,152,34294666,98.8049398053,_100,7,>100
11076,aa,152,34294818,98.8053777262,_100,2,>100
11077,horrendous,152,34294970,98.8058156471,_100,10,>100
11078,mic,152,34295122,98.806253568,_100,3,>100
11079,beets,152,34295274,98.8066914889,_100,5,>100
11080,recruiting,152,34295426,98.8071294098,_100,10,>100
11081,charismatic,152,34295578,98.8075673307,_100,11,>100
11082,roaring,152,34295730,98.8080052516,_100,7,>100
11083,cosy,152,34295882,98.8084431725,_100,4,>100
11084,whine,152,34296034,98.8088810934,_100,5,>100
11085,supermarkets,152,34296186,98.8093190143,_100,12,>100
11086,villagers,152,34296338,98.8097569352,_100,9,>100
11087,depiction,152,34296490,98.8101948561,_100,9,>100
11088,sampled,152,34296642,98.810632777,_100,7,>100
11089,tins,152,34296794,98.8110706979,_100,4,>100
11090,investigated,152,34296946,98.8115086188,_100,12,>100
11091,floated,152,34297098,98.8119465397,_100,7,>100
11092,lyrical,152,34297250,98.8123844605,_100,7,>100
11093,approx,152,34297402,98.8128223814,_100,6,>100
11094,richness,152,34297554,98.8132603023,_100,8,>100
11095,concentrating,152,34297706,98.8136982232,_100,13,>100
11096,periodically,152,34297858,98.8141361441,_100,12,>100
11097,inventive,152,34298010,98.814574065,_100,9,>100
11098,misunderstood,152,34298162,98.8150119859,_100,13,>100
11099,unstable,152,34298314,98.8154499068,_100,8,>100
11100,contractor,152,34298466,98.8158878277,_100,10,>100
11101,flirting,152,34298618,98.8163257486,_100,8,>100
11102,leeds,152,34298770,98.8167636695,_100,5,>100
11103,clumsy,152,34298922,98.8172015904,_100,6,>100
11104,twentieth,152,34299074,98.8176395113,_100,9,>100
11105,diminished,152,34299226,98.8180774322,_100,10,>100
11106,smoky,152,34299378,98.8185153531,_100,5,>100
11107,froze,151,34299529,98.8189503929,_100,5,>100
11108,tuck,151,34299680,98.8193854328,_100,4,>100
11109,pronounce,151,34299831,98.8198204726,_100,9,>100
11110,brent,151,34299982,98.8202555124,_100,5,>100
11111,masked,151,34300133,98.8206905523,_100,6,>100
11112,parted,151,34300284,98.8211255921,_100,6,>100
11113,beginner,151,34300435,98.8215606319,_100,8,>100
11114,elect,151,34300586,98.8219956718,_100,5,>100
11115,cheapest,151,34300737,98.8224307116,_100,8,>100
11116,soups,151,34300888,98.8228657515,_100,5,>100
11117,straps,151,34301039,98.8233007913,_100,6,>100
11118,oath,151,34301190,98.8237358311,_100,4,>100
11119,malty,151,34301341,98.824170871,_100,5,>100
11120,havoc,151,34301492,98.8246059108,_100,5,>100
11121,tweaking,151,34301643,98.8250409506,_100,8,>100
11122,pipeline,151,34301794,98.8254759905,_100,8,>100
11123,loaves,151,34301945,98.8259110303,_100,6,>100
11124,meatballs,151,34302096,98.8263460702,_100,9,>100
11125,banging,151,34302247,98.82678111,_100,7,>100
11126,toilets,151,34302398,98.8272161498,_100,7,>100
11127,postal,151,34302549,98.8276511897,_100,6,>100
11128,simplistic,151,34302700,98.8280862295,_100,10,>100
11129,menus,151,34302851,98.8285212693,_100,5,>100
11130,malay,151,34303002,98.8289563092,_100,5,>100
11131,woken,151,34303153,98.829391349,_100,5,>100
11132,immature,151,34303304,98.8298263889,_100,8,>100
11133,garments,151,34303455,98.8302614287,_100,8,>100
11134,boarded,151,34303606,98.8306964685,_100,7,>100
11135,spared,151,34303757,98.8311315084,_100,6,>100
11136,dunno,151,34303908,98.8315665482,_100,5,>100
11137,saturdays,151,34304059,98.832001588,_100,9,>100
11138,wired,151,34304210,98.8324366279,_100,5,>100
11139,renovation,151,34304361,98.8328716677,_100,10,>100
11140,reproduce,151,34304512,98.8333067076,_100,9,>100
11141,vermont,151,34304663,98.8337417474,_100,7,>100
11142,jupiter,151,34304814,98.8341767872,_100,7,>100
11143,repentance,151,34304965,98.8346118271,_100,10,>100
11144,vicinity,151,34305116,98.8350468669,_100,8,>100
11145,snuggle,151,34305267,98.8354819067,_100,7,>100
11146,oregano,151,34305418,98.8359169466,_100,7,>100
11147,recurring,151,34305569,98.8363519864,_100,9,>100
11148,gardener,151,34305720,98.8367870262,_100,8,>100
11149,unreasonable,151,34305871,98.8372220661,_100,12,>100
11150,youths,151,34306022,98.8376571059,_100,6,>100
11151,shaky,151,34306173,98.8380921458,_100,5,>100
11152,alarming,151,34306324,98.8385271856,_100,8,>100
11153,shoppers,151,34306475,98.8389622254,_100,8,>100
11154,evidently,150,34306625,98.8393943842,_100,9,>100
11155,evils,150,34306775,98.839826543,_100,5,>100
11156,medals,150,34306925,98.8402587018,_100,6,>100
11157,crumbling,150,34307075,98.8406908605,_100,9,>100
11158,penned,150,34307225,98.8411230193,_100,6,>100
11159,agreeing,150,34307375,98.8415551781,_100,8,>100
11160,transfers,150,34307525,98.8419873369,_100,9,>100
11161,teeny,150,34307675,98.8424194957,_100,5,>100
11162,tissues,150,34307825,98.8428516544,_100,7,>100
11163,supervisor,150,34307975,98.8432838132,_100,10,>100
11164,secrecy,150,34308125,98.843715972,_100,7,>100
11165,powerless,150,34308275,98.8441481308,_100,9,>100
11166,condemnation,150,34308425,98.8445802896,_100,12,>100
11167,semi,150,34308575,98.8450124483,_100,4,>100
11168,richest,150,34308725,98.8454446071,_100,7,>100
11169,aspire,150,34308875,98.8458767659,_100,6,>100
11170,shaw,150,34309025,98.8463089247,_100,4,>100
11171,bidding,150,34309175,98.8467410834,_100,7,>100
11172,whispering,150,34309325,98.8471732422,_100,10,>100
11173,melanie,150,34309475,98.847605401,_100,7,>100
11174,daytime,150,34309625,98.8480375598,_100,7,>100
11175,recognizable,150,34309775,98.8484697186,_100,12,>100
11176,gatherings,150,34309925,98.8489018773,_100,10,>100
11177,hateful,150,34310075,98.8493340361,_100,7,>100
11178,labelled,150,34310225,98.8497661949,_100,8,>100
11179,lori,150,34310375,98.8501983537,_100,4,>100
11180,shores,150,34310525,98.8506305125,_100,6,>100
11181,dietary,150,34310675,98.8510626712,_100,7,>100
11182,150,150,34310825,98.85149483,_100,3,>100
11183,skiing,150,34310975,98.8519269888,_100,6,>100
11184,sharply,150,34311125,98.8523591476,_100,7,>100
11185,fooled,150,34311275,98.8527913063,_100,6,>100
11186,au,150,34311425,98.8532234651,_100,2,>100
11187,commodity,150,34311575,98.8536556239,_100,9,>100
11188,portal,150,34311725,98.8540877827,_100,6,>100
11189,vibration,150,34311875,98.8545199415,_100,9,>100
11190,pumpkins,150,34312025,98.8549521002,_100,8,>100
11191,clone,150,34312175,98.855384259,_100,5,>100
11192,jung,150,34312325,98.8558164178,_100,4,>100
11193,performs,150,34312475,98.8562485766,_100,8,>100
11194,pickle,150,34312625,98.8566807354,_100,6,>100
11195,fasting,150,34312775,98.8571128941,_100,7,>100
11196,patriotic,150,34312925,98.8575450529,_100,9,>100
11197,spoilers,150,34313075,98.8579772117,_100,8,>100
11198,modes,150,34313225,98.8584093705,_100,5,>100
11199,postage,150,34313375,98.8588415292,_100,7,>100
11200,swung,150,34313525,98.859273688,_100,5,>100
11201,migration,149,34313674,98.8597029657,_100,9,>100
11202,interference,149,34313823,98.8601322435,_100,12,>100
11203,protagonists,149,34313972,98.8605615212,_100,12,>100
11204,surrounds,149,34314121,98.8609907989,_100,9,>100
11205,pristine,149,34314270,98.8614200766,_100,8,>100
11206,inmates,149,34314419,98.8618493543,_100,7,>100
11207,crucified,149,34314568,98.8622786321,_100,9,>100
11208,insulting,149,34314717,98.8627079098,_100,9,>100
11209,burke,149,34314866,98.8631371875,_100,5,>100
11210,courtney,149,34315015,98.8635664652,_100,8,>100
11211,mindless,149,34315164,98.8639957429,_100,8,>100
11212,exhibited,149,34315313,98.8644250207,_100,9,>100
11213,futile,149,34315462,98.8648542984,_100,6,>100
11214,destroys,149,34315611,98.8652835761,_100,8,>100
11215,intends,149,34315760,98.8657128538,_100,7,>100
11216,lgbt,149,34315909,98.8661421315,_100,4,>100
11217,fortnight,149,34316058,98.8665714093,_100,9,>100
11218,slate,149,34316207,98.867000687,_100,5,>100
11219,inbox,149,34316356,98.8674299647,_100,5,>100
11220,alberta,149,34316505,98.8678592424,_100,7,>100
11221,busted,149,34316654,98.8682885201,_100,6,>100
11222,repeats,149,34316803,98.8687177979,_100,7,>100
11223,tyranny,149,34316952,98.8691470756,_100,7,>100
11224,elephants,149,34317101,98.8695763533,_100,9,>100
11225,wholesale,149,34317250,98.870005631,_100,9,>100
11226,scrapping,149,34317399,98.8704349087,_100,9,>100
11227,heidi,149,34317548,98.8708641865,_100,5,>100
11228,protesting,149,34317697,98.8712934642,_100,10,>100
11229,overtime,149,34317846,98.8717227419,_100,8,>100
11230,perched,149,34317995,98.8721520196,_100,7,>100
11231,subsidies,149,34318144,98.8725812973,_100,9,>100
11232,playoffs,149,34318293,98.8730105751,_100,8,>100
11233,morrison,149,34318442,98.8734398528,_100,8,>100
11234,barefoot,149,34318591,98.8738691305,_100,8,>100
11235,poisoning,149,34318740,98.8742984082,_100,9,>100
11236,linger,149,34318889,98.8747276859,_100,6,>100
11237,contracted,149,34319038,98.8751569637,_100,10,>100
11238,cruz,149,34319187,98.8755862414,_100,4,>100
11239,stereotype,149,34319336,98.8760155191,_100,10,>100
11240,quebec,148,34319484,98.8764419158,_100,6,>100
11241,disconnected,148,34319632,98.8768683124,_100,12,>100
11242,everlasting,148,34319780,98.8772947091,_100,11,>100
11243,pornography,148,34319928,98.8777211058,_100,11,>100
11244,nutshell,148,34320076,98.8781475024,_100,8,>100
11245,accidental,148,34320224,98.8785738991,_100,10,>100
11246,piper,148,34320372,98.8790002957,_100,5,>100
11247,que,148,34320520,98.8794266924,_100,3,>100
11248,activism,148,34320668,98.8798530891,_100,8,>100
11249,marinade,148,34320816,98.8802794857,_100,8,>100
11250,incarnation,148,34320964,98.8807058824,_100,11,>100
11251,leah,148,34321112,98.881132279,_100,4,>100
11252,mileage,148,34321260,98.8815586757,_100,7,>100
11253,outlines,148,34321408,98.8819850724,_100,8,>100
11254,durham,148,34321556,98.882411469,_100,6,>100
11255,cardinal,148,34321704,98.8828378657,_100,8,>100
11256,induced,148,34321852,98.8832642624,_100,7,>100
11257,rave,148,34322000,98.883690659,_100,4,>100
11258,adolescent,148,34322148,98.8841170557,_100,10,>100
11259,digestive,148,34322296,98.8845434523,_100,9,>100
11260,blurred,148,34322444,98.884969849,_100,7,>100
11261,beige,148,34322592,98.8853962457,_100,5,>100
11262,wiser,148,34322740,98.8858226423,_100,5,>100
11263,emptiness,148,34322888,98.886249039,_100,9,>100
11264,idle,148,34323036,98.8866754356,_100,4,>100
11265,chile,148,34323184,98.8871018323,_100,5,>100
11266,knocks,148,34323332,98.887528229,_100,6,>100
11267,cloak,148,34323480,98.8879546256,_100,5,>100
11268,sobbing,148,34323628,98.8883810223,_100,7,>100
11269,descriptive,148,34323776,98.888807419,_100,11,>100
11270,hans,148,34323924,98.8892338156,_100,4,>100
11271,laboratory,148,34324072,98.8896602123,_100,10,>100
11272,toxins,148,34324220,98.8900866089,_100,6,>100
11273,futures,148,34324368,98.8905130056,_100,7,>100
11274,yoochun,148,34324516,98.8909394023,_100,7,>100
11275,loops,148,34324664,98.8913657989,_100,5,>100
11276,sausages,148,34324812,98.8917921956,_100,8,>100
11277,predators,148,34324960,98.8922185922,_100,9,>100
11278,taiwan,148,34325108,98.8926449889,_100,6,>100
11279,snippets,148,34325256,98.8930713856,_100,8,>100
11280,ceremonies,148,34325404,98.8934977822,_100,10,>100
11281,drinker,148,34325552,98.8939241789,_100,7,>100
11282,unforgettable,148,34325700,98.8943505756,_100,13,>100
11283,bun,148,34325848,98.8947769722,_100,3,>100
11284,resemblance,148,34325996,98.8952033689,_100,11,>100
11285,endeavors,147,34326143,98.8956268845,_100,9,>100
11286,calculations,147,34326290,98.8960504001,_100,12,>100
11287,knitted,147,34326437,98.8964739157,_100,7,>100
11288,sunk,147,34326584,98.8968974313,_100,4,>100
11289,repent,147,34326731,98.8973209469,_100,6,>100
11290,nigerian,147,34326878,98.8977444625,_100,8,>100
11291,plumbing,147,34327025,98.8981679781,_100,8,>100
11292,allison,147,34327172,98.8985914937,_100,7,>100
11293,tractor,147,34327319,98.8990150093,_100,7,>100
11294,alison,147,34327466,98.8994385249,_100,6,>100
11295,filtered,147,34327613,98.8998620405,_100,8,>100
11296,replicate,147,34327760,98.9002855561,_100,9,>100
11297,polar,147,34327907,98.9007090717,_100,5,>100
11298,longtime,147,34328054,98.9011325873,_100,8,>100
11299,evidenced,147,34328201,98.9015561029,_100,9,>100
11300,cosmetics,147,34328348,98.9019796185,_100,9,>100
11301,emergence,147,34328495,98.9024031341,_100,9,>100
11302,spilling,147,34328642,98.9028266497,_100,8,>100
11303,novice,147,34328789,98.9032501653,_100,6,>100
11304,armstrong,147,34328936,98.9036736809,_100,9,>100
11305,scotch,147,34329083,98.9040971965,_100,6,>100
11306,royalties,147,34329230,98.9045207121,_100,9,>100
11307,uneven,147,34329377,98.9049442277,_100,6,>100
11308,cushions,147,34329524,98.9053677434,_100,8,>100
11309,lousy,147,34329671,98.905791259,_100,5,>100
11310,misunderstanding,147,34329818,98.9062147746,_100,16,>100
11311,squirrel,147,34329965,98.9066382902,_100,8,>100
11312,moan,147,34330112,98.9070618058,_100,4,>100
11313,screws,147,34330259,98.9074853214,_100,6,>100
11314,promo,147,34330406,98.907908837,_100,5,>100
11315,hypothesis,147,34330553,98.9083323526,_100,10,>100
11316,diminish,147,34330700,98.9087558682,_100,8,>100
11317,slots,147,34330847,98.9091793838,_100,5,>100
11318,dared,147,34330994,98.9096028994,_100,5,>100
11319,outraged,147,34331141,98.910026415,_100,8,>100
11320,slippers,147,34331288,98.9104499306,_100,8,>100
11321,stacks,147,34331435,98.9108734462,_100,6,>100
11322,plum,147,34331582,98.9112969618,_100,4,>100
11323,possesses,147,34331729,98.9117204774,_100,9,>100
11324,deity,146,34331875,98.9121411119,_100,5,>100
11325,messenger,146,34332021,98.9125617465,_100,9,>100
11326,kittens,146,34332167,98.912982381,_100,7,>100
11327,paws,146,34332313,98.9134030156,_100,4,>100
11328,awaited,146,34332459,98.9138236501,_100,7,>100
11329,wrinkles,146,34332605,98.9142442847,_100,8,>100
11330,blindly,146,34332751,98.9146649192,_100,7,>100
11331,ss,146,34332897,98.9150855538,_100,2,>100
11332,resides,146,34333043,98.9155061883,_100,7,>100
11333,lids,146,34333189,98.9159268228,_100,4,>100
11334,saut,146,34333335,98.9163474574,_100,4,>100
11335,organizer,146,34333481,98.9167680919,_100,9,>100
11336,insecurity,146,34333627,98.9171887265,_100,10,>100
11337,opener,146,34333773,98.917609361,_100,6,>100
11338,sylvia,146,34333919,98.9180299956,_100,6,>100
11339,caesar,146,34334065,98.9184506301,_100,6,>100
11340,diplomatic,146,34334211,98.9188712647,_100,10,>100
11341,correctness,146,34334357,98.9192918992,_100,11,>100
11342,ropes,146,34334503,98.9197125337,_100,5,>100
11343,suburb,146,34334649,98.9201331683,_100,6,>100
11344,purposely,146,34334795,98.9205538028,_100,9,>100
11345,kerry,146,34334941,98.9209744374,_100,5,>100
11346,triangles,146,34335087,98.9213950719,_100,9,>100
11347,bending,146,34335233,98.9218157065,_100,7,>100
11348,floods,146,34335379,98.922236341,_100,6,>100
11349,cooperate,146,34335525,98.9226569756,_100,9,>100
11350,engineered,146,34335671,98.9230776101,_100,10,>100
11351,moods,146,34335817,98.9234982446,_100,5,>100
11352,hack,146,34335963,98.9239188792,_100,4,>100
11353,machinery,146,34336109,98.9243395137,_100,9,>100
11354,stimulus,146,34336255,98.9247601483,_100,8,>100
11355,wondrous,146,34336401,98.9251807828,_100,8,>100
11356,missile,146,34336547,98.9256014174,_100,7,>100
11357,ph,146,34336693,98.9260220519,_100,2,>100
11358,swelling,146,34336839,98.9264426865,_100,8,>100
11359,childish,146,34336985,98.926863321,_100,8,>100
11360,pretended,146,34337131,98.9272839555,_100,9,>100
11361,vogue,146,34337277,98.9277045901,_100,5,>100
11362,cardiff,146,34337423,98.9281252246,_100,7,>100
11363,carving,146,34337569,98.9285458592,_100,7,>100
11364,specifics,146,34337715,98.9289664937,_100,9,>100
11365,sniff,146,34337861,98.9293871283,_100,5,>100
11366,flickr,146,34338007,98.9298077628,_100,6,>100
11367,cravings,146,34338153,98.9302283974,_100,8,>100
11368,frances,146,34338299,98.9306490319,_100,7,>100
11369,brakes,146,34338445,98.9310696664,_100,6,>100
11370,envisioned,146,34338591,98.931490301,_100,10,>100
11371,paranoia,146,34338737,98.9319109355,_100,8,>100
11372,vowed,146,34338883,98.9323315701,_100,5,>100
11373,orbit,145,34339028,98.9327493236,_100,5,>100
11374,dioxide,145,34339173,98.933167077,_100,7,>100
11375,jihad,145,34339318,98.9335848305,_100,5,>100
11376,snowflakes,145,34339463,98.934002584,_100,10,>100
11377,breads,145,34339608,98.9344203375,_100,6,>100
11378,vanessa,145,34339753,98.934838091,_100,7,>100
11379,scarce,145,34339898,98.9352558445,_100,6,>100
11380,gamers,145,34340043,98.935673598,_100,6,>100
11381,pickles,145,34340188,98.9360913515,_100,7,>100
11382,diesel,145,34340333,98.9365091049,_100,6,>100
11383,nebraska,145,34340478,98.9369268584,_100,8,>100
11384,bracelets,145,34340623,98.9373446119,_100,9,>100
11385,referendum,145,34340768,98.9377623654,_100,10,>100
11386,graders,145,34340913,98.9381801189,_100,7,>100
11387,bubbling,145,34341058,98.9385978724,_100,8,>100
11388,alternating,145,34341203,98.9390156259,_100,11,>100
11389,crooked,145,34341348,98.9394333793,_100,7,>100
11390,ramp,145,34341493,98.9398511328,_100,4,>100
11391,rods,145,34341638,98.9402688863,_100,4,>100
11392,panicked,145,34341783,98.9406866398,_100,8,>100
11393,cursing,145,34341928,98.9411043933,_100,7,>100
11394,psychiatrist,145,34342073,98.9415221468,_100,12,>100
11395,monks,145,34342218,98.9419399003,_100,5,>100
11396,roam,145,34342363,98.9423576537,_100,4,>100
11397,dinosaurs,145,34342508,98.9427754072,_100,9,>100
11398,tying,145,34342653,98.9431931607,_100,5,>100
11399,quarterback,145,34342798,98.9436109142,_100,11,>100
11400,dumplings,145,34342943,98.9440286677,_100,9,>100
11401,openness,145,34343088,98.9444464212,_100,8,>100
11402,pharmacy,145,34343233,98.9448641747,_100,8,>100
11403,sherlock,145,34343378,98.9452819281,_100,8,>100
11404,charleston,145,34343523,98.9456996816,_100,10,>100
11405,librarian,145,34343668,98.9461174351,_100,9,>100
11406,weep,145,34343813,98.9465351886,_100,4,>100
11407,feminism,145,34343958,98.9469529421,_100,8,>100
11408,undead,145,34344103,98.9473706956,_100,6,>100
11409,dealers,145,34344248,98.9477884491,_100,7,>100
11410,trays,145,34344393,98.9482062025,_100,5,>100
11411,draining,145,34344538,98.948623956,_100,8,>100
11412,flawless,145,34344683,98.9490417095,_100,8,>100
11413,urges,145,34344828,98.949459463,_100,5,>100
11414,toured,145,34344973,98.9498772165,_100,6,>100
11415,garcia,145,34345118,98.95029497,_100,6,>100
11416,tiffany,145,34345263,98.9507127235,_100,7,>100
11417,traps,145,34345408,98.9511304769,_100,5,>100
11418,sixties,145,34345553,98.9515482304,_100,7,>100
11419,voucher,145,34345698,98.9519659839,_100,7,>100
11420,voila,145,34345843,98.9523837374,_100,5,>100
11421,misguided,144,34345987,98.9527986098,_100,9,>100
11422,copying,144,34346131,98.9532134823,_100,7,>100
11423,reps,144,34346275,98.9536283547,_100,4,>100
11424,cuttlebug,144,34346419,98.9540432271,_100,9,>100
11425,uncover,144,34346563,98.9544580995,_100,7,>100
11426,liable,144,34346707,98.954872972,_100,6,>100
11427,casualties,144,34346851,98.9552878444,_100,10,>100
11428,detached,144,34346995,98.9557027168,_100,8,>100
11429,praises,144,34347139,98.9561175893,_100,7,>100
11430,echoed,144,34347283,98.9565324617,_100,6,>100
11431,removes,144,34347427,98.9569473341,_100,7,>100
11432,fermentation,144,34347571,98.9573622065,_100,12,>100
11433,nesting,144,34347715,98.957777079,_100,7,>100
11434,inhabit,144,34347859,98.9581919514,_100,7,>100
11435,securing,144,34348003,98.9586068238,_100,8,>100
11436,glamour,144,34348147,98.9590216962,_100,7,>100
11437,shanghai,144,34348291,98.9594365687,_100,8,>100
11438,seminars,144,34348435,98.9598514411,_100,8,>100
11439,ensures,144,34348579,98.9602663135,_100,7,>100
11440,cosmic,144,34348723,98.960681186,_100,6,>100
11441,chap,144,34348867,98.9610960584,_100,4,>100
11442,rehabilitation,144,34349011,98.9615109308,_100,14,>100
11443,bailout,144,34349155,98.9619258032,_100,7,>100
11444,patron,144,34349299,98.9623406757,_100,6,>100
11445,strapped,144,34349443,98.9627555481,_100,8,>100
11446,halves,144,34349587,98.9631704205,_100,6,>100
11447,granola,144,34349731,98.9635852929,_100,7,>100
11448,novella,144,34349875,98.9640001654,_100,7,>100
11449,awakened,144,34350019,98.9644150378,_100,8,>100
11450,fragments,144,34350163,98.9648299102,_100,9,>100
11451,eternally,144,34350307,98.9652447827,_100,9,>100
11452,recycle,144,34350451,98.9656596551,_100,7,>100
11453,overlap,144,34350595,98.9660745275,_100,7,>100
11454,trivial,144,34350739,98.9664893999,_100,7,>100
11455,literacy,144,34350883,98.9669042724,_100,8,>100
11456,murderous,144,34351027,98.9673191448,_100,9,>100
11457,whopping,144,34351171,98.9677340172,_100,8,>100
11458,littered,144,34351315,98.9681488896,_100,8,>100
11459,coworkers,144,34351459,98.9685637621,_100,9,>100
11460,oppressive,144,34351603,98.9689786345,_100,10,>100
11461,replica,144,34351747,98.9693935069,_100,7,>100
11462,hehe,144,34351891,98.9698083794,_100,4,>100
11463,pistol,144,34352035,98.9702232518,_100,6,>100
11464,shouts,144,34352179,98.9706381242,_100,6,>100
11465,kane,144,34352323,98.9710529966,_100,4,>100
11466,sl,143,34352466,98.971464988,_100,2,>100
11467,bounty,143,34352609,98.9718769794,_100,6,>100
11468,medicines,143,34352752,98.9722889707,_100,9,>100
11469,flowed,143,34352895,98.9727009621,_100,6,>100
11470,continuation,143,34353038,98.9731129535,_100,12,>100
11471,wal,143,34353181,98.9735249449,_100,3,>100
11472,catastrophe,143,34353324,98.9739369362,_100,11,>100
11473,advertise,143,34353467,98.9743489276,_100,9,>100
11474,poked,143,34353610,98.974760919,_100,5,>100
11475,faithfulness,143,34353753,98.9751729103,_100,12,>100
11476,mascara,143,34353896,98.9755849017,_100,7,>100
11477,creatively,143,34354039,98.9759968931,_100,10,>100
11478,restrained,143,34354182,98.9764088844,_100,10,>100
11479,fertile,143,34354325,98.9768208758,_100,7,>100
11480,railroad,143,34354468,98.9772328672,_100,8,>100
11481,bookshelves,143,34354611,98.9776448585,_100,11,>100
11482,fearing,143,34354754,98.9780568499,_100,7,>100
11483,jules,143,34354897,98.9784688413,_100,5,>100
11484,differing,143,34355040,98.9788808326,_100,9,>100
11485,chen,143,34355183,98.979292824,_100,4,>100
11486,awfully,143,34355326,98.9797048154,_100,7,>100
11487,brutality,143,34355469,98.9801168068,_100,9,>100
11488,dorm,143,34355612,98.9805287981,_100,4,>100
11489,durable,143,34355755,98.9809407895,_100,7,>100
11490,rupert,143,34355898,98.9813527809,_100,6,>100
11491,behaving,143,34356041,98.9817647722,_100,8,>100
11492,factories,143,34356184,98.9821767636,_100,9,>100
11493,hurried,143,34356327,98.982588755,_100,7,>100
11494,barbie,143,34356470,98.9830007463,_100,6,>100
11495,pilsner,143,34356613,98.9834127377,_100,7,>100
11496,tilda,143,34356756,98.9838247291,_100,5,>100
11497,outsider,143,34356899,98.9842367204,_100,8,>100
11498,tweak,143,34357042,98.9846487118,_100,5,>100
11499,motif,143,34357185,98.9850607032,_100,5,>100
11500,dangling,143,34357328,98.9854726946,_100,8,>100
11501,darkened,143,34357471,98.9858846859,_100,8,>100
11502,subscribers,143,34357614,98.9862966773,_100,11,>100
11503,saviour,143,34357757,98.9867086687,_100,7,>100
11504,disguised,143,34357900,98.98712066,_100,9,>100
11505,alleviate,143,34358043,98.9875326514,_100,9,>100
11506,leaps,143,34358186,98.9879446428,_100,5,>100
11507,lentils,143,34358329,98.9883566341,_100,7,>100
11508,yells,143,34358472,98.9887686255,_100,5,>100
11509,accusing,143,34358615,98.9891806169,_100,8,>100
11510,soaring,143,34358758,98.9895926082,_100,7,>100
11511,calves,143,34358901,98.9900045996,_100,6,>100
11512,insults,143,34359044,98.990416591,_100,7,>100
11513,manipulated,142,34359186,98.9908257013,_100,11,>100
11514,staircase,142,34359328,98.9912348116,_100,9,>100
11515,hue,142,34359470,98.9916439219,_100,3,>100
11516,branding,142,34359612,98.9920530322,_100,8,>100
11517,richie,142,34359754,98.9924621425,_100,6,>100
11518,gloomy,142,34359896,98.9928712528,_100,6,>100
11519,lotus,142,34360038,98.9932803632,_100,5,>100
11520,bummed,142,34360180,98.9936894735,_100,6,>100
11521,wording,142,34360322,98.9940985838,_100,7,>100
11522,shameful,142,34360464,98.9945076941,_100,8,>100
11523,blueberry,142,34360606,98.9949168044,_100,9,>100
11524,experimentation,142,34360748,98.9953259147,_100,15,>100
11525,fianc,142,34360890,98.995735025,_100,5,>100
11526,yikes,142,34361032,98.9961441353,_100,5,>100
11527,dusk,142,34361174,98.9965532456,_100,4,>100
11528,contradiction,142,34361316,98.9969623559,_100,13,>100
11529,patrol,142,34361458,98.9973714663,_100,6,>100
11530,extraordinarily,142,34361600,98.9977805766,_100,15,>100
11531,eyebrow,142,34361742,98.9981896869,_100,7,>100
11532,nixon,142,34361884,98.9985987972,_100,5,>100
11533,pierce,142,34362026,98.9990079075,_100,6,>100
11534,rails,142,34362168,98.9994170178,_100,5,>100
11535,costing,142,34362310,98.9998261281,_100,7,>100
11536,horrifying,142,34362452,99.0002352384,_100,10,>100
11537,inward,142,34362594,99.0006443487,_100,6,>100
11538,forwards,142,34362736,99.001053459,_100,8,>100
11539,salute,142,34362878,99.0014625694,_100,6,>100
11540,os,142,34363020,99.0018716797,_100,2,>100
11541,medicare,142,34363162,99.00228079,_100,8,>100
11542,rendition,142,34363304,99.0026899003,_100,9,>100
11543,seriousness,142,34363446,99.0030990106,_100,11,>100
11544,southwest,142,34363588,99.0035081209,_100,9,>100
11545,unified,142,34363730,99.0039172312,_100,7,>100
11546,promotions,142,34363872,99.0043263415,_100,10,>100
11547,breaths,142,34364014,99.0047354518,_100,7,>100
11548,mushy,142,34364156,99.0051445622,_100,5,>100
11549,butcher,142,34364298,99.0055536725,_100,7,>100
11550,swell,142,34364440,99.0059627828,_100,5,>100
11551,razor,142,34364582,99.0063718931,_100,5,>100
11552,donors,142,34364724,99.0067810034,_100,6,>100
11553,wiping,142,34364866,99.0071901137,_100,6,>100
11554,nana,142,34365008,99.007599224,_100,4,>100
11555,sequels,142,34365150,99.0080083343,_100,7,>100
11556,pouch,142,34365292,99.0084174446,_100,5,>100
11557,pre,142,34365434,99.0088265549,_100,3,>100
11558,prisons,142,34365576,99.0092356653,_100,7,>100
11559,infinitely,142,34365718,99.0096447756,_100,10,>100
11560,nonfiction,142,34365860,99.0100538859,_100,10,>100
11561,undergoing,142,34366002,99.0104629962,_100,10,>100
11562,specials,142,34366144,99.0108721065,_100,8,>100
11563,lookout,142,34366286,99.0112812168,_100,7,>100
11564,appreciative,142,34366428,99.0116903271,_100,12,>100
11565,balsamic,142,34366570,99.0120994374,_100,8,>100
11566,congo,142,34366712,99.0125085477,_100,5,>100
11567,margins,142,34366854,99.0129176581,_100,7,>100
11568,dazzling,141,34366995,99.0133238873,_100,8,>100
11569,hazy,141,34367136,99.0137301166,_100,4,>100
11570,polly,141,34367277,99.0141363458,_100,5,>100
11571,benefited,141,34367418,99.0145425751,_100,9,>100
11572,sinner,141,34367559,99.0149488043,_100,6,>100
11573,partying,141,34367700,99.0153550336,_100,8,>100
11574,recruitment,141,34367841,99.0157612628,_100,11,>100
11575,unrest,141,34367982,99.0161674921,_100,6,>100
11576,doubles,141,34368123,99.0165737213,_100,7,>100
11577,scenic,141,34368264,99.0169799506,_100,6,>100
11578,trainers,141,34368405,99.0173861798,_100,8,>100
11579,imprisonment,141,34368546,99.0177924091,_100,12,>100
11580,rue,141,34368687,99.0181986383,_100,3,>100
11581,tabs,141,34368828,99.0186048676,_100,4,>100
11582,onwards,141,34368969,99.0190110968,_100,7,>100
11583,nokia,141,34369110,99.0194173261,_100,5,>100
11584,boils,141,34369251,99.0198235553,_100,5,>100
11585,peeling,141,34369392,99.0202297846,_100,7,>100
11586,wig,141,34369533,99.0206360138,_100,3,>100
11587,gloria,141,34369674,99.0210422431,_100,6,>100
11588,communal,141,34369815,99.0214484723,_100,8,>100
11589,imperfect,141,34369956,99.0218547016,_100,9,>100
11590,intervene,141,34370097,99.0222609308,_100,9,>100
11591,skeleton,141,34370238,99.0226671601,_100,8,>100
11592,observers,141,34370379,99.0230733893,_100,9,>100
11593,losers,141,34370520,99.0234796186,_100,6,>100
11594,bishops,141,34370661,99.0238858479,_100,7,>100
11595,factual,141,34370802,99.0242920771,_100,7,>100
11596,culturally,141,34370943,99.0246983064,_100,10,>100
11597,crow,141,34371084,99.0251045356,_100,4,>100
11598,verify,141,34371225,99.0255107649,_100,6,>100
11599,dramas,141,34371366,99.0259169941,_100,6,>100
11600,tampa,141,34371507,99.0263232234,_100,5,>100
11601,blazing,141,34371648,99.0267294526,_100,7,>100
11602,broadly,141,34371789,99.0271356819,_100,7,>100
11603,infants,141,34371930,99.0275419111,_100,7,>100
11604,alicia,141,34372071,99.0279481404,_100,6,>100
11605,probe,141,34372212,99.0283543696,_100,5,>100
11606,rendering,141,34372353,99.0287605989,_100,9,>100
11607,cafeteria,141,34372494,99.0291668281,_100,9,>100
11608,cracker,141,34372635,99.0295730574,_100,7,>100
11609,hostility,141,34372776,99.0299792866,_100,9,>100
11610,norfolk,141,34372917,99.0303855159,_100,7,>100
11611,undertaken,140,34373057,99.0307888641,_100,10,>100
11612,prosecutors,140,34373197,99.0311922123,_100,11,>100
11613,clare,140,34373337,99.0315955605,_100,5,>100
11614,dangerously,140,34373477,99.0319989087,_100,11,>100
11615,motivations,140,34373617,99.0324022568,_100,11,>100
11616,suppress,140,34373757,99.032805605,_100,8,>100
11617,smoothie,140,34373897,99.0332089532,_100,8,>100
11618,accessory,140,34374037,99.0336123014,_100,9,>100
11619,140,140,34374177,99.0340156496,_100,3,>100
11620,bandwagon,140,34374317,99.0344189978,_100,9,>100
11621,bravery,140,34374457,99.034822346,_100,7,>100
11622,attackers,140,34374597,99.0352256942,_100,9,>100
11623,essentials,140,34374737,99.0356290424,_100,10,>100
11624,pleading,140,34374877,99.0360323906,_100,8,>100
11625,linkedin,140,34375017,99.0364357388,_100,8,>100
11626,blinded,140,34375157,99.036839087,_100,7,>100
11627,objection,140,34375297,99.0372424352,_100,9,>100
11628,budding,140,34375437,99.0376457834,_100,7,>100
11629,philippine,140,34375577,99.0380491316,_100,10,>100
11630,steals,140,34375717,99.0384524797,_100,6,>100
11631,firearms,140,34375857,99.0388558279,_100,8,>100
11632,contrasting,140,34375997,99.0392591761,_100,11,>100
11633,dismay,140,34376137,99.0396625243,_100,6,>100
11634,petrol,140,34376277,99.0400658725,_100,6,>100
11635,exceed,140,34376417,99.0404692207,_100,6,>100
11636,jamaica,140,34376557,99.0408725689,_100,7,>100
11637,necklaces,140,34376697,99.0412759171,_100,9,>100
11638,swam,140,34376837,99.0416792653,_100,4,>100
11639,toppings,140,34376977,99.0420826135,_100,8,>100
11640,councillors,140,34377117,99.0424859617,_100,11,>100
11641,hal,140,34377257,99.0428893099,_100,3,>100
11642,tame,140,34377397,99.0432926581,_100,4,>100
11643,thinkers,140,34377537,99.0436960063,_100,8,>100
11644,chillies,140,34377677,99.0440993545,_100,8,>100
11645,ive,140,34377817,99.0445027026,_100,3,>100
11646,empowering,140,34377957,99.0449060508,_100,10,>100
11647,watermelon,140,34378097,99.045309399,_100,10,>100
11648,fetch,140,34378237,99.0457127472,_100,5,>100
11649,continual,140,34378377,99.0461160954,_100,9,>100
11650,recreational,140,34378517,99.0465194436,_100,12,>100
11651,rewrite,140,34378657,99.0469227918,_100,7,>100
11652,sunflower,140,34378797,99.04732614,_100,9,>100
11653,altering,140,34378937,99.0477294882,_100,8,>100
11654,teamed,140,34379077,99.0481328364,_100,6,>100
11655,anglican,140,34379217,99.0485361846,_100,8,>100
11656,cues,140,34379357,99.0489395328,_100,4,>100
11657,favored,140,34379497,99.049342881,_100,7,>100
11658,transplant,140,34379637,99.0497462292,_100,10,>100
11659,pentagon,140,34379777,99.0501495774,_100,8,>100
11660,enforced,140,34379917,99.0505529255,_100,8,>100
11661,brighten,140,34380057,99.0509562737,_100,8,>100
11662,compares,140,34380197,99.0513596219,_100,8,>100
11663,ubiquitous,140,34380337,99.0517629701,_100,10,>100
11664,uttered,140,34380477,99.0521663183,_100,7,>100
11665,munich,139,34380616,99.0525667855,_100,6,>100
11666,sen,139,34380755,99.0529672526,_100,3,>100
11667,textbook,139,34380894,99.0533677197,_100,8,>100
11668,adrenaline,139,34381033,99.0537681869,_100,10,>100
11669,statistical,139,34381172,99.054168654,_100,11,>100
11670,precedent,139,34381311,99.0545691211,_100,9,>100
11671,scones,139,34381450,99.0549695883,_100,6,>100
11672,modeling,139,34381589,99.0553700554,_100,8,>100
11673,jae,139,34381728,99.0557705225,_100,3,>100
11674,juliet,139,34381867,99.0561709897,_100,6,>100
11675,supervision,139,34382006,99.0565714568,_100,11,>100
11676,enclosed,139,34382145,99.0569719239,_100,8,>100
11677,ds,139,34382284,99.0573723911,_100,2,>100
11678,criticisms,139,34382423,99.0577728582,_100,10,>100
11679,improves,139,34382562,99.0581733253,_100,8,>100
11680,richmond,139,34382701,99.0585737925,_100,8,>100
11681,brighton,139,34382840,99.0589742596,_100,8,>100
11682,clutch,139,34382979,99.0593747267,_100,6,>100
11683,vocalist,139,34383118,99.0597751939,_100,8,>100
11684,embellishment,139,34383257,99.060175661,_100,13,>100
11685,puzzled,139,34383396,99.0605761282,_100,7,>100
11686,coleman,139,34383535,99.0609765953,_100,7,>100
11687,orphan,139,34383674,99.0613770624,_100,6,>100
11688,nova,139,34383813,99.0617775296,_100,4,>100
11689,obese,139,34383952,99.0621779967,_100,5,>100
11690,geography,139,34384091,99.0625784638,_100,9,>100
11691,toddlers,139,34384230,99.062978931,_100,8,>100
11692,strengthened,139,34384369,99.0633793981,_100,12,>100
11693,cohen,139,34384508,99.0637798652,_100,5,>100
11694,neighboring,139,34384647,99.0641803324,_100,11,>100
11695,crumb,139,34384786,99.0645807995,_100,5,>100
11696,bowed,139,34384925,99.0649812666,_100,5,>100
11697,narration,139,34385064,99.0653817338,_100,9,>100
11698,retailer,139,34385203,99.0657822009,_100,8,>100
11699,holiness,139,34385342,99.066182668,_100,8,>100
11700,civic,139,34385481,99.0665831352,_100,5,>100
11701,dads,139,34385620,99.0669836023,_100,4,>100
11702,poisonous,139,34385759,99.0673840694,_100,9,>100
11703,zionist,139,34385898,99.0677845366,_100,7,>100
11704,sleek,139,34386037,99.0681850037,_100,5,>100
11705,readership,139,34386176,99.0685854709,_100,10,>100
11706,esteem,139,34386315,99.068985938,_100,6,>100
11707,doyle,139,34386454,99.0693864051,_100,5,>100
11708,samantha,139,34386593,99.0697868723,_100,8,>100
11709,darren,139,34386732,99.0701873394,_100,6,>100
11710,exploited,139,34386871,99.0705878065,_100,9,>100
11711,depicting,139,34387010,99.0709882737,_100,9,>100
11712,missiles,139,34387149,99.0713887408,_100,8,>100
11713,abruptly,139,34387288,99.0717892079,_100,8,>100
11714,acquainted,139,34387427,99.0721896751,_100,10,>100
11715,stalk,139,34387566,99.0725901422,_100,5,>100
11716,aug,139,34387705,99.0729906093,_100,3,>100
11717,rebuilding,139,34387844,99.0733910765,_100,10,>100
11718,astounding,139,34387983,99.0737915436,_100,10,>100
11719,monitors,139,34388122,99.0741920107,_100,8,>100
11720,chandler,139,34388261,99.0745924779,_100,8,>100
11721,transferring,139,34388400,99.074992945,_100,12,>100
11722,examines,139,34388539,99.0753934121,_100,8,>100
11723,shred,139,34388678,99.0757938793,_100,5,>100
11724,instinctively,139,34388817,99.0761943464,_100,13,>100
11725,unveiled,139,34388956,99.0765948135,_100,8,>100
11726,enthusiastically,139,34389095,99.0769952807,_100,16,>100
11727,module,139,34389234,99.0773957478,_100,6,>100
11728,donor,139,34389373,99.077796215,_100,5,>100
11729,ambiguous,138,34389511,99.078193801,_100,9,>100
11730,federation,138,34389649,99.0785913871,_100,10,>100
11731,colonies,138,34389787,99.0789889732,_100,8,>100
11732,inherit,138,34389925,99.0793865593,_100,7,>100
11733,aunts,138,34390063,99.0797841453,_100,5,>100
11734,anecdotes,138,34390201,99.0801817314,_100,9,>100
11735,histories,138,34390339,99.0805793175,_100,9,>100
11736,hillary,138,34390477,99.0809769036,_100,7,>100
11737,pioneer,138,34390615,99.0813744896,_100,7,>100
11738,pilots,138,34390753,99.0817720757,_100,6,>100
11739,dividing,138,34390891,99.0821696618,_100,8,>100
11740,mia,138,34391029,99.0825672479,_100,3,>100
11741,napoleon,138,34391167,99.0829648339,_100,8,>100
11742,pendant,138,34391305,99.08336242,_100,7,>100
11743,choke,138,34391443,99.0837600061,_100,5,>100
11744,phillip,138,34391581,99.0841575922,_100,7,>100
11745,macdonald,138,34391719,99.0845551782,_100,9,>100
11746,hymn,138,34391857,99.0849527643,_100,4,>100
11747,quitting,138,34391995,99.0853503504,_100,8,>100
11748,align,138,34392133,99.0857479365,_100,5,>100
11749,rochester,138,34392271,99.0861455226,_100,9,>100
11750,brendan,138,34392409,99.0865431086,_100,7,>100
11751,anguish,138,34392547,99.0869406947,_100,7,>100
11752,moss,138,34392685,99.0873382808,_100,4,>100
11753,spreads,138,34392823,99.0877358669,_100,7,>100
11754,isbn,138,34392961,99.0881334529,_100,4,>100
11755,earthquakes,138,34393099,99.088531039,_100,11,>100
11756,mugs,138,34393237,99.0889286251,_100,4,>100
11757,geographical,138,34393375,99.0893262112,_100,12,>100
11758,mines,138,34393513,99.0897237972,_100,5,>100
11759,stressing,138,34393651,99.0901213833,_100,9,>100
11760,gail,138,34393789,99.0905189694,_100,4,>100
11761,steaming,138,34393927,99.0909165555,_100,8,>100
11762,chant,138,34394065,99.0913141415,_100,5,>100
11763,repaired,138,34394203,99.0917117276,_100,8,>100
11764,edged,138,34394341,99.0921093137,_100,5,>100
11765,clad,138,34394479,99.0925068998,_100,4,>100
11766,superiority,138,34394617,99.0929044859,_100,11,>100
11767,pickled,138,34394755,99.0933020719,_100,7,>100
11768,tumor,138,34394893,99.093699658,_100,5,>100
11769,advertisers,138,34395031,99.0940972441,_100,11,>100
11770,doily,138,34395169,99.0944948302,_100,5,>100
11771,resign,138,34395307,99.0948924162,_100,6,>100
11772,wedge,138,34395445,99.0952900023,_100,5,>100
11773,pieced,138,34395583,99.0956875884,_100,6,>100
11774,monumental,138,34395721,99.0960851745,_100,10,>100
11775,reacted,138,34395859,99.0964827605,_100,7,>100
11776,ct,138,34395997,99.0968803466,_100,2,>100
11777,undercover,138,34396135,99.0972779327,_100,10,>100
11778,carriers,138,34396273,99.0976755188,_100,8,>100
11779,tackled,138,34396411,99.0980731048,_100,7,>100
11780,rebirth,138,34396549,99.0984706909,_100,7,>100
11781,bastards,138,34396687,99.098868277,_100,8,>100
11782,productions,138,34396825,99.0992658631,_100,11,>100
11783,considerations,138,34396963,99.0996634491,_100,14,>100
11784,frederick,138,34397101,99.1000610352,_100,9,>100
11785,ridden,138,34397239,99.1004586213,_100,6,>100
11786,modify,138,34397377,99.1008562074,_100,6,>100
11787,matthews,138,34397515,99.1012537935,_100,8,>100
11788,translucent,138,34397653,99.1016513795,_100,11,>100
11789,nausea,138,34397791,99.1020489656,_100,6,>100
11790,bitten,138,34397929,99.1024465517,_100,6,>100
11791,births,138,34398067,99.1028441378,_100,6,>100
11792,ordained,137,34398204,99.1032388428,_100,8,>100
11793,birthing,137,34398341,99.1036335478,_100,8,>100
11794,hangover,137,34398478,99.1040282528,_100,8,>100
11795,zoom,137,34398615,99.1044229578,_100,4,>100
11796,booths,137,34398752,99.1048176628,_100,6,>100
11797,mutually,137,34398889,99.1052123679,_100,8,>100
11798,freeing,137,34399026,99.1056070729,_100,7,>100
11799,inconvenience,137,34399163,99.1060017779,_100,13,>100
11800,settlers,137,34399300,99.1063964829,_100,8,>100
11801,manifested,137,34399437,99.1067911879,_100,10,>100
11802,privileges,137,34399574,99.107185893,_100,10,>100
11803,yields,137,34399711,99.107580598,_100,6,>100
11804,carnival,137,34399848,99.107975303,_100,8,>100
11805,positioning,137,34399985,99.108370008,_100,11,>100
11806,poe,137,34400122,99.108764713,_100,3,>100
11807,sheffield,137,34400259,99.109159418,_100,9,>100
11808,tweeting,137,34400396,99.1095541231,_100,8,>100
11809,babe,137,34400533,99.1099488281,_100,4,>100
11810,plaque,137,34400670,99.1103435331,_100,6,>100
11811,jams,137,34400807,99.1107382381,_100,4,>100
11812,plato,137,34400944,99.1111329431,_100,5,>100
11813,discretion,137,34401081,99.1115276482,_100,10,>100
11814,overload,137,34401218,99.1119223532,_100,8,>100
11815,rotating,137,34401355,99.1123170582,_100,8,>100
11816,wok,137,34401492,99.1127117632,_100,3,>100
11817,suicidal,137,34401629,99.1131064682,_100,8,>100
11818,curd,137,34401766,99.1135011732,_100,4,>100
11819,diner,137,34401903,99.1138958783,_100,5,>100
11820,territories,137,34402040,99.1142905833,_100,11,>100
11821,reread,137,34402177,99.1146852883,_100,6,>100
11822,sixty,137,34402314,99.1150799933,_100,5,>100
11823,fixture,137,34402451,99.1154746983,_100,7,>100
11824,toned,137,34402588,99.1158694033,_100,5,>100
11825,norms,137,34402725,99.1162641084,_100,5,>100
11826,staged,137,34402862,99.1166588134,_100,6,>100
11827,ninth,137,34402999,99.1170535184,_100,5,>100
11828,flair,137,34403136,99.1174482234,_100,5,>100
11829,shaved,137,34403273,99.1178429284,_100,6,>100
11830,dusting,137,34403410,99.1182376335,_100,7,>100
11831,paved,137,34403547,99.1186323385,_100,5,>100
11832,leopard,137,34403684,99.1190270435,_100,7,>100
11833,airports,137,34403821,99.1194217485,_100,8,>100
11834,shone,137,34403958,99.1198164535,_100,5,>100
11835,restrict,136,34404094,99.1202082775,_100,8,>100
11836,liners,136,34404230,99.1206001014,_100,6,>100
11837,backstory,136,34404366,99.1209919254,_100,9,>100
11838,governed,136,34404502,99.1213837494,_100,8,>100
11839,embellished,136,34404638,99.1217755733,_100,11,>100
11840,phases,136,34404774,99.1221673973,_100,6,>100
11841,circa,136,34404910,99.1225592212,_100,5,>100
11842,loft,136,34405046,99.1229510452,_100,4,>100
11843,crafters,136,34405182,99.1233428692,_100,8,>100
11844,bats,136,34405318,99.1237346931,_100,4,>100
11845,hurtful,136,34405454,99.1241265171,_100,7,>100
11846,reinforced,136,34405590,99.124518341,_100,10,>100
11847,organizational,136,34405726,99.124910165,_100,14,>100
11848,policemen,136,34405862,99.125301989,_100,9,>100
11849,detected,136,34405998,99.1256938129,_100,8,>100
11850,brink,136,34406134,99.1260856369,_100,5,>100
11851,stereotypical,136,34406270,99.1264774608,_100,13,>100
11852,yale,136,34406406,99.1268692848,_100,4,>100
11853,hawaiian,136,34406542,99.1272611087,_100,8,>100
11854,filipino,136,34406678,99.1276529327,_100,8,>100
11855,eminent,136,34406814,99.1280447567,_100,7,>100
11856,fudge,136,34406950,99.1284365806,_100,5,>100
11857,sensual,136,34407086,99.1288284046,_100,7,>100
11858,ruining,136,34407222,99.1292202285,_100,7,>100
11859,predominantly,136,34407358,99.1296120525,_100,13,>100
11860,va,136,34407494,99.1300038765,_100,2,>100
11861,dial,136,34407630,99.1303957004,_100,4,>100
11862,asthma,136,34407766,99.1307875244,_100,6,>100
11863,nicest,136,34407902,99.1311793483,_100,6,>100
11864,aromas,136,34408038,99.1315711723,_100,6,>100
11865,cox,136,34408174,99.1319629963,_100,3,>100
11866,prop,136,34408310,99.1323548202,_100,4,>100
11867,israelis,136,34408446,99.1327466442,_100,8,>100
11868,diligently,136,34408582,99.1331384681,_100,10,>100
11869,sorta,136,34408718,99.1335302921,_100,5,>100
11870,terrace,136,34408854,99.1339221161,_100,7,>100
11871,poo,136,34408990,99.13431394,_100,3,>100
11872,oily,136,34409126,99.134705764,_100,4,>100
11873,advocating,136,34409262,99.1350975879,_100,10,>100
11874,russians,136,34409398,99.1354894119,_100,8,>100
11875,rugs,136,34409534,99.1358812359,_100,4,>100
11876,contacting,136,34409670,99.1362730598,_100,10,>100
11877,herald,136,34409806,99.1366648838,_100,6,>100
11878,rumours,136,34409942,99.1370567077,_100,7,>100
11879,hostage,136,34410078,99.1374485317,_100,7,>100
11880,reunited,136,34410214,99.1378403556,_100,8,>100
11881,plainly,136,34410350,99.1382321796,_100,7,>100
11882,pottery,136,34410486,99.1386240036,_100,7,>100
11883,artifacts,135,34410621,99.1390129465,_100,9,>100
11884,exploding,135,34410756,99.1394018894,_100,9,>100
11885,frankie,135,34410891,99.1397908323,_100,7,>100
11886,aisles,135,34411026,99.1401797752,_100,6,>100
11887,framing,135,34411161,99.1405687181,_100,7,>100
11888,acquaintances,135,34411296,99.140957661,_100,13,>100
11889,learners,135,34411431,99.1413466039,_100,8,>100
11890,favorable,135,34411566,99.1417355468,_100,9,>100
11891,afar,135,34411701,99.1421244897,_100,4,>100
11892,unsuccessful,135,34411836,99.1425134326,_100,12,>100
11893,redeem,135,34411971,99.1429023755,_100,6,>100
11894,prevail,135,34412106,99.1432913184,_100,7,>100
11895,faithfully,135,34412241,99.1436802613,_100,10,>100
11896,anthem,135,34412376,99.1440692042,_100,6,>100
11897,deployment,135,34412511,99.1444581471,_100,10,>100
11898,brides,135,34412646,99.14484709,_100,6,>100
11899,foliage,135,34412781,99.1452360329,_100,7,>100
11900,negotiating,135,34412916,99.1456249758,_100,11,>100
11901,depart,135,34413051,99.1460139187,_100,6,>100
11902,sued,135,34413186,99.1464028616,_100,4,>100
11903,teammates,135,34413321,99.1467918045,_100,9,>100
11904,abdul,135,34413456,99.1471807474,_100,5,>100
11905,heir,135,34413591,99.1475696903,_100,4,>100
11906,informing,135,34413726,99.1479586332,_100,9,>100
11907,synthetic,135,34413861,99.1483475761,_100,9,>100
11908,lawmakers,135,34413996,99.148736519,_100,9,>100
11909,gourmet,135,34414131,99.1491254619,_100,7,>100
11910,withdrawn,135,34414266,99.1495144048,_100,9,>100
11911,sarcasm,135,34414401,99.1499033477,_100,7,>100
11912,similarity,135,34414536,99.1502922906,_100,10,>100
11913,cruising,135,34414671,99.1506812335,_100,8,>100
11914,cena,135,34414806,99.1510701764,_100,4,>100
11915,nigel,135,34414941,99.1514591193,_100,5,>100
11916,gilbert,135,34415076,99.1518480622,_100,7,>100
11917,masala,135,34415211,99.1522370051,_100,6,>100
11918,cliche,135,34415346,99.152625948,_100,6,>100
11919,leverage,135,34415481,99.1530148909,_100,8,>100
11920,explosions,135,34415616,99.1534038338,_100,10,>100
11921,banners,135,34415751,99.1537927767,_100,7,>100
11922,mourn,135,34415886,99.1541817196,_100,5,>100
11923,mann,135,34416021,99.1545706625,_100,4,>100
11924,crawford,135,34416156,99.1549596054,_100,8,>100
11925,rooting,135,34416291,99.1553485483,_100,7,>100
11926,abuses,135,34416426,99.1557374912,_100,6,>100
11927,vividly,135,34416561,99.1561264341,_100,7,>100
11928,barren,135,34416696,99.156515377,_100,6,>100
11929,naomi,135,34416831,99.1569043199,_100,5,>100
11930,pertaining,135,34416966,99.1572932628,_100,10,>100
11931,irresistible,135,34417101,99.1576822057,_100,12,>100
11932,enrolled,135,34417236,99.1580711486,_100,8,>100
11933,seizure,135,34417371,99.1584600915,_100,7,>100
11934,mantle,135,34417506,99.1588490344,_100,6,>100
11935,economist,135,34417641,99.1592379773,_100,9,>100
11936,fondness,135,34417776,99.1596269202,_100,8,>100
11937,chords,135,34417911,99.1600158631,_100,6,>100
11938,atmospheric,135,34418046,99.160404806,_100,11,>100
11939,exodus,135,34418181,99.1607937489,_100,6,>100
11940,mcdonalds,135,34418316,99.1611826918,_100,9,>100
11941,booklet,135,34418451,99.1615716347,_100,7,>100
11942,yolk,135,34418586,99.1619605776,_100,4,>100
11943,newman,135,34418721,99.1623495205,_100,6,>100
11944,ana,134,34418855,99.1627355824,_100,3,>100
11945,rex,134,34418989,99.1631216442,_100,3,>100
11946,fart,134,34419123,99.163507706,_100,4,>100
11947,sperm,134,34419257,99.1638937679,_100,5,>100
11948,sponsoring,134,34419391,99.1642798297,_100,10,>100
11949,recruited,134,34419525,99.1646658916,_100,9,>100
11950,fronts,134,34419659,99.1650519534,_100,6,>100
11951,fists,134,34419793,99.1654380153,_100,5,>100
11952,unfolds,134,34419927,99.1658240771,_100,7,>100
11953,ronnie,134,34420061,99.1662101389,_100,6,>100
11954,milan,134,34420195,99.1665962008,_100,5,>100
11955,watchers,134,34420329,99.1669822626,_100,8,>100
11956,jewels,134,34420463,99.1673683245,_100,6,>100
11957,belfast,134,34420597,99.1677543863,_100,7,>100
11958,intern,134,34420731,99.1681404481,_100,6,>100
11959,quoting,134,34420865,99.16852651,_100,7,>100
11960,poles,134,34420999,99.1689125718,_100,5,>100
11961,smelly,134,34421133,99.1692986337,_100,6,>100
11962,homer,134,34421267,99.1696846955,_100,5,>100
11963,realising,134,34421401,99.1700707574,_100,9,>100
11964,rigorous,134,34421535,99.1704568192,_100,8,>100
11965,bookmark,134,34421669,99.170842881,_100,8,>100
11966,crept,134,34421803,99.1712289429,_100,5,>100
11967,catering,134,34421937,99.1716150047,_100,8,>100
11968,textured,134,34422071,99.1720010666,_100,8,>100
11969,merge,134,34422205,99.1723871284,_100,5,>100
11970,shrinking,134,34422339,99.1727731903,_100,9,>100
11971,sided,134,34422473,99.1731592521,_100,5,>100
11972,shalt,134,34422607,99.1735453139,_100,5,>100
11973,graffiti,134,34422741,99.1739313758,_100,8,>100
11974,cline,134,34422875,99.1743174376,_100,5,>100
11975,tailored,134,34423009,99.1747034995,_100,8,>100
11976,sodium,134,34423143,99.1750895613,_100,6,>100
11977,irene,134,34423277,99.1754756231,_100,5,>100
11978,bangladesh,134,34423411,99.175861685,_100,10,>100
11979,exceeded,134,34423545,99.1762477468,_100,8,>100
11980,discern,134,34423679,99.1766338087,_100,7,>100
11981,clicks,134,34423813,99.1770198705,_100,6,>100
11982,qualifications,134,34423947,99.1774059324,_100,14,>100
11983,nurturing,134,34424081,99.1777919942,_100,9,>100
11984,folds,134,34424215,99.178178056,_100,5,>100
11985,melodies,134,34424349,99.1785641179,_100,8,>100
11986,neglecting,134,34424483,99.1789501797,_100,10,>100
11987,dill,134,34424617,99.1793362416,_100,4,>100
11988,mildred,134,34424751,99.1797223034,_100,7,>100
11989,wonderland,134,34424885,99.1801083653,_100,10,>100
11990,noodle,134,34425019,99.1804944271,_100,6,>100
11991,contractors,134,34425153,99.1808804889,_100,11,>100
11992,treaty,134,34425287,99.1812665508,_100,6,>100
11993,rentals,134,34425421,99.1816526126,_100,7,>100
11994,presumed,134,34425555,99.1820386745,_100,8,>100
11995,bonding,134,34425689,99.1824247363,_100,7,>100
11996,moons,134,34425823,99.1828107981,_100,5,>100
11997,fearless,134,34425957,99.18319686,_100,8,>100
11998,licking,134,34426091,99.1835829218,_100,7,>100
11999,ivory,134,34426225,99.1839689837,_100,5,>100
12000,glimmer,134,34426359,99.1843550455,_100,7,>100
12001,giggles,134,34426493,99.1847411074,_100,7,>100
12002,mortar,134,34426627,99.1851271692,_100,6,>100
12003,stalks,134,34426761,99.185513231,_100,6,>100
12004,cater,134,34426895,99.1858992929,_100,5,>100
12005,ludicrous,134,34427029,99.1862853547,_100,9,>100
12006,militant,134,34427163,99.1866714166,_100,8,>100
12007,brady,134,34427297,99.1870574784,_100,5,>100
12008,judith,134,34427431,99.1874435403,_100,6,>100
12009,carefree,134,34427565,99.1878296021,_100,8,>100
12010,rugby,134,34427699,99.1882156639,_100,5,>100
12011,lighten,134,34427833,99.1886017258,_100,7,>100
12012,banter,134,34427967,99.1889877876,_100,6,>100
12013,overwhelmingly,133,34428100,99.1893709684,_100,14,>100
12014,pertinent,133,34428233,99.1897541492,_100,9,>100
12015,ghana,133,34428366,99.19013733,_100,5,>100
12016,elimination,133,34428499,99.1905205108,_100,11,>100
12017,bubbly,133,34428632,99.1909036915,_100,6,>100
12018,suppressed,133,34428765,99.1912868723,_100,10,>100
12019,atheists,133,34428898,99.1916700531,_100,8,>100
12020,apron,133,34429031,99.1920532339,_100,5,>100
12021,broadband,133,34429164,99.1924364147,_100,9,>100
12022,grove,133,34429297,99.1928195955,_100,5,>100
12023,ironing,133,34429430,99.1932027762,_100,7,>100
12024,universally,133,34429563,99.193585957,_100,11,>100
12025,volcano,133,34429696,99.1939691378,_100,7,>100
12026,voiced,133,34429829,99.1943523186,_100,6,>100
12027,mayonnaise,133,34429962,99.1947354994,_100,10,>100
12028,der,133,34430095,99.1951186802,_100,3,>100
12029,smoother,133,34430228,99.1955018609,_100,8,>100
12030,donkey,133,34430361,99.1958850417,_100,6,>100
12031,rodriguez,133,34430494,99.1962682225,_100,9,>100
12032,unsettling,133,34430627,99.1966514033,_100,10,>100
12033,insect,133,34430760,99.1970345841,_100,6,>100
12034,gasp,133,34430893,99.1974177649,_100,4,>100
12035,owls,133,34431026,99.1978009456,_100,4,>100
12036,andre,133,34431159,99.1981841264,_100,5,>100
12037,sonic,133,34431292,99.1985673072,_100,5,>100
12038,terminology,133,34431425,99.198950488,_100,11,>100
12039,steaks,133,34431558,99.1993336688,_100,6,>100
12040,boldly,133,34431691,99.1997168496,_100,6,>100
12041,leon,133,34431824,99.2001000304,_100,4,>100
12042,alumni,133,34431957,99.2004832111,_100,6,>100
12043,hardship,133,34432090,99.2008663919,_100,8,>100
12044,refugee,133,34432223,99.2012495727,_100,7,>100
12045,outbreak,133,34432356,99.2016327535,_100,8,>100
12046,spelled,133,34432489,99.2020159343,_100,7,>100
12047,einstein,133,34432622,99.2023991151,_100,8,>100
12048,hussein,133,34432755,99.2027822958,_100,7,>100
12049,tempo,133,34432888,99.2031654766,_100,5,>100
12050,sprint,133,34433021,99.2035486574,_100,6,>100
12051,parliamentary,133,34433154,99.2039318382,_100,13,>100
12052,leaked,133,34433287,99.204315019,_100,6,>100
12053,afforded,133,34433420,99.2046981998,_100,8,>100
12054,swords,133,34433553,99.2050813805,_100,6,>100
12055,lynch,133,34433686,99.2054645613,_100,5,>100
12056,starred,133,34433819,99.2058477421,_100,7,>100
12057,porcelain,133,34433952,99.2062309229,_100,9,>100
12058,sarkozy,133,34434085,99.2066141037,_100,7,>100
12059,buddhism,133,34434218,99.2069972845,_100,8,>100
12060,shovel,133,34434351,99.2073804652,_100,6,>100
12061,percy,133,34434484,99.207763646,_100,5,>100
12062,suspend,133,34434617,99.2081468268,_100,7,>100
12063,census,133,34434750,99.2085300076,_100,6,>100
12064,greenwich,133,34434883,99.2089131884,_100,9,>100
12065,plugged,133,34435016,99.2092963692,_100,7,>100
12066,contributor,132,34435148,99.2096766689,_100,11,>100
12067,prompting,132,34435280,99.2100569686,_100,9,>100
12068,anew,132,34435412,99.2104372683,_100,4,>100
12069,portuguese,132,34435544,99.2108175681,_100,10,>100
12070,maiden,132,34435676,99.2111978678,_100,6,>100
12071,stencil,132,34435808,99.2115781675,_100,7,>100
12072,rookie,132,34435940,99.2119584672,_100,6,>100
12073,epiphany,132,34436072,99.212338767,_100,8,>100
12074,rhubarb,132,34436204,99.2127190667,_100,7,>100
12075,warms,132,34436336,99.2130993664,_100,5,>100
12076,rosa,132,34436468,99.2134796661,_100,4,>100
12077,cite,132,34436600,99.2138599659,_100,4,>100
12078,kathleen,132,34436732,99.2142402656,_100,8,>100
12079,joked,132,34436864,99.2146205653,_100,5,>100
12080,paycheck,132,34436996,99.215000865,_100,8,>100
12081,recruit,132,34437128,99.2153811648,_100,7,>100
12082,contributes,132,34437260,99.2157614645,_100,11,>100
12083,mayan,132,34437392,99.2161417642,_100,5,>100
12084,disgusted,132,34437524,99.2165220639,_100,9,>100
12085,dee,132,34437656,99.2169023637,_100,3,>100
12086,ranged,132,34437788,99.2172826634,_100,6,>100
12087,ncaa,132,34437920,99.2176629631,_100,4,>100
12088,bff,132,34438052,99.2180432628,_100,3,>100
12089,mussolini,132,34438184,99.2184235626,_100,9,>100
12090,drinkable,132,34438316,99.2188038623,_100,9,>100
12091,injection,132,34438448,99.219184162,_100,9,>100
12092,hardened,132,34438580,99.2195644617,_100,8,>100
12093,housework,132,34438712,99.2199447615,_100,9,>100
12094,enthusiast,132,34438844,99.2203250612,_100,10,>100
12095,crock,132,34438976,99.2207053609,_100,5,>100
12096,cables,132,34439108,99.2210856606,_100,6,>100
12097,amelia,132,34439240,99.2214659604,_100,6,>100
12098,nile,132,34439372,99.2218462601,_100,4,>100
12099,rifles,132,34439504,99.2222265598,_100,6,>100
12100,supplier,132,34439636,99.2226068595,_100,8,>100
12101,boehner,132,34439768,99.2229871593,_100,7,>100
12102,sincerity,132,34439900,99.223367459,_100,9,>100
12103,jerome,132,34440032,99.2237477587,_100,6,>100
12104,commandments,132,34440164,99.2241280584,_100,12,>100
12105,mechanic,132,34440296,99.2245083582,_100,8,>100
12106,yorker,132,34440428,99.2248886579,_100,6,>100
12107,squeezing,132,34440560,99.2252689576,_100,9,>100
12108,richardson,132,34440692,99.2256492573,_100,10,>100
12109,vows,132,34440824,99.2260295571,_100,4,>100
12110,knights,132,34440956,99.2264098568,_100,7,>100
12111,listings,132,34441088,99.2267901565,_100,8,>100
12112,bikini,132,34441220,99.2271704562,_100,6,>100
12113,infectious,132,34441352,99.227550756,_100,10,>100
12114,correlation,132,34441484,99.2279310557,_100,11,>100
12115,geneva,131,34441615,99.2283084744,_100,6,>100
12116,verbally,131,34441746,99.228685893,_100,8,>100
12117,stern,131,34441877,99.2290633117,_100,5,>100
12118,unused,131,34442008,99.2294407304,_100,6,>100
12119,ukraine,131,34442139,99.229818149,_100,7,>100
12120,surplus,131,34442270,99.2301955677,_100,7,>100
12121,owes,131,34442401,99.2305729864,_100,4,>100
12122,knead,131,34442532,99.230950405,_100,5,>100
12123,devoid,131,34442663,99.2313278237,_100,6,>100
12124,wwe,131,34442794,99.2317052424,_100,3,>100
12125,glorified,131,34442925,99.232082661,_100,9,>100
12126,pip,131,34443056,99.2324600797,_100,3,>100
12127,natives,131,34443187,99.2328374984,_100,7,>100
12128,watery,131,34443318,99.233214917,_100,6,>100
12129,cashier,131,34443449,99.2335923357,_100,7,>100
12130,bahrain,131,34443580,99.2339697544,_100,7,>100
12131,applaud,131,34443711,99.234347173,_100,7,>100
12132,jeremiah,131,34443842,99.2347245917,_100,8,>100
12133,regimes,131,34443973,99.2351020104,_100,7,>100
12134,colombia,131,34444104,99.235479429,_100,8,>100
12135,matte,131,34444235,99.2358568477,_100,5,>100
12136,dana,131,34444366,99.2362342664,_100,4,>100
12137,adoptive,131,34444497,99.236611685,_100,8,>100
12138,therein,131,34444628,99.2369891037,_100,7,>100
12139,offending,131,34444759,99.2373665224,_100,9,>100
12140,darcy,131,34444890,99.237743941,_100,5,>100
12141,payroll,131,34445021,99.2381213597,_100,7,>100
12142,bb,131,34445152,99.2384987784,_100,2,>100
12143,pakatan,131,34445283,99.238876197,_100,7,>100
12144,shady,131,34445414,99.2392536157,_100,5,>100
12145,advancement,131,34445545,99.2396310344,_100,11,>100
12146,ethic,131,34445676,99.240008453,_100,5,>100
12147,criticize,131,34445807,99.2403858717,_100,9,>100
12148,euros,131,34445938,99.2407632904,_100,5,>100
12149,calendars,131,34446069,99.241140709,_100,9,>100
12150,interiors,131,34446200,99.2415181277,_100,9,>100
12151,michaels,131,34446331,99.2418955464,_100,8,>100
12152,watered,131,34446462,99.242272965,_100,7,>100
12153,melancholy,131,34446593,99.2426503837,_100,10,>100
12154,persian,131,34446724,99.2430278024,_100,7,>100
12155,dreamy,131,34446855,99.243405221,_100,6,>100
12156,melodic,131,34446986,99.2437826397,_100,7,>100
12157,reconciliation,131,34447117,99.2441600584,_100,14,>100
12158,backlash,131,34447248,99.244537477,_100,8,>100
12159,broadcasting,131,34447379,99.2449148957,_100,12,>100
12160,nestabilities,131,34447510,99.2452923144,_100,13,>100
12161,avenues,131,34447641,99.245669733,_100,7,>100
12162,extremists,131,34447772,99.2460471517,_100,10,>100
12163,disdain,131,34447903,99.2464245704,_100,7,>100
12164,nationally,131,34448034,99.246801989,_100,10,>100
12165,extensions,130,34448164,99.2471765266,_100,10,>100
12166,farmhouse,130,34448294,99.2475510642,_100,9,>100
12167,boycott,130,34448424,99.2479256018,_100,7,>100
12168,wagner,130,34448554,99.2483001395,_100,6,>100
12169,junsu,130,34448684,99.2486746771,_100,5,>100
12170,rivalry,130,34448814,99.2490492147,_100,7,>100
12171,playoff,130,34448944,99.2494237523,_100,7,>100
12172,delegates,130,34449074,99.2497982899,_100,9,>100
12173,utilizing,130,34449204,99.2501728275,_100,9,>100
12174,goddamn,130,34449334,99.2505473651,_100,7,>100
12175,bengal,130,34449464,99.2509219027,_100,6,>100
12176,crumbled,130,34449594,99.2512964403,_100,8,>100
12177,empowerment,130,34449724,99.2516709779,_100,11,>100
12178,lowering,130,34449854,99.2520455155,_100,8,>100
12179,oversized,130,34449984,99.2524200531,_100,9,>100
12180,bash,130,34450114,99.2527945908,_100,4,>100
12181,rebuilt,130,34450244,99.2531691284,_100,7,>100
12182,impromptu,130,34450374,99.253543666,_100,9,>100
12183,rationale,130,34450504,99.2539182036,_100,9,>100
12184,lazarus,130,34450634,99.2542927412,_100,7,>100
12185,disconnect,130,34450764,99.2546672788,_100,10,>100
12186,inadvertently,130,34450894,99.2550418164,_100,13,>100
12187,govern,130,34451024,99.255416354,_100,6,>100
12188,wand,130,34451154,99.2557908916,_100,4,>100
12189,woody,130,34451284,99.2561654292,_100,5,>100
12190,orphans,130,34451414,99.2565399668,_100,7,>100
12191,discs,130,34451544,99.2569145044,_100,5,>100
12192,negatively,130,34451674,99.2572890421,_100,10,>100
12193,afrikaner,130,34451804,99.2576635797,_100,9,>100
12194,circling,130,34451934,99.2580381173,_100,8,>100
12195,councils,130,34452064,99.2584126549,_100,8,>100
12196,brag,130,34452194,99.2587871925,_100,4,>100
12197,clarke,130,34452324,99.2591617301,_100,6,>100
12198,usd,130,34452454,99.2595362677,_100,3,>100
12199,tending,130,34452584,99.2599108053,_100,7,>100
12200,rake,130,34452714,99.2602853429,_100,4,>100
12201,tigers,130,34452844,99.2606598805,_100,6,>100
12202,bros,130,34452974,99.2610344181,_100,4,>100
12203,functionality,130,34453104,99.2614089557,_100,13,>100
12204,coulson,130,34453234,99.2617834933,_100,7,>100
12205,architects,130,34453364,99.262158031,_100,10,>100
12206,130,130,34453494,99.2625325686,_100,3,>100
12207,ricotta,130,34453624,99.2629071062,_100,7,>100
12208,cinco,130,34453754,99.2632816438,_100,5,>100
12209,determines,130,34453884,99.2636561814,_100,10,>100
12210,milwaukee,130,34454014,99.264030719,_100,9,>100
12211,paddy,130,34454144,99.2644052566,_100,5,>100
12212,minneapolis,130,34454274,99.2647797942,_100,11,>100
12213,critters,130,34454404,99.2651543318,_100,8,>100
12214,confines,130,34454534,99.2655288694,_100,8,>100
12215,harness,130,34454664,99.265903407,_100,7,>100
12216,everytime,130,34454794,99.2662779446,_100,9,>100
12217,seasonings,130,34454924,99.2666524823,_100,10,>100
12218,gloom,130,34455054,99.2670270199,_100,5,>100
12219,evoke,130,34455184,99.2674015575,_100,5,>100
12220,ipads,130,34455314,99.2677760951,_100,5,>100
12221,closets,130,34455444,99.2681506327,_100,7,>100
12222,indicators,130,34455574,99.2685251703,_100,10,>100
12223,gibson,130,34455704,99.2688997079,_100,6,>100
12224,betsy,130,34455834,99.2692742455,_100,5,>100
12225,curved,130,34455964,99.2696487831,_100,6,>100
12226,trent,130,34456094,99.2700233207,_100,5,>100
12227,leaking,129,34456223,99.2703949773,_100,7,>100
12228,expressive,129,34456352,99.2707666338,_100,10,>100
12229,investor,129,34456481,99.2711382904,_100,8,>100
12230,absorbing,129,34456610,99.2715099469,_100,9,>100
12231,graves,129,34456739,99.2718816035,_100,6,>100
12232,memo,129,34456868,99.27225326,_100,4,>100
12233,surgeries,129,34456997,99.2726249166,_100,9,>100
12234,championships,129,34457126,99.2729965731,_100,13,>100
12235,rouge,129,34457255,99.2733682297,_100,5,>100
12236,pesky,129,34457384,99.2737398862,_100,5,>100
12237,linear,129,34457513,99.2741115428,_100,6,>100
12238,wink,129,34457642,99.2744831993,_100,4,>100
12239,afrikaners,129,34457771,99.2748548559,_100,10,>100
12240,detained,129,34457900,99.2752265124,_100,8,>100
12241,metabolism,129,34458029,99.275598169,_100,10,>100
12242,doris,129,34458158,99.2759698255,_100,5,>100
12243,shelters,129,34458287,99.2763414821,_100,8,>100
12244,dodgy,129,34458416,99.2767131386,_100,5,>100
12245,anwar,129,34458545,99.2770847952,_100,5,>100
12246,resembling,129,34458674,99.2774564517,_100,10,>100
12247,micro,129,34458803,99.2778281083,_100,5,>100
12248,felix,129,34458932,99.2781997648,_100,5,>100
12249,compensate,129,34459061,99.2785714214,_100,10,>100
12250,disciple,129,34459190,99.2789430779,_100,8,>100
12251,lola,129,34459319,99.2793147345,_100,4,>100
12252,hemp,129,34459448,99.279686391,_100,4,>100
12253,bulky,129,34459577,99.2800580476,_100,5,>100
12254,bathtub,129,34459706,99.2804297041,_100,7,>100
12255,maximize,129,34459835,99.2808013607,_100,8,>100
12256,symptom,129,34459964,99.2811730172,_100,7,>100
12257,internally,129,34460093,99.2815446738,_100,10,>100
12258,educating,129,34460222,99.2819163303,_100,9,>100
12259,lads,129,34460351,99.2822879869,_100,4,>100
12260,subdued,129,34460480,99.2826596434,_100,7,>100
12261,printable,129,34460609,99.2830313,_100,9,>100
12262,benches,129,34460738,99.2834029565,_100,7,>100
12263,jenkins,129,34460867,99.2837746131,_100,7,>100
12264,teal,129,34460996,99.2841462696,_100,4,>100
12265,allan,129,34461125,99.2845179262,_100,5,>100
12266,hooray,129,34461254,99.2848895827,_100,6,>100
12267,fermented,129,34461383,99.2852612393,_100,9,>100
12268,poised,129,34461512,99.2856328958,_100,6,>100
12269,fathom,129,34461641,99.2860045524,_100,6,>100
12270,dealings,129,34461770,99.2863762089,_100,8,>100
12271,parameters,129,34461899,99.2867478655,_100,10,>100
12272,spooky,129,34462028,99.287119522,_100,6,>100
12273,homeowners,129,34462157,99.2874911786,_100,10,>100
12274,verb,129,34462286,99.2878628351,_100,4,>100
12275,backstage,129,34462415,99.2882344917,_100,9,>100
12276,formidable,129,34462544,99.2886061482,_100,10,>100
12277,bankrupt,129,34462673,99.2889778048,_100,8,>100
12278,disclosed,129,34462802,99.2893494613,_100,9,>100
12279,fl,129,34462931,99.2897211179,_100,2,>100
12280,mythical,129,34463060,99.2900927744,_100,8,>100
12281,tolerated,129,34463189,99.290464431,_100,9,>100
12282,incoming,129,34463318,99.2908360875,_100,8,>100
12283,comprehension,128,34463446,99.291204863,_100,13,>100
12284,calculate,128,34463574,99.2915736385,_100,9,>100
12285,socialism,128,34463702,99.291942414,_100,9,>100
12286,lim,128,34463830,99.2923111895,_100,3,>100
12287,probability,128,34463958,99.292679965,_100,11,>100
12288,fa,128,34464086,99.2930487405,_100,2,>100
12289,mph,128,34464214,99.2934175159,_100,3,>100
12290,splitting,128,34464342,99.2937862914,_100,9,>100
12291,civilized,128,34464470,99.2941550669,_100,9,>100
12292,disco,128,34464598,99.2945238424,_100,5,>100
12293,flare,128,34464726,99.2948926179,_100,5,>100
12294,denies,128,34464854,99.2952613934,_100,6,>100
12295,admiring,128,34464982,99.2956301689,_100,8,>100
12296,swirls,128,34465110,99.2959989444,_100,6,>100
12297,isle,128,34465238,99.2963677199,_100,4,>100
12298,empower,128,34465366,99.2967364954,_100,7,>100
12299,paso,128,34465494,99.2971052709,_100,4,>100
12300,shaun,128,34465622,99.2974740463,_100,5,>100
12301,renewable,128,34465750,99.2978428218,_100,9,>100
12302,collapsing,128,34465878,99.2982115973,_100,10,>100
12303,breakthrough,128,34466006,99.2985803728,_100,12,>100
12304,toffee,128,34466134,99.2989491483,_100,6,>100
12305,maxwell,128,34466262,99.2993179238,_100,7,>100
12306,battlefield,128,34466390,99.2996866993,_100,11,>100
12307,hum,128,34466518,99.3000554748,_100,3,>100
12308,monument,128,34466646,99.3004242503,_100,8,>100
12309,devised,128,34466774,99.3007930258,_100,7,>100
12310,specialists,128,34466902,99.3011618013,_100,11,>100
12311,waffle,128,34467030,99.3015305767,_100,6,>100
12312,rebellious,128,34467158,99.3018993522,_100,10,>100
12313,devon,128,34467286,99.3022681277,_100,5,>100
12314,sidewalks,128,34467414,99.3026369032,_100,9,>100
12315,governmental,128,34467542,99.3030056787,_100,12,>100
12316,dang,128,34467670,99.3033744542,_100,4,>100
12317,operators,128,34467798,99.3037432297,_100,9,>100
12318,longed,128,34467926,99.3041120052,_100,6,>100
12319,comedic,128,34468054,99.3044807807,_100,7,>100
12320,amish,128,34468182,99.3048495562,_100,5,>100
12321,renamed,128,34468310,99.3052183317,_100,7,>100
12322,plaster,128,34468438,99.3055871071,_100,7,>100
12323,smug,128,34468566,99.3059558826,_100,4,>100
12324,successor,128,34468694,99.3063246581,_100,9,>100
12325,justrite,128,34468822,99.3066934336,_100,8,>100
12326,establishments,128,34468950,99.3070622091,_100,14,>100
12327,arranging,128,34469078,99.3074309846,_100,9,>100
12328,jared,128,34469206,99.3077997601,_100,5,>100
12329,roaming,128,34469334,99.3081685356,_100,7,>100
12330,lobbying,128,34469462,99.3085373111,_100,8,>100
12331,sacramento,128,34469590,99.3089060866,_100,10,>100
12332,sooooo,128,34469718,99.3092748621,_100,6,>100
12333,whales,128,34469846,99.3096436375,_100,6,>100
12334,dracula,128,34469974,99.310012413,_100,7,>100
12335,stainless,128,34470102,99.3103811885,_100,9,>100
12336,correspondent,127,34470229,99.310747083,_100,13,>100
12337,concealed,127,34470356,99.3111129774,_100,9,>100
12338,oyster,127,34470483,99.3114788718,_100,6,>100
12339,reliance,127,34470610,99.3118447663,_100,8,>100
12340,seventies,127,34470737,99.3122106607,_100,9,>100
12341,penalties,127,34470864,99.3125765551,_100,9,>100
12342,hen,127,34470991,99.3129424496,_100,3,>100
12343,resonate,127,34471118,99.313308344,_100,8,>100
12344,skate,127,34471245,99.3136742384,_100,5,>100
12345,monstrous,127,34471372,99.3140401329,_100,9,>100
12346,fennel,127,34471499,99.3144060273,_100,6,>100
12347,teresa,127,34471626,99.3147719217,_100,6,>100
12348,pneumonia,127,34471753,99.3151378162,_100,9,>100
12349,rk,127,34471880,99.3155037106,_100,2,>100
12350,snuggled,127,34472007,99.315869605,_100,8,>100
12351,nutritious,127,34472134,99.3162354995,_100,10,>100
12352,styled,127,34472261,99.3166013939,_100,6,>100
12353,trumpet,127,34472388,99.3169672883,_100,7,>100
12354,catastrophic,127,34472515,99.3173331828,_100,12,>100
12355,glaring,127,34472642,99.3176990772,_100,7,>100
12356,conflicting,127,34472769,99.3180649716,_100,11,>100
12357,hauled,127,34472896,99.318430866,_100,6,>100
12358,freshness,127,34473023,99.3187967605,_100,9,>100
12359,reacting,127,34473150,99.3191626549,_100,8,>100
12360,depicts,127,34473277,99.3195285493,_100,7,>100
12361,accounted,127,34473404,99.3198944438,_100,9,>100
12362,crows,127,34473531,99.3202603382,_100,5,>100
12363,lumps,127,34473658,99.3206262326,_100,5,>100
12364,symbolism,127,34473785,99.3209921271,_100,9,>100
12365,illustrator,127,34473912,99.3213580215,_100,11,>100
12366,towering,127,34474039,99.3217239159,_100,8,>100
12367,brightest,127,34474166,99.3220898104,_100,9,>100
12368,eater,127,34474293,99.3224557048,_100,5,>100
12369,multiply,127,34474420,99.3228215992,_100,8,>100
12370,probable,127,34474547,99.3231874937,_100,8,>100
12371,floats,127,34474674,99.3235533881,_100,6,>100
12372,emphasized,127,34474801,99.3239192825,_100,10,>100
12373,fuels,127,34474928,99.324285177,_100,5,>100
12374,economists,127,34475055,99.3246510714,_100,10,>100
12375,tyres,127,34475182,99.3250169658,_100,5,>100
12376,skim,127,34475309,99.3253828603,_100,4,>100
12377,kilometers,127,34475436,99.3257487547,_100,10,>100
12378,emptied,127,34475563,99.3261146491,_100,7,>100
12379,tacky,127,34475690,99.3264805436,_100,5,>100
12380,tolerant,127,34475817,99.326846438,_100,8,>100
12381,cramped,127,34475944,99.3272123324,_100,7,>100
12382,contagious,127,34476071,99.3275782269,_100,10,>100
12383,desks,127,34476198,99.3279441213,_100,5,>100
12384,dap,127,34476325,99.3283100157,_100,3,>100
12385,epidemic,127,34476452,99.3286759102,_100,8,>100
12386,unsuspecting,127,34476579,99.3290418046,_100,12,>100
12387,snuck,127,34476706,99.329407699,_100,5,>100
12388,sponged,127,34476833,99.3297735935,_100,7,>100
12389,koran,127,34476960,99.3301394879,_100,5,>100
12390,trot,127,34477087,99.3305053823,_100,4,>100
12391,blatantly,127,34477214,99.3308712768,_100,9,>100
12392,duct,127,34477341,99.3312371712,_100,4,>100
12393,cannon,127,34477468,99.3316030656,_100,6,>100
12394,rumor,127,34477595,99.3319689601,_100,5,>100
12395,reds,127,34477722,99.3323348545,_100,4,>100
12396,traders,127,34477849,99.3327007489,_100,7,>100
12397,insecurities,127,34477976,99.3330666433,_100,12,>100
12398,inspirations,127,34478103,99.3334325378,_100,12,>100
12399,onward,126,34478229,99.3337955512,_100,6,>100
12400,rita,126,34478355,99.3341585645,_100,4,>100
12401,bloated,126,34478481,99.3345215779,_100,7,>100
12402,purses,126,34478607,99.3348845913,_100,6,>100
12403,shadowy,126,34478733,99.3352476047,_100,7,>100
12404,preceded,126,34478859,99.335610618,_100,8,>100
12405,trivia,126,34478985,99.3359736314,_100,6,>100
12406,fueled,126,34479111,99.3363366448,_100,6,>100
12407,affiliated,126,34479237,99.3366996581,_100,10,>100
12408,sophia,126,34479363,99.3370626715,_100,6,>100
12409,mocking,126,34479489,99.3374256849,_100,7,>100
12410,hurdles,126,34479615,99.3377886983,_100,7,>100
12411,expedition,126,34479741,99.3381517116,_100,10,>100
12412,lydia,126,34479867,99.338514725,_100,5,>100
12413,starch,126,34479993,99.3388777384,_100,6,>100
12414,pizzas,126,34480119,99.3392407518,_100,6,>100
12415,babysitter,126,34480245,99.3396037651,_100,10,>100
12416,overcoming,126,34480371,99.3399667785,_100,10,>100
12417,recess,126,34480497,99.3403297919,_100,6,>100
12418,puddle,126,34480623,99.3406928053,_100,6,>100
12419,fluids,126,34480749,99.3410558186,_100,6,>100
12420,caves,126,34480875,99.341418832,_100,5,>100
12421,dumping,126,34481001,99.3417818454,_100,7,>100
12422,rents,126,34481127,99.3421448588,_100,5,>100
12423,stalled,126,34481253,99.3425078721,_100,7,>100
12424,apparatus,126,34481379,99.3428708855,_100,9,>100
12425,rehab,126,34481505,99.3432338989,_100,5,>100
12426,indifference,126,34481631,99.3435969123,_100,12,>100
12427,speculate,126,34481757,99.3439599256,_100,9,>100
12428,leigh,126,34481883,99.344322939,_100,5,>100
12429,aromatic,126,34482009,99.3446859524,_100,8,>100
12430,confidential,126,34482135,99.3450489658,_100,12,>100
12431,discounted,126,34482261,99.3454119791,_100,10,>100
12432,partnered,126,34482387,99.3457749925,_100,9,>100
12433,fig,126,34482513,99.3461380059,_100,3,>100
12434,leisurely,126,34482639,99.3465010192,_100,9,>100
12435,woodland,126,34482765,99.3468640326,_100,8,>100
12436,bedside,126,34482891,99.347227046,_100,7,>100
12437,endangered,126,34483017,99.3475900594,_100,10,>100
12438,bruises,126,34483143,99.3479530727,_100,7,>100
12439,pierced,126,34483269,99.3483160861,_100,7,>100
12440,saith,126,34483395,99.3486790995,_100,5,>100
12441,comedies,126,34483521,99.3490421129,_100,8,>100
12442,comrades,126,34483647,99.3494051262,_100,8,>100
12443,herbert,126,34483773,99.3497681396,_100,7,>100
12444,swan,126,34483899,99.350131153,_100,4,>100
12445,hq,126,34484025,99.3504941664,_100,2,>100
12446,hr,126,34484151,99.3508571797,_100,2,>100
12447,mar,126,34484277,99.3512201931,_100,3,>100
12448,mastery,126,34484403,99.3515832065,_100,7,>100
12449,songwriter,126,34484529,99.3519462199,_100,10,>100
12450,provoking,126,34484655,99.3523092332,_100,9,>100
12451,tuesdays,126,34484781,99.3526722466,_100,8,>100
12452,developmental,126,34484907,99.35303526,_100,13,>100
12453,administrator,126,34485033,99.3533982734,_100,13,>100
12454,op,126,34485159,99.3537612867,_100,2,>100
12455,mailed,126,34485285,99.3541243001,_100,6,>100
12456,jog,126,34485411,99.3544873135,_100,3,>100
12457,ferguson,126,34485537,99.3548503268,_100,8,>100
12458,julius,126,34485663,99.3552133402,_100,6,>100
12459,locking,126,34485789,99.3555763536,_100,7,>100
12460,tamil,126,34485915,99.355939367,_100,5,>100
12461,reverence,126,34486041,99.3563023803,_100,9,>100
12462,congrats,126,34486167,99.3566653937,_100,8,>100
12463,jessie,126,34486293,99.3570284071,_100,6,>100
12464,cayenne,125,34486418,99.3573885394,_100,7,>100
12465,invade,125,34486543,99.3577486717,_100,6,>100
12466,mclaren,125,34486668,99.358108804,_100,7,>100
12467,filters,125,34486793,99.3584689364,_100,7,>100
12468,cooperative,125,34486918,99.3588290687,_100,11,>100
12469,aussie,125,34487043,99.359189201,_100,6,>100
12470,ellis,125,34487168,99.3595493333,_100,5,>100
12471,proactive,125,34487293,99.3599094656,_100,9,>100
12472,laptops,125,34487418,99.3602695979,_100,7,>100
12473,etiquette,125,34487543,99.3606297302,_100,9,>100
12474,bruno,125,34487668,99.3609898626,_100,5,>100
12475,wrists,125,34487793,99.3613499949,_100,6,>100
12476,glazed,125,34487918,99.3617101272,_100,6,>100
12477,murky,125,34488043,99.3620702595,_100,5,>100
12478,pardon,125,34488168,99.3624303918,_100,6,>100
12479,abode,125,34488293,99.3627905241,_100,5,>100
12480,hare,125,34488418,99.3631506565,_100,4,>100
12481,whedon,125,34488543,99.3635107888,_100,6,>100
12482,flashlight,125,34488668,99.3638709211,_100,10,>100
12483,sugary,125,34488793,99.3642310534,_100,6,>100
12484,contradictory,125,34488918,99.3645911857,_100,13,>100
12485,dusted,125,34489043,99.364951318,_100,6,>100
12486,strife,125,34489168,99.3653114503,_100,6,>100
12487,characterized,125,34489293,99.3656715827,_100,13,>100
12488,disposition,125,34489418,99.366031715,_100,11,>100
12489,prolonged,125,34489543,99.3663918473,_100,9,>100
12490,lcd,125,34489668,99.3667519796,_100,3,>100
12491,manila,125,34489793,99.3671121119,_100,6,>100
12492,125,125,34489918,99.3674722442,_100,3,>100
12493,disliked,125,34490043,99.3678323766,_100,8,>100
12494,geeks,125,34490168,99.3681925089,_100,5,>100
12495,overheard,125,34490293,99.3685526412,_100,9,>100
12496,detour,125,34490418,99.3689127735,_100,6,>100
12497,forged,125,34490543,99.3692729058,_100,6,>100
12498,spree,125,34490668,99.3696330381,_100,5,>100
12499,embroidered,125,34490793,99.3699931705,_100,11,>100
12500,calgary,125,34490918,99.3703533028,_100,7,>100
12501,judgments,125,34491043,99.3707134351,_100,9,>100
12502,smashing,125,34491168,99.3710735674,_100,8,>100
12503,rejecting,125,34491293,99.3714336997,_100,9,>100
12504,fiercely,125,34491418,99.371793832,_100,8,>100
12505,detrimental,125,34491543,99.3721539643,_100,11,>100
12506,prominently,125,34491668,99.3725140967,_100,11,>100
12507,geese,125,34491793,99.372874229,_100,5,>100
12508,logically,125,34491918,99.3732343613,_100,9,>100
12509,ineffective,125,34492043,99.3735944936,_100,11,>100
12510,dictates,125,34492168,99.3739546259,_100,8,>100
12511,simplify,125,34492293,99.3743147582,_100,8,>100
12512,reggae,125,34492418,99.3746748906,_100,6,>100
12513,protested,125,34492543,99.3750350229,_100,9,>100
12514,creed,125,34492668,99.3753951552,_100,5,>100
12515,occupational,125,34492793,99.3757552875,_100,12,>100
12516,frowned,125,34492918,99.3761154198,_100,7,>100
12517,manny,125,34493043,99.3764755521,_100,5,>100
12518,appetizer,125,34493168,99.3768356844,_100,9,>100
12519,exhilarating,125,34493293,99.3771958168,_100,12,>100
12520,rugged,125,34493418,99.3775559491,_100,6,>100
12521,reap,125,34493543,99.3779160814,_100,4,>100
12522,builder,125,34493668,99.3782762137,_100,7,>100
12523,nearing,125,34493793,99.378636346,_100,7,>100
12524,danielle,125,34493918,99.3789964783,_100,8,>100
12525,heightened,125,34494043,99.3793566107,_100,10,>100
12526,seekers,125,34494168,99.379716743,_100,7,>100
12527,ole,125,34494293,99.3800768753,_100,3,>100
12528,exchanges,125,34494418,99.3804370076,_100,9,>100
12529,drafting,125,34494543,99.3807971399,_100,8,>100
12530,hummus,125,34494668,99.3811572722,_100,6,>100
12531,exercised,125,34494793,99.3815174045,_100,9,>100
12532,outdated,125,34494918,99.3818775369,_100,8,>100
12533,identifies,125,34495043,99.3822376692,_100,10,>100
12534,chalkboard,125,34495168,99.3825978015,_100,10,>100
12535,deborah,125,34495293,99.3829579338,_100,7,>100
12536,fleece,125,34495418,99.3833180661,_100,6,>100
12537,dizzy,124,34495542,99.3836753174,_100,5,>100
12538,bureaucracy,124,34495666,99.3840325686,_100,11,>100
12539,maurice,124,34495790,99.3843898199,_100,7,>100
12540,wacky,124,34495914,99.3847470712,_100,5,>100
12541,mona,124,34496038,99.3851043224,_100,4,>100
12542,shooter,124,34496162,99.3854615737,_100,7,>100
12543,intellectually,124,34496286,99.3858188249,_100,14,>100
12544,missionaries,124,34496410,99.3861760762,_100,12,>100
12545,perks,124,34496534,99.3865333274,_100,5,>100
12546,seaside,124,34496658,99.3868905787,_100,7,>100
12547,shallots,124,34496782,99.38724783,_100,8,>100
12548,fda,124,34496906,99.3876050812,_100,3,>100
12549,mainland,124,34497030,99.3879623325,_100,8,>100
12550,nationalist,124,34497154,99.3883195837,_100,11,>100
12551,canning,124,34497278,99.388676835,_100,7,>100
12552,luis,124,34497402,99.3890340862,_100,4,>100
12553,orchid,124,34497526,99.3893913375,_100,6,>100
12554,hypothetical,124,34497650,99.3897485887,_100,12,>100
12555,gerald,124,34497774,99.39010584,_100,6,>100
12556,browns,124,34497898,99.3904630913,_100,6,>100
12557,saddened,124,34498022,99.3908203425,_100,8,>100
12558,roadside,124,34498146,99.3911775938,_100,8,>100
12559,remembrance,124,34498270,99.391534845,_100,11,>100
12560,jin,124,34498394,99.3918920963,_100,3,>100
12561,reclaim,124,34498518,99.3922493475,_100,7,>100
12562,defendants,124,34498642,99.3926065988,_100,10,>100
12563,meringue,124,34498766,99.3929638501,_100,8,>100
12564,rut,124,34498890,99.3933211013,_100,3,>100
12565,transitions,124,34499014,99.3936783526,_100,11,>100
12566,milestones,124,34499138,99.3940356038,_100,10,>100
12567,pharisees,124,34499262,99.3943928551,_100,9,>100
12568,delaware,124,34499386,99.3947501063,_100,8,>100
12569,captivating,124,34499510,99.3951073576,_100,11,>100
12570,lodged,124,34499634,99.3954646089,_100,6,>100
12571,revered,124,34499758,99.3958218601,_100,7,>100
12572,rocker,124,34499882,99.3961791114,_100,6,>100
12573,disagreed,124,34500006,99.3965363626,_100,9,>100
12574,ferrari,124,34500130,99.3968936139,_100,7,>100
12575,contributors,124,34500254,99.3972508651,_100,12,>100
12576,teaser,124,34500378,99.3976081164,_100,6,>100
12577,discharge,124,34500502,99.3979653677,_100,9,>100
12578,imaginable,124,34500626,99.3983226189,_100,10,>100
12579,joanna,124,34500750,99.3986798702,_100,6,>100
12580,tripod,124,34500874,99.3990371214,_100,6,>100
12581,casts,124,34500998,99.3993943727,_100,5,>100
12582,inaugural,124,34501122,99.3997516239,_100,9,>100
12583,doses,124,34501246,99.4001088752,_100,5,>100
12584,concoction,124,34501370,99.4004661265,_100,10,>100
12585,parody,124,34501494,99.4008233777,_100,6,>100
12586,footing,124,34501618,99.401180629,_100,7,>100
12587,trader,124,34501742,99.4015378802,_100,6,>100
12588,coveted,124,34501866,99.4018951315,_100,7,>100
12589,presume,124,34501990,99.4022523827,_100,7,>100
12590,disruption,124,34502114,99.402609634,_100,10,>100
12591,sophomore,124,34502238,99.4029668853,_100,9,>100
12592,sprinkles,124,34502362,99.4033241365,_100,9,>100
12593,sacrificing,124,34502486,99.4036813878,_100,11,>100
12594,stoked,124,34502610,99.404038639,_100,6,>100
12595,unconventional,123,34502733,99.4043930092,_100,14,>100
12596,loathe,123,34502856,99.4047473794,_100,6,>100
12597,enlarge,123,34502979,99.4051017496,_100,7,>100
12598,cunning,123,34503102,99.4054561198,_100,7,>100
12599,gameplay,123,34503225,99.40581049,_100,8,>100
12600,summed,123,34503348,99.4061648602,_100,6,>100
12601,menacing,123,34503471,99.4065192304,_100,8,>100
12602,borough,123,34503594,99.4068736006,_100,7,>100
12603,insistence,123,34503717,99.4072279708,_100,10,>100
12604,hyde,123,34503840,99.407582341,_100,4,>100
12605,craigslist,123,34503963,99.4079367112,_100,10,>100
12606,solace,123,34504086,99.4082910814,_100,6,>100
12607,dsp,123,34504209,99.4086454516,_100,3,>100
12608,glorify,123,34504332,99.4089998218,_100,7,>100
12609,piercing,123,34504455,99.409354192,_100,8,>100
12610,painters,123,34504578,99.4097085622,_100,8,>100
12611,gadget,123,34504701,99.4100629324,_100,6,>100
12612,gooey,123,34504824,99.4104173026,_100,5,>100
12613,indirect,123,34504947,99.4107716728,_100,8,>100
12614,clooney,123,34505070,99.411126043,_100,7,>100
12615,hens,123,34505193,99.4114804132,_100,4,>100
12616,cal,123,34505316,99.4118347834,_100,3,>100
12617,ronan,123,34505439,99.4121891536,_100,5,>100
12618,mocked,123,34505562,99.4125435238,_100,6,>100
12619,plentiful,123,34505685,99.412897894,_100,9,>100
12620,revise,123,34505808,99.4132522642,_100,6,>100
12621,soggy,123,34505931,99.4136066344,_100,5,>100
12622,nieces,123,34506054,99.4139610046,_100,6,>100
12623,vi,123,34506177,99.4143153748,_100,2,>100
12624,tequila,123,34506300,99.414669745,_100,7,>100
12625,dungeon,123,34506423,99.4150241152,_100,7,>100
12626,unreal,123,34506546,99.4153784854,_100,6,>100
12627,redundant,123,34506669,99.4157328556,_100,9,>100
12628,licensee,123,34506792,99.4160872258,_100,8,>100
12629,hoffman,123,34506915,99.416441596,_100,7,>100
12630,diffuser,123,34507038,99.4167959662,_100,8,>100
12631,spraying,123,34507161,99.4171503364,_100,8,>100
12632,reuters,123,34507284,99.4175047066,_100,7,>100
12633,torment,123,34507407,99.4178590768,_100,7,>100
12634,remedies,123,34507530,99.418213447,_100,8,>100
12635,fm,123,34507653,99.4185678172,_100,2,>100
12636,contention,123,34507776,99.4189221874,_100,10,>100
12637,germs,123,34507899,99.4192765576,_100,5,>100
12638,java,123,34508022,99.4196309278,_100,4,>100
12639,outsiders,123,34508145,99.419985298,_100,9,>100
12640,aqua,123,34508268,99.4203396682,_100,4,>100
12641,violate,123,34508391,99.4206940384,_100,7,>100
12642,berkeley,123,34508514,99.4210484086,_100,8,>100
12643,conditioner,123,34508637,99.4214027788,_100,11,>100
12644,countdown,123,34508760,99.421757149,_100,9,>100
12645,restroom,123,34508883,99.4221115191,_100,8,>100
12646,jfk,123,34509006,99.4224658893,_100,3,>100
12647,puffy,123,34509129,99.4228202595,_100,5,>100
12648,messes,123,34509252,99.4231746297,_100,6,>100
12649,excel,123,34509375,99.4235289999,_100,5,>100
12650,columnist,123,34509498,99.4238833701,_100,9,>100
12651,springfield,123,34509621,99.4242377403,_100,11,>100
12652,collision,123,34509744,99.4245921105,_100,9,>100
12653,trustworthy,123,34509867,99.4249464807,_100,11,>100
12654,nike,123,34509990,99.4253008509,_100,4,>100
12655,pyramid,123,34510113,99.4256552211,_100,7,>100
12656,digest,123,34510236,99.4260095913,_100,6,>100
12657,interrupt,123,34510359,99.4263639615,_100,9,>100
12658,scans,123,34510482,99.4267183317,_100,5,>100
12659,buenos,123,34510605,99.4270727019,_100,6,>100
12660,announces,123,34510728,99.4274270721,_100,9,>100
12661,sprung,123,34510851,99.4277814423,_100,6,>100
12662,harp,123,34510974,99.4281358125,_100,4,>100
12663,washes,122,34511096,99.4284873017,_100,6,>100
12664,exceedingly,122,34511218,99.4288387908,_100,11,>100
12665,transmitted,122,34511340,99.4291902799,_100,11,>100
12666,mc,122,34511462,99.4295417691,_100,2,>100
12667,stripe,122,34511584,99.4298932582,_100,6,>100
12668,tammy,122,34511706,99.4302447474,_100,5,>100
12669,devour,122,34511828,99.4305962365,_100,6,>100
12670,hacked,122,34511950,99.4309477256,_100,6,>100
12671,flashed,122,34512072,99.4312992148,_100,7,>100
12672,awaits,122,34512194,99.4316507039,_100,6,>100
12673,awkwardly,122,34512316,99.4320021931,_100,9,>100
12674,misplaced,122,34512438,99.4323536822,_100,9,>100
12675,attest,122,34512560,99.4327051713,_100,6,>100
12676,percussion,122,34512682,99.4330566605,_100,10,>100
12677,dictator,122,34512804,99.4334081496,_100,8,>100
12678,irritation,122,34512926,99.4337596388,_100,10,>100
12679,meditate,122,34513048,99.4341111279,_100,8,>100
12680,duplicate,122,34513170,99.434462617,_100,9,>100
12681,stunt,122,34513292,99.4348141062,_100,5,>100
12682,licenses,122,34513414,99.4351655953,_100,8,>100
12683,logistics,122,34513536,99.4355170845,_100,9,>100
12684,satire,122,34513658,99.4358685736,_100,6,>100
12685,installing,122,34513780,99.4362200627,_100,10,>100
12686,sync,122,34513902,99.4365715519,_100,4,>100
12687,deliciously,122,34514024,99.436923041,_100,11,>100
12688,inconsistent,122,34514146,99.4372745302,_100,12,>100
12689,grilling,122,34514268,99.4376260193,_100,8,>100
12690,administered,122,34514390,99.4379775084,_100,12,>100
12691,computing,122,34514512,99.4383289976,_100,9,>100
12692,jockey,122,34514634,99.4386804867,_100,6,>100
12693,tate,122,34514756,99.4390319759,_100,4,>100
12694,uni,122,34514878,99.439383465,_100,3,>100
12695,amazes,122,34515000,99.4397349541,_100,6,>100
12696,indifferent,122,34515122,99.4400864433,_100,11,>100
12697,stigma,122,34515244,99.4404379324,_100,6,>100
12698,apocalypse,122,34515366,99.4407894216,_100,10,>100
12699,resisting,122,34515488,99.4411409107,_100,9,>100
12700,investigator,122,34515610,99.4414923998,_100,12,>100
12701,initiate,122,34515732,99.441843889,_100,8,>100
12702,choked,122,34515854,99.4421953781,_100,6,>100
12703,heath,122,34515976,99.4425468673,_100,5,>100
12704,unpublished,122,34516098,99.4428983564,_100,11,>100
12705,aires,122,34516220,99.4432498455,_100,5,>100
12706,entails,122,34516342,99.4436013347,_100,7,>100
12707,doubted,122,34516464,99.4439528238,_100,7,>100
12708,authoritarian,122,34516586,99.444304313,_100,13,>100
12709,susceptible,122,34516708,99.4446558021,_100,11,>100
12710,pondered,122,34516830,99.4450072912,_100,8,>100
12711,endorse,122,34516952,99.4453587804,_100,7,>100
12712,disgrace,122,34517074,99.4457102695,_100,8,>100
12713,hrs,122,34517196,99.4460617587,_100,3,>100
12714,disagreement,122,34517318,99.4464132478,_100,12,>100
12715,conservatism,122,34517440,99.4467647369,_100,12,>100
12716,annoy,122,34517562,99.4471162261,_100,5,>100
12717,contaminated,122,34517684,99.4474677152,_100,12,>100
12718,dependence,122,34517806,99.4478192044,_100,10,>100
12719,surgical,122,34517928,99.4481706935,_100,8,>100
12720,contemplated,122,34518050,99.4485221826,_100,12,>100
12721,stockholm,122,34518172,99.4488736718,_100,9,>100
12722,indianapolis,122,34518294,99.4492251609,_100,12,>100
12723,beams,122,34518416,99.4495766501,_100,5,>100
12724,currents,121,34518537,99.4499252581,_100,8,>100
12725,brake,121,34518658,99.4502738662,_100,5,>100
12726,inaccurate,121,34518779,99.4506224743,_100,10,>100
12727,stools,121,34518900,99.4509710824,_100,6,>100
12728,cc,121,34519021,99.4513196905,_100,2,>100
12729,apollo,121,34519142,99.4516682985,_100,6,>100
12730,walsh,121,34519263,99.4520169066,_100,5,>100
12731,pandora,121,34519384,99.4523655147,_100,7,>100
12732,launches,121,34519505,99.4527141228,_100,8,>100
12733,disadvantage,121,34519626,99.4530627309,_100,12,>100
12734,unschoolers,121,34519747,99.453411339,_100,11,>100
12735,honoured,121,34519868,99.453759947,_100,8,>100
12736,aggressively,121,34519989,99.4541085551,_100,12,>100
12737,interim,121,34520110,99.4544571632,_100,7,>100
12738,pod,121,34520231,99.4548057713,_100,3,>100
12739,omitted,121,34520352,99.4551543794,_100,7,>100
12740,canceled,121,34520473,99.4555029874,_100,8,>100
12741,queensland,121,34520594,99.4558515955,_100,10,>100
12742,vow,121,34520715,99.4562002036,_100,3,>100
12743,shopped,121,34520836,99.4565488117,_100,7,>100
12744,helper,121,34520957,99.4568974198,_100,6,>100
12745,bazzill,121,34521078,99.4572460278,_100,7,>100
12746,granting,121,34521199,99.4575946359,_100,8,>100
12747,medicaid,121,34521320,99.457943244,_100,8,>100
12748,retaining,121,34521441,99.4582918521,_100,9,>100
12749,cigar,121,34521562,99.4586404602,_100,5,>100
12750,rico,121,34521683,99.4589890683,_100,4,>100
12751,erupted,121,34521804,99.4593376763,_100,7,>100
12752,harvesting,121,34521925,99.4596862844,_100,10,>100
12753,commonplace,121,34522046,99.4600348925,_100,11,>100
12754,emailing,121,34522167,99.4603835006,_100,8,>100
12755,relay,121,34522288,99.4607321087,_100,5,>100
12756,scarred,121,34522409,99.4610807167,_100,7,>100
12757,dexter,121,34522530,99.4614293248,_100,6,>100
12758,hee,121,34522651,99.4617779329,_100,3,>100
12759,cords,121,34522772,99.462126541,_100,5,>100
12760,mimic,121,34522893,99.4624751491,_100,5,>100
12761,grinding,121,34523014,99.4628237572,_100,8,>100
12762,stranded,121,34523135,99.4631723652,_100,8,>100
12763,fines,121,34523256,99.4635209733,_100,5,>100
12764,camel,121,34523377,99.4638695814,_100,5,>100
12765,obligated,121,34523498,99.4642181895,_100,9,>100
12766,retiring,121,34523619,99.4645667976,_100,8,>100
12767,paw,121,34523740,99.4649154056,_100,3,>100
12768,pcs,121,34523861,99.4652640137,_100,3,>100
12769,nominee,121,34523982,99.4656126218,_100,7,>100
12770,pesticides,121,34524103,99.4659612299,_100,10,>100
12771,piped,121,34524224,99.466309838,_100,5,>100
12772,monopoly,121,34524345,99.466658446,_100,8,>100
12773,accord,121,34524466,99.4670070541,_100,6,>100
12774,louisville,121,34524587,99.4673556622,_100,10,>100
12775,resurrected,121,34524708,99.4677042703,_100,11,>100
12776,stacey,121,34524829,99.4680528784,_100,6,>100
12777,addicts,121,34524950,99.4684014865,_100,7,>100
12778,consultants,121,34525071,99.4687500945,_100,11,>100
12779,footwear,121,34525192,99.4690987026,_100,8,>100
12780,abandonment,121,34525313,99.4694473107,_100,11,>100
12781,johannesburg,121,34525434,99.4697959188,_100,12,>100
12782,judas,121,34525555,99.4701445269,_100,5,>100
12783,triggers,121,34525676,99.4704931349,_100,8,>100
12784,tug,121,34525797,99.470841743,_100,3,>100
12785,legitimacy,121,34525918,99.4711903511,_100,10,>100
12786,penchant,121,34526039,99.4715389592,_100,8,>100
12787,speculative,121,34526160,99.4718875673,_100,11,>100
12788,smitten,121,34526281,99.4722361753,_100,7,>100
12789,marketed,121,34526402,99.4725847834,_100,8,>100
12790,distressing,121,34526523,99.4729333915,_100,11,>100
12791,undo,121,34526644,99.4732819996,_100,4,>100
12792,flashbacks,121,34526765,99.4736306077,_100,10,>100
12793,harvested,121,34526886,99.4739792158,_100,9,>100
12794,sensed,121,34527007,99.4743278238,_100,6,>100
12795,parenthood,121,34527128,99.4746764319,_100,10,>100
12796,fiance,121,34527249,99.47502504,_100,6,>100
12797,adversity,121,34527370,99.4753736481,_100,9,>100
12798,organise,121,34527491,99.4757222562,_100,8,>100
12799,multiculturalism,121,34527612,99.4760708642,_100,16,>100
12800,miserably,121,34527733,99.4764194723,_100,9,>100
12801,yea,121,34527854,99.4767680804,_100,3,>100
12802,singaporeans,121,34527975,99.4771166885,_100,12,>100
12803,goldman,121,34528096,99.4774652966,_100,7,>100
12804,musings,121,34528217,99.4778139047,_100,7,>100
12805,napping,120,34528337,99.4781596317,_100,7,>100
12806,commentators,120,34528457,99.4785053587,_100,12,>100
12807,hues,120,34528577,99.4788510857,_100,4,>100
12808,conceive,120,34528697,99.4791968127,_100,8,>100
12809,voluntarily,120,34528817,99.4795425398,_100,11,>100
12810,redo,120,34528937,99.4798882668,_100,4,>100
12811,glove,120,34529057,99.4802339938,_100,5,>100
12812,prepares,120,34529177,99.4805797208,_100,8,>100
12813,ocd,120,34529297,99.4809254479,_100,3,>100
12814,georgetown,120,34529417,99.4812711749,_100,10,>100
12815,blasted,120,34529537,99.4816169019,_100,7,>100
12816,dashboard,120,34529657,99.4819626289,_100,9,>100
12817,truffle,120,34529777,99.4823083559,_100,7,>100
12818,censorship,120,34529897,99.482654083,_100,10,>100
12819,workings,120,34530017,99.48299981,_100,8,>100
12820,hsn,120,34530137,99.483345537,_100,3,>100
12821,rhinestones,120,34530257,99.483691264,_100,11,>100
12822,lavish,120,34530377,99.4840369911,_100,6,>100
12823,cropped,120,34530497,99.4843827181,_100,7,>100
12824,ridicule,120,34530617,99.4847284451,_100,8,>100
12825,rig,120,34530737,99.4850741721,_100,3,>100
12826,polling,120,34530857,99.4854198992,_100,7,>100
12827,perish,120,34530977,99.4857656262,_100,6,>100
12828,oslo,120,34531097,99.4861113532,_100,4,>100
12829,sleepless,120,34531217,99.4864570802,_100,9,>100
12830,immoral,120,34531337,99.4868028072,_100,7,>100
12831,bangkok,120,34531457,99.4871485343,_100,7,>100
12832,stimulate,120,34531577,99.4874942613,_100,9,>100
12833,inflicted,120,34531697,99.4878399883,_100,9,>100
12834,sinks,120,34531817,99.4881857153,_100,5,>100
12835,monk,120,34531937,99.4885314424,_100,4,>100
12836,finer,120,34532057,99.4888771694,_100,5,>100
12837,policing,120,34532177,99.4892228964,_100,8,>100
12838,persecuted,120,34532297,99.4895686234,_100,10,>100
12839,haunts,120,34532417,99.4899143505,_100,6,>100
12840,counterpart,120,34532537,99.4902600775,_100,11,>100
12841,victorious,120,34532657,99.4906058045,_100,10,>100
12842,timed,120,34532777,99.4909515315,_100,5,>100
12843,120,120,34532897,99.4912972585,_100,3,>100
12844,guise,120,34533017,99.4916429856,_100,5,>100
12845,fodder,120,34533137,99.4919887126,_100,6,>100
12846,lucrative,120,34533257,99.4923344396,_100,9,>100
12847,carve,120,34533377,99.4926801666,_100,5,>100
12848,merchants,120,34533497,99.4930258937,_100,9,>100
12849,sneaky,120,34533617,99.4933716207,_100,6,>100
12850,preston,120,34533737,99.4937173477,_100,7,>100
12851,bagel,120,34533857,99.4940630747,_100,5,>100
12852,whore,120,34533977,99.4944088017,_100,5,>100
12853,hormone,120,34534097,99.4947545288,_100,7,>100
12854,nanny,120,34534217,99.4951002558,_100,5,>100
12855,systematic,120,34534337,99.4954459828,_100,10,>100
12856,saison,120,34534457,99.4957917098,_100,6,>100
12857,rankings,120,34534577,99.4961374369,_100,8,>100
12858,savor,120,34534697,99.4964831639,_100,5,>100
12859,thingy,120,34534817,99.4968288909,_100,6,>100
12860,uncles,120,34534937,99.4971746179,_100,6,>100
12861,grips,120,34535057,99.497520345,_100,5,>100
12862,behavioral,120,34535177,99.497866072,_100,10,>100
12863,pragmatic,120,34535297,99.498211799,_100,9,>100
12864,torso,120,34535417,99.498557526,_100,5,>100
12865,cocaine,120,34535537,99.498903253,_100,7,>100
12866,furiously,119,34535656,99.499246099,_100,9,>100
12867,cornstarch,119,34535775,99.499588945,_100,10,>100
12868,nestled,119,34535894,99.4999317909,_100,7,>100
12869,drooling,119,34536013,99.5002746369,_100,8,>100
12870,giggled,119,34536132,99.5006174829,_100,7,>100
12871,chronicle,119,34536251,99.5009603288,_100,9,>100
12872,fernando,119,34536370,99.5013031748,_100,8,>100
12873,wrestle,119,34536489,99.5016460208,_100,7,>100
12874,laurel,119,34536608,99.5019888667,_100,6,>100
12875,projection,119,34536727,99.5023317127,_100,10,>100
12876,sookie,119,34536846,99.5026745587,_100,6,>100
12877,selfishness,119,34536965,99.5030174046,_100,11,>100
12878,whats,119,34537084,99.5033602506,_100,5,>100
12879,philosophers,119,34537203,99.5037030965,_100,12,>100
12880,serene,119,34537322,99.5040459425,_100,6,>100
12881,benny,119,34537441,99.5043887885,_100,5,>100
12882,ty,119,34537560,99.5047316344,_100,2,>100
12883,hamburger,119,34537679,99.5050744804,_100,9,>100
12884,snowing,119,34537798,99.5054173264,_100,7,>100
12885,ira,119,34537917,99.5057601723,_100,3,>100
12886,dcwv,119,34538036,99.5061030183,_100,4,>100
12887,verified,119,34538155,99.5064458643,_100,8,>100
12888,leans,119,34538274,99.5067887102,_100,5,>100
12889,standpoint,119,34538393,99.5071315562,_100,10,>100
12890,clint,119,34538512,99.5074744022,_100,5,>100
12891,wept,119,34538631,99.5078172481,_100,4,>100
12892,adorned,119,34538750,99.5081600941,_100,7,>100
12893,bernie,119,34538869,99.50850294,_100,6,>100
12894,autobiography,119,34538988,99.508845786,_100,13,>100
12895,conjure,119,34539107,99.509188632,_100,7,>100
12896,emerson,119,34539226,99.5095314779,_100,7,>100
12897,prejudices,119,34539345,99.5098743239,_100,10,>100
12898,balm,119,34539464,99.5102171699,_100,4,>100
12899,captivity,119,34539583,99.5105600158,_100,9,>100
12900,sanding,119,34539702,99.5109028618,_100,7,>100
12901,expo,119,34539821,99.5112457078,_100,4,>100
12902,nodding,119,34539940,99.5115885537,_100,7,>100
12903,necks,119,34540059,99.5119313997,_100,5,>100
12904,pasty,119,34540178,99.5122742457,_100,5,>100
12905,enticing,119,34540297,99.5126170916,_100,8,>100
12906,drool,119,34540416,99.5129599376,_100,5,>100
12907,proposing,119,34540535,99.5133027835,_100,9,>100
12908,typewriter,119,34540654,99.5136456295,_100,10,>100
12909,roth,119,34540773,99.5139884755,_100,4,>100
12910,undertake,119,34540892,99.5143313214,_100,9,>100
12911,hunted,119,34541011,99.5146741674,_100,6,>100
12912,roo,119,34541130,99.5150170134,_100,3,>100
12913,abyss,119,34541249,99.5153598593,_100,5,>100
12914,flicks,119,34541368,99.5157027053,_100,6,>100
12915,simplified,119,34541487,99.5160455513,_100,10,>100
12916,tidbits,119,34541606,99.5163883972,_100,7,>100
12917,paramount,119,34541725,99.5167312432,_100,9,>100
12918,tyson,119,34541844,99.5170740892,_100,5,>100
12919,graveyard,119,34541963,99.5174169351,_100,9,>100
12920,contingent,119,34542082,99.5177597811,_100,10,>100
12921,doesnt,119,34542201,99.518102627,_100,6,>100
12922,ernest,119,34542320,99.518445473,_100,6,>100
12923,asians,119,34542439,99.518788319,_100,6,>100
12924,oysters,119,34542558,99.5191311649,_100,7,>100
12925,murdering,119,34542677,99.5194740109,_100,9,>100
12926,henderson,119,34542796,99.5198168569,_100,9,>100
12927,unpaid,119,34542915,99.5201597028,_100,6,>100
12928,injunction,119,34543034,99.5205025488,_100,10,>100
12929,mediums,119,34543153,99.5208453948,_100,7,>100
12930,revive,118,34543271,99.5211853597,_100,6,>100
12931,idiotic,118,34543389,99.5215253246,_100,7,>100
12932,iraqi,118,34543507,99.5218652895,_100,5,>100
12933,disputes,118,34543625,99.5222052544,_100,8,>100
12934,wonky,118,34543743,99.5225452193,_100,5,>100
12935,stylist,118,34543861,99.5228851842,_100,7,>100
12936,apricot,118,34543979,99.5232251491,_100,7,>100
12937,disrespectful,118,34544097,99.523565114,_100,13,>100
12938,dinosaur,118,34544215,99.5239050789,_100,8,>100
12939,backbone,118,34544333,99.5242450438,_100,8,>100
12940,tuning,118,34544451,99.5245850087,_100,6,>100
12941,gowns,118,34544569,99.5249249736,_100,5,>100
12942,keyboards,118,34544687,99.5252649385,_100,9,>100
12943,poorest,118,34544805,99.5256049034,_100,7,>100
12944,shaft,118,34544923,99.5259448684,_100,5,>100
12945,viruses,118,34545041,99.5262848333,_100,7,>100
12946,complains,118,34545159,99.5266247982,_100,9,>100
12947,airtight,118,34545277,99.5269647631,_100,8,>100
12948,tutor,118,34545395,99.527304728,_100,5,>100
12949,respondents,118,34545513,99.5276446929,_100,11,>100
12950,ensued,118,34545631,99.5279846578,_100,6,>100
12951,persuasive,118,34545749,99.5283246227,_100,10,>100
12952,automobile,118,34545867,99.5286645876,_100,10,>100
12953,cleverly,118,34545985,99.5290045525,_100,8,>100
12954,monitored,118,34546103,99.5293445174,_100,9,>100
12955,dries,118,34546221,99.5296844823,_100,5,>100
12956,imitation,118,34546339,99.5300244472,_100,9,>100
12957,eleanor,118,34546457,99.5303644121,_100,7,>100
12958,wretched,118,34546575,99.530704377,_100,8,>100
12959,pov,118,34546693,99.5310443419,_100,3,>100
12960,heater,118,34546811,99.5313843068,_100,6,>100
12961,exaggeration,118,34546929,99.5317242718,_100,12,>100
12962,influx,118,34547047,99.5320642367,_100,6,>100
12963,mistress,118,34547165,99.5324042016,_100,8,>100
12964,muscular,118,34547283,99.5327441665,_100,8,>100
12965,shaving,118,34547401,99.5330841314,_100,7,>100
12966,gavin,118,34547519,99.5334240963,_100,5,>100
12967,woes,118,34547637,99.5337640612,_100,4,>100
12968,penang,118,34547755,99.5341040261,_100,6,>100
12969,axe,118,34547873,99.534443991,_100,3,>100
12970,intimately,118,34547991,99.5347839559,_100,10,>100
12971,perpetually,118,34548109,99.5351239208,_100,11,>100
12972,damon,118,34548227,99.5354638857,_100,5,>100
12973,lobster,118,34548345,99.5358038506,_100,7,>100
12974,slender,118,34548463,99.5361438155,_100,7,>100
12975,choking,118,34548581,99.5364837804,_100,7,>100
12976,embarked,118,34548699,99.5368237453,_100,8,>100
12977,chandelier,118,34548817,99.5371637102,_100,10,>100
12978,thyroid,118,34548935,99.5375036752,_100,7,>100
12979,fruitful,118,34549053,99.5378436401,_100,8,>100
12980,persist,118,34549171,99.538183605,_100,7,>100
12981,endorsed,118,34549289,99.5385235699,_100,8,>100
12982,faction,118,34549407,99.5388635348,_100,7,>100
12983,asap,118,34549525,99.5392034997,_100,4,>100
12984,monty,118,34549643,99.5395434646,_100,5,>100
12985,icons,118,34549761,99.5398834295,_100,5,>100
12986,costco,118,34549879,99.5402233944,_100,6,>100
12987,alzheimer,118,34549997,99.5405633593,_100,9,>100
12988,kidnapping,118,34550115,99.5409033242,_100,10,>100
12989,turnout,118,34550233,99.5412432891,_100,7,>100
12990,madly,118,34550351,99.541583254,_100,5,>100
12991,baron,118,34550469,99.5419232189,_100,5,>100
12992,vince,118,34550587,99.5422631838,_100,5,>100
12993,tulsa,118,34550705,99.5426031487,_100,5,>100
12994,unnamed,118,34550823,99.5429431136,_100,7,>100
12995,attentive,118,34550941,99.5432830785,_100,9,>100
12996,recite,118,34551059,99.5436230435,_100,6,>100
12997,provoked,117,34551176,99.5439601273,_100,8,>100
12998,jakarta,117,34551293,99.5442972111,_100,7,>100
12999,hatch,117,34551410,99.544634295,_100,5,>100
13000,clothed,117,34551527,99.5449713788,_100,7,>100
13001,dreamt,117,34551644,99.5453084627,_100,6,>100
13002,fibre,117,34551761,99.5456455465,_100,5,>100
13003,contradictions,117,34551878,99.5459826304,_100,14,>100
13004,metals,117,34551995,99.5463197142,_100,6,>100
13005,navigating,117,34552112,99.5466567981,_100,10,>100
13006,incomes,117,34552229,99.5469938819,_100,7,>100
13007,cupboards,117,34552346,99.5473309658,_100,9,>100
13008,malls,117,34552463,99.5476680496,_100,5,>100
13009,donuts,117,34552580,99.5480051335,_100,6,>100
13010,flowering,117,34552697,99.5483422173,_100,9,>100
13011,indirectly,117,34552814,99.5486793012,_100,10,>100
13012,slaughtered,117,34552931,99.549016385,_100,11,>100
13013,ledge,117,34553048,99.5493534689,_100,5,>100
13014,legit,117,34553165,99.5496905527,_100,5,>100
13015,preheated,117,34553282,99.5500276366,_100,9,>100
13016,metaphors,117,34553399,99.5503647204,_100,9,>100
13017,limp,117,34553516,99.5507018042,_100,4,>100
13018,subsidiary,117,34553633,99.5510388881,_100,10,>100
13019,satisfactory,117,34553750,99.5513759719,_100,12,>100
13020,grammy,117,34553867,99.5517130558,_100,6,>100
13021,macro,117,34553984,99.5520501396,_100,5,>100
13022,mosque,117,34554101,99.5523872235,_100,6,>100
13023,runny,117,34554218,99.5527243073,_100,5,>100
13024,nightly,117,34554335,99.5530613912,_100,7,>100
13025,gp,117,34554452,99.553398475,_100,2,>100
13026,waffles,117,34554569,99.5537355589,_100,7,>100
13027,sailed,117,34554686,99.5540726427,_100,6,>100
13028,commemorate,117,34554803,99.5544097266,_100,11,>100
13029,borne,117,34554920,99.5547468104,_100,5,>100
13030,climbs,117,34555037,99.5550838943,_100,6,>100
13031,sm,117,34555154,99.5554209781,_100,2,>100
13032,airing,117,34555271,99.555758062,_100,6,>100
13033,lofty,117,34555388,99.5560951458,_100,5,>100
13034,bomber,117,34555505,99.5564322297,_100,6,>100
13035,te,117,34555622,99.5567693135,_100,2,>100
13036,sped,117,34555739,99.5571063973,_100,4,>100
13037,chambers,117,34555856,99.5574434812,_100,8,>100
13038,descend,117,34555973,99.557780565,_100,7,>100
13039,aura,117,34556090,99.5581176489,_100,4,>100
13040,progressing,117,34556207,99.5584547327,_100,11,>100
13041,creams,117,34556324,99.5587918166,_100,6,>100
13042,interventions,117,34556441,99.5591289004,_100,13,>100
13043,stamina,117,34556558,99.5594659843,_100,7,>100
13044,snapshot,117,34556675,99.5598030681,_100,8,>100
13045,outgoing,117,34556792,99.560140152,_100,8,>100
13046,founders,116,34556908,99.5604743548,_100,8,>100
13047,jolly,116,34557024,99.5608085576,_100,5,>100
13048,upsetting,116,34557140,99.5611427603,_100,9,>100
13049,wip,116,34557256,99.5614769631,_100,3,>100
13050,generates,116,34557372,99.5618111659,_100,9,>100
13051,exclusion,116,34557488,99.5621453687,_100,9,>100
13052,discourage,116,34557604,99.5624795715,_100,10,>100
13053,cascade,116,34557720,99.5628137743,_100,7,>100
13054,piling,116,34557836,99.5631479771,_100,6,>100
13055,catholicism,116,34557952,99.5634821799,_100,11,>100
13056,sharia,116,34558068,99.5638163826,_100,6,>100
13057,scholarly,116,34558184,99.5641505854,_100,9,>100
13058,salesman,116,34558300,99.5644847882,_100,8,>100
13059,sidelines,116,34558416,99.564818991,_100,9,>100
13060,seedlings,116,34558532,99.5651531938,_100,9,>100
13061,amazement,116,34558648,99.5654873966,_100,9,>100
13062,forensic,116,34558764,99.5658215994,_100,8,>100
13063,sparse,116,34558880,99.5661558022,_100,6,>100
13064,phew,116,34558996,99.566490005,_100,4,>100
13065,foe,116,34559112,99.5668242077,_100,3,>100
13066,stimulating,116,34559228,99.5671584105,_100,11,>100
13067,breeds,116,34559344,99.5674926133,_100,6,>100
13068,fortunes,116,34559460,99.5678268161,_100,8,>100
13069,ominous,116,34559576,99.5681610189,_100,7,>100
13070,allocated,116,34559692,99.5684952217,_100,9,>100
13071,claws,116,34559808,99.5688294245,_100,5,>100
13072,pup,116,34559924,99.5691636273,_100,3,>100
13073,siege,116,34560040,99.5694978301,_100,5,>100
13074,affirmation,116,34560156,99.5698320328,_100,11,>100
13075,certificates,116,34560272,99.5701662356,_100,12,>100
13076,barney,116,34560388,99.5705004384,_100,6,>100
13077,contraction,116,34560504,99.5708346412,_100,11,>100
13078,paprika,116,34560620,99.571168844,_100,7,>100
13079,prosecutor,116,34560736,99.5715030468,_100,10,>100
13080,chubby,116,34560852,99.5718372496,_100,6,>100
13081,thicken,116,34560968,99.5721714524,_100,7,>100
13082,syrian,116,34561084,99.5725056552,_100,6,>100
13083,retains,116,34561200,99.5728398579,_100,7,>100
13084,nifty,116,34561316,99.5731740607,_100,5,>100
13085,infertility,116,34561432,99.5735082635,_100,11,>100
13086,stoke,116,34561548,99.5738424663,_100,5,>100
13087,physicians,116,34561664,99.5741766691,_100,10,>100
13088,cultivated,116,34561780,99.5745108719,_100,10,>100
13089,pivotal,116,34561896,99.5748450747,_100,7,>100
13090,rectangular,116,34562012,99.5751792775,_100,11,>100
13091,goodreads,116,34562128,99.5755134803,_100,9,>100
13092,glimpses,116,34562244,99.575847683,_100,8,>100
13093,betting,116,34562360,99.5761818858,_100,7,>100
13094,aback,116,34562476,99.5765160886,_100,5,>100
13095,actresses,116,34562592,99.5768502914,_100,9,>100
13096,radicals,116,34562708,99.5771844942,_100,8,>100
13097,thermometer,116,34562824,99.577518697,_100,11,>100
13098,luscious,116,34562940,99.5778528998,_100,8,>100
13099,tesco,116,34563056,99.5781871026,_100,5,>100
13100,discard,116,34563172,99.5785213054,_100,7,>100
13101,rot,116,34563288,99.5788555081,_100,3,>100
13102,prettier,116,34563404,99.5791897109,_100,8,>100
13103,devotional,116,34563520,99.5795239137,_100,10,>100
13104,matted,116,34563636,99.5798581165,_100,6,>100
13105,pastries,116,34563752,99.5801923193,_100,8,>100
13106,jewel,116,34563868,99.5805265221,_100,5,>100
13107,expired,116,34563984,99.5808607249,_100,7,>100
13108,mayhem,116,34564100,99.5811949277,_100,6,>100
13109,nuances,116,34564216,99.5815291305,_100,7,>100
13110,southeast,116,34564332,99.5818633332,_100,9,>100
13111,weathered,116,34564448,99.582197536,_100,9,>100
13112,boris,116,34564564,99.5825317388,_100,5,>100
13113,anxiously,116,34564680,99.5828659416,_100,9,>100
13114,gras,116,34564796,99.5832001444,_100,4,>100
13115,sxsw,116,34564912,99.5835343472,_100,4,>100
13116,keyword,116,34565028,99.58386855,_100,7,>100
13117,discontent,116,34565144,99.5842027528,_100,10,>100
13118,carts,116,34565260,99.5845369556,_100,5,>100
13119,madame,116,34565376,99.5848711583,_100,6,>100
13120,handicap,116,34565492,99.5852053611,_100,8,>100
13121,cohesive,116,34565608,99.5855395639,_100,8,>100
13122,scrambling,116,34565724,99.5858737667,_100,10,>100
13123,peeking,116,34565840,99.5862079695,_100,7,>100
13124,repertoire,116,34565956,99.5865421723,_100,10,>100
13125,usb,116,34566072,99.5868763751,_100,3,>100
13126,mumbai,116,34566188,99.5872105779,_100,6,>100
13127,palmer,116,34566304,99.5875447807,_100,6,>100
13128,depended,115,34566419,99.5878761024,_100,8,>100
13129,turtles,115,34566534,99.5882074241,_100,7,>100
13130,somalia,115,34566649,99.5885387458,_100,7,>100
13131,motivating,115,34566764,99.5888700676,_100,10,>100
13132,tread,115,34566879,99.5892013893,_100,5,>100
13133,unleashed,115,34566994,99.589532711,_100,9,>100
13134,rightfully,115,34567109,99.5898640328,_100,10,>100
13135,sb,115,34567224,99.5901953545,_100,2,>100
13136,transitional,115,34567339,99.5905266762,_100,12,>100
13137,toyota,115,34567454,99.590857998,_100,6,>100
13138,screened,115,34567569,99.5911893197,_100,8,>100
13139,surrendered,115,34567684,99.5915206414,_100,11,>100
13140,supplying,115,34567799,99.5918519631,_100,9,>100
13141,timid,115,34567914,99.5921832849,_100,5,>100
13142,tulips,115,34568029,99.5925146066,_100,6,>100
13143,slows,115,34568144,99.5928459283,_100,5,>100
13144,openings,115,34568259,99.5931772501,_100,8,>100
13145,intolerance,115,34568374,99.5935085718,_100,11,>100
13146,vigorously,115,34568489,99.5938398935,_100,10,>100
13147,practise,115,34568604,99.5941712153,_100,8,>100
13148,variant,115,34568719,99.594502537,_100,7,>100
13149,sunscreen,115,34568834,99.5948338587,_100,9,>100
13150,coordination,115,34568949,99.5951651804,_100,12,>100
13151,demeanor,115,34569064,99.5954965022,_100,8,>100
13152,nash,115,34569179,99.5958278239,_100,4,>100
13153,posh,115,34569294,99.5961591456,_100,4,>100
13154,guacamole,115,34569409,99.5964904674,_100,9,>100
13155,spotting,115,34569524,99.5968217891,_100,8,>100
13156,troop,115,34569639,99.5971531108,_100,5,>100
13157,occupying,115,34569754,99.5974844326,_100,9,>100
13158,tiniest,115,34569869,99.5978157543,_100,7,>100
13159,glucose,115,34569984,99.598147076,_100,7,>100
13160,willow,115,34570099,99.5984783978,_100,6,>100
13161,dodgers,115,34570214,99.5988097195,_100,7,>100
13162,hayes,115,34570329,99.5991410412,_100,5,>100
13163,overthrow,115,34570444,99.5994723629,_100,9,>100
13164,laced,115,34570559,99.5998036847,_100,5,>100
13165,comforted,115,34570674,99.6001350064,_100,9,>100
13166,heinous,115,34570789,99.6004663281,_100,7,>100
13167,kaiser,115,34570904,99.6007976499,_100,6,>100
13168,demolished,115,34571019,99.6011289716,_100,10,>100
13169,unheard,115,34571134,99.6014602933,_100,7,>100
13170,committees,115,34571249,99.6017916151,_100,10,>100
13171,mathematics,115,34571364,99.6021229368,_100,11,>100
13172,audit,115,34571479,99.6024542585,_100,5,>100
13173,pervasive,115,34571594,99.6027855802,_100,9,>100
13174,selective,115,34571709,99.603116902,_100,9,>100
13175,hesitated,115,34571824,99.6034482237,_100,9,>100
13176,cam,115,34571939,99.6037795454,_100,3,>100
13177,exclude,115,34572054,99.6041108672,_100,7,>100
13178,spacious,115,34572169,99.6044421889,_100,8,>100
13179,showered,115,34572284,99.6047735106,_100,8,>100
13180,linguistic,115,34572399,99.6051048324,_100,10,>100
13181,sensations,115,34572514,99.6054361541,_100,10,>100
13182,fixtures,115,34572629,99.6057674758,_100,8,>100
13183,cosmetic,114,34572743,99.6060959165,_100,8,>100
13184,affirmed,114,34572857,99.6064243572,_100,8,>100
13185,napkins,114,34572971,99.6067527978,_100,7,>100
13186,compose,114,34573085,99.6070812385,_100,7,>100
13187,culprit,114,34573199,99.6074096792,_100,7,>100
13188,alignment,114,34573313,99.6077381198,_100,9,>100
13189,echoing,114,34573427,99.6080665605,_100,7,>100
13190,sheila,114,34573541,99.6083950012,_100,6,>100
13191,crusty,114,34573655,99.6087234419,_100,6,>100
13192,dysfunctional,114,34573769,99.6090518825,_100,13,>100
13193,onset,114,34573883,99.6093803232,_100,5,>100
13194,synonymous,114,34573997,99.6097087639,_100,10,>100
13195,communicated,114,34574111,99.6100372045,_100,12,>100
13196,symphony,114,34574225,99.6103656452,_100,8,>100
13197,wrought,114,34574339,99.6106940859,_100,7,>100
13198,bred,114,34574453,99.6110225266,_100,4,>100
13199,imaginations,114,34574567,99.6113509672,_100,12,>100
13200,prostate,114,34574681,99.6116794079,_100,8,>100
13201,negotiated,114,34574795,99.6120078486,_100,10,>100
13202,tainted,114,34574909,99.6123362893,_100,7,>100
13203,extinction,114,34575023,99.6126647299,_100,10,>100
13204,archbishop,114,34575137,99.6129931706,_100,10,>100
13205,weakened,114,34575251,99.6133216113,_100,8,>100
13206,anonymity,114,34575365,99.6136500519,_100,9,>100
13207,coma,114,34575479,99.6139784926,_100,4,>100
13208,wrongs,114,34575593,99.6143069333,_100,6,>100
13209,rethink,114,34575707,99.614635374,_100,7,>100
13210,miraculously,114,34575821,99.6149638146,_100,12,>100
13211,yr,114,34575935,99.6152922553,_100,2,>100
13212,majestic,114,34576049,99.615620696,_100,8,>100
13213,explosives,114,34576163,99.6159491366,_100,10,>100
13214,adhd,114,34576277,99.6162775773,_100,4,>100
13215,rand,114,34576391,99.616606018,_100,4,>100
13216,amendments,114,34576505,99.6169344587,_100,10,>100
13217,stalin,114,34576619,99.6172628993,_100,6,>100
13218,iceberg,114,34576733,99.61759134,_100,7,>100
13219,confidently,114,34576847,99.6179197807,_100,11,>100
13220,filler,114,34576961,99.6182482213,_100,6,>100
13221,fateful,114,34577075,99.618576662,_100,7,>100
13222,cutie,114,34577189,99.6189051027,_100,5,>100
13223,mega,114,34577303,99.6192335434,_100,4,>100
13224,elves,114,34577417,99.619561984,_100,5,>100
13225,insides,114,34577531,99.6198904247,_100,7,>100
13226,visibility,114,34577645,99.6202188654,_100,10,>100
13227,elliptical,114,34577759,99.620547306,_100,10,>100
13228,camper,114,34577873,99.6208757467,_100,6,>100
13229,url,114,34577987,99.6212041874,_100,3,>100
13230,undeniable,114,34578101,99.6215326281,_100,10,>100
13231,accomplishing,114,34578215,99.6218610687,_100,13,>100
13232,inflammation,114,34578329,99.6221895094,_100,12,>100
13233,carolyn,114,34578443,99.6225179501,_100,7,>100
13234,illusions,114,34578557,99.6228463907,_100,9,>100
13235,protocol,114,34578671,99.6231748314,_100,8,>100
13236,goodman,114,34578785,99.6235032721,_100,7,>100
13237,scents,114,34578899,99.6238317128,_100,6,>100
13238,shuffle,114,34579013,99.6241601534,_100,7,>100
13239,innings,114,34579127,99.6244885941,_100,7,>100
13240,miscarriage,114,34579241,99.6248170348,_100,11,>100
13241,idols,114,34579355,99.6251454754,_100,5,>100
13242,mums,114,34579469,99.6254739161,_100,4,>100
13243,lieu,114,34579583,99.6258023568,_100,4,>100
13244,chester,114,34579697,99.6261307975,_100,7,>100
13245,evaluating,114,34579811,99.6264592381,_100,10,>100
13246,relentlessly,114,34579925,99.6267876788,_100,12,>100
13247,cor,114,34580039,99.6271161195,_100,3,>100
13248,abnormal,114,34580153,99.6274445602,_100,8,>100
13249,unthinkable,114,34580267,99.6277730008,_100,11,>100
13250,dashing,114,34580381,99.6281014415,_100,7,>100
13251,sweetie,114,34580495,99.6284298822,_100,7,>100
13252,lindsey,114,34580609,99.6287583228,_100,7,>100
13253,variables,114,34580723,99.6290867635,_100,9,>100
13254,arthritis,114,34580837,99.6294152042,_100,9,>100
13255,tenderness,114,34580951,99.6297436449,_100,10,>100
13256,badges,114,34581065,99.6300720855,_100,6,>100
13257,lilac,114,34581179,99.6304005262,_100,5,>100
13258,elbows,114,34581293,99.6307289669,_100,6,>100
13259,camra,114,34581407,99.6310574075,_100,5,>100
13260,outset,114,34581521,99.6313858482,_100,6,>100
13261,rabid,114,34581635,99.6317142889,_100,5,>100
13262,uncanny,114,34581749,99.6320427296,_100,7,>100
13263,honorable,114,34581863,99.6323711702,_100,9,>100
13264,alarmed,114,34581977,99.6326996109,_100,7,>100
13265,rotate,113,34582090,99.6330251705,_100,6,>100
13266,ghostly,113,34582203,99.6333507301,_100,7,>100
13267,dishonest,113,34582316,99.6336762897,_100,9,>100
13268,narrowed,113,34582429,99.6340018494,_100,8,>100
13269,npr,113,34582542,99.634327409,_100,3,>100
13270,flops,113,34582655,99.6346529686,_100,5,>100
13271,catalyst,113,34582768,99.6349785282,_100,8,>100
13272,proteins,113,34582881,99.6353040878,_100,8,>100
13273,legislators,113,34582994,99.6356296474,_100,11,>100
13274,hoop,113,34583107,99.635955207,_100,4,>100
13275,unpopular,113,34583220,99.6362807666,_100,9,>100
13276,chapman,113,34583333,99.6366063263,_100,7,>100
13277,decisive,113,34583446,99.6369318859,_100,8,>100
13278,resembled,113,34583559,99.6372574455,_100,9,>100
13279,clergy,113,34583672,99.6375830051,_100,6,>100
13280,extremist,113,34583785,99.6379085647,_100,9,>100
13281,awaken,113,34583898,99.6382341243,_100,6,>100
13282,temporal,113,34584011,99.6385596839,_100,8,>100
13283,presidents,113,34584124,99.6388852435,_100,10,>100
13284,lifestyles,113,34584237,99.6392108032,_100,10,>100
13285,paralyzed,113,34584350,99.6395363628,_100,9,>100
13286,futuristic,113,34584463,99.6398619224,_100,10,>100
13287,acidity,113,34584576,99.640187482,_100,7,>100
13288,disrupt,113,34584689,99.6405130416,_100,7,>100
13289,kirby,113,34584802,99.6408386012,_100,5,>100
13290,brittany,113,34584915,99.6411641608,_100,8,>100
13291,mischief,113,34585028,99.6414897205,_100,8,>100
13292,naval,113,34585141,99.6418152801,_100,5,>100
13293,milton,113,34585254,99.6421408397,_100,6,>100
13294,likeable,113,34585367,99.6424663993,_100,8,>100
13295,squirrels,113,34585480,99.6427919589,_100,9,>100
13296,carmen,113,34585593,99.6431175185,_100,6,>100
13297,comforts,113,34585706,99.6434430781,_100,8,>100
13298,poorer,113,34585819,99.6437686377,_100,6,>100
13299,trimester,113,34585932,99.6440941974,_100,9,>100
13300,foodie,113,34586045,99.644419757,_100,6,>100
13301,sponsorship,113,34586158,99.6447453166,_100,11,>100
13302,jumper,113,34586271,99.6450708762,_100,6,>100
13303,reconcile,113,34586384,99.6453964358,_100,9,>100
13304,cheery,113,34586497,99.6457219954,_100,6,>100
13305,restoring,113,34586610,99.646047555,_100,9,>100
13306,vic,113,34586723,99.6463731147,_100,3,>100
13307,thickened,113,34586836,99.6466986743,_100,9,>100
13308,pretentious,113,34586949,99.6470242339,_100,11,>100
13309,commercially,113,34587062,99.6473497935,_100,12,>100
13310,wei,113,34587175,99.6476753531,_100,3,>100
13311,tracey,113,34587288,99.6480009127,_100,6,>100
13312,michele,113,34587401,99.6483264723,_100,7,>100
13313,jillian,113,34587514,99.6486520319,_100,7,>100
13314,snowflake,113,34587627,99.6489775916,_100,9,>100
13315,drones,113,34587740,99.6493031512,_100,6,>100
13316,airy,113,34587853,99.6496287108,_100,4,>100
13317,tsa,113,34587966,99.6499542704,_100,3,>100
13318,toughest,113,34588079,99.65027983,_100,8,>100
13319,puffed,113,34588192,99.6506053896,_100,6,>100
13320,ibm,113,34588305,99.6509309492,_100,3,>100
13321,carr,113,34588418,99.6512565089,_100,4,>100
13322,mri,113,34588531,99.6515820685,_100,3,>100
13323,cambodia,113,34588644,99.6519076281,_100,8,>100
13324,customary,113,34588757,99.6522331877,_100,9,>100
13325,trusts,113,34588870,99.6525587473,_100,6,>100
13326,freebies,113,34588983,99.6528843069,_100,8,>100
13327,poisoned,113,34589096,99.6532098665,_100,8,>100
13328,horrid,113,34589209,99.6535354261,_100,6,>100
13329,entice,113,34589322,99.6538609858,_100,6,>100
13330,cairo,113,34589435,99.6541865454,_100,5,>100
13331,oblivion,112,34589547,99.6545092239,_100,8,>100
13332,stature,112,34589659,99.6548319025,_100,7,>100
13333,lovelies,112,34589771,99.655154581,_100,8,>100
13334,sourced,112,34589883,99.6554772596,_100,7,>100
13335,liberating,112,34589995,99.6557999381,_100,10,>100
13336,lovable,112,34590107,99.6561226167,_100,7,>100
13337,itchy,112,34590219,99.6564452953,_100,5,>100
13338,digs,112,34590331,99.6567679738,_100,4,>100
13339,upfront,112,34590443,99.6570906524,_100,7,>100
13340,hbo,112,34590555,99.6574133309,_100,3,>100
13341,guarded,112,34590667,99.6577360095,_100,7,>100
13342,distributors,112,34590779,99.658058688,_100,12,>100
13343,bookshop,112,34590891,99.6583813666,_100,8,>100
13344,marketers,112,34591003,99.6587040451,_100,9,>100
13345,tract,112,34591115,99.6590267237,_100,5,>100
13346,edwin,112,34591227,99.6593494022,_100,5,>100
13347,hippie,112,34591339,99.6596720808,_100,6,>100
13348,straighten,112,34591451,99.6599947594,_100,10,>100
13349,procession,112,34591563,99.6603174379,_100,10,>100
13350,flute,112,34591675,99.6606401165,_100,5,>100
13351,snag,112,34591787,99.660962795,_100,4,>100
13352,pediatrician,112,34591899,99.6612854736,_100,12,>100
13353,uterus,112,34592011,99.6616081521,_100,6,>100
13354,smear,112,34592123,99.6619308307,_100,5,>100
13355,referenced,112,34592235,99.6622535092,_100,10,>100
13356,machu,112,34592347,99.6625761878,_100,5,>100
13357,grazing,112,34592459,99.6628988663,_100,7,>100
13358,chan,112,34592571,99.6632215449,_100,4,>100
13359,perusing,112,34592683,99.6635442235,_100,8,>100
13360,redeemed,112,34592795,99.663866902,_100,8,>100
13361,enigmatic,112,34592907,99.6641895806,_100,9,>100
13362,cb,112,34593019,99.6645122591,_100,2,>100
13363,foray,112,34593131,99.6648349377,_100,5,>100
13364,wort,112,34593243,99.6651576162,_100,4,>100
13365,cites,112,34593355,99.6654802948,_100,5,>100
13366,parting,112,34593467,99.6658029733,_100,7,>100
13367,sayings,112,34593579,99.6661256519,_100,7,>100
13368,gandhi,112,34593691,99.6664483304,_100,6,>100
13369,hazel,112,34593803,99.666771009,_100,5,>100
13370,starvation,112,34593915,99.6670936876,_100,10,>100
13371,cuff,112,34594027,99.6674163661,_100,4,>100
13372,flyer,112,34594139,99.6677390447,_100,5,>100
13373,strategically,112,34594251,99.6680617232,_100,13,>100
13374,entrusted,112,34594363,99.6683844018,_100,9,>100
13375,successive,112,34594475,99.6687070803,_100,10,>100
13376,moaning,112,34594587,99.6690297589,_100,7,>100
13377,repay,112,34594699,99.6693524374,_100,5,>100
13378,rory,112,34594811,99.669675116,_100,4,>100
13379,sr,112,34594923,99.6699977945,_100,2,>100
13380,verification,112,34595035,99.6703204731,_100,12,>100
13381,carpets,112,34595147,99.6706431517,_100,7,>100
13382,mathematical,112,34595259,99.6709658302,_100,12,>100
13383,duly,112,34595371,99.6712885088,_100,4,>100
13384,wade,112,34595483,99.6716111873,_100,4,>100
13385,pharmaceutical,112,34595595,99.6719338659,_100,14,>100
13386,montgomery,112,34595707,99.6722565444,_100,10,>100
13387,resilience,112,34595819,99.672579223,_100,10,>100
13388,jammed,112,34595931,99.6729019015,_100,6,>100
13389,spitting,112,34596043,99.6732245801,_100,8,>100
13390,bestselling,112,34596155,99.6735472587,_100,11,>100
13391,scramble,112,34596267,99.6738699372,_100,8,>100
13392,abigail,112,34596379,99.6741926158,_100,7,>100
13393,racists,112,34596491,99.6745152943,_100,7,>100
13394,sweetened,112,34596603,99.6748379729,_100,9,>100
13395,nominations,112,34596715,99.6751606514,_100,11,>100
13396,tactical,112,34596827,99.67548333,_100,8,>100
13397,dustin,112,34596939,99.6758060085,_100,6,>100
13398,disclose,112,34597051,99.6761286871,_100,8,>100
13399,deities,112,34597163,99.6764513656,_100,7,>100
13400,consolation,112,34597275,99.6767740442,_100,11,>100
13401,hinted,112,34597387,99.6770967228,_100,6,>100
13402,caravan,112,34597499,99.6774194013,_100,7,>100
13403,offline,112,34597611,99.6777420799,_100,7,>100
13404,someplace,112,34597723,99.6780647584,_100,9,>100
13405,perfected,112,34597835,99.678387437,_100,9,>100
13406,shelley,112,34597947,99.6787101155,_100,7,>100
13407,picchu,112,34598059,99.6790327941,_100,6,>100
13408,nerdy,112,34598171,99.6793554726,_100,5,>100
13409,abandoning,112,34598283,99.6796781512,_100,10,>100
13410,margarine,111,34598394,99.6799979487,_100,9,>100
13411,friction,111,34598505,99.6803177462,_100,8,>100
13412,taxation,111,34598616,99.6806375437,_100,8,>100
13413,metric,111,34598727,99.6809573412,_100,6,>100
13414,perverse,111,34598838,99.6812771387,_100,8,>100
13415,moonlight,111,34598949,99.6815969362,_100,9,>100
13416,nectar,111,34599060,99.6819167337,_100,6,>100
13417,heroin,111,34599171,99.6822365312,_100,6,>100
13418,ob,111,34599282,99.6825563287,_100,2,>100
13419,katy,111,34599393,99.6828761262,_100,4,>100
13420,perpetrators,111,34599504,99.6831959236,_100,12,>100
13421,tolkien,111,34599615,99.6835157211,_100,7,>100
13422,cranberry,111,34599726,99.6838355186,_100,9,>100
13423,autonomy,111,34599837,99.6841553161,_100,8,>100
13424,gathers,111,34599948,99.6844751136,_100,7,>100
13425,weakest,111,34600059,99.6847949111,_100,7,>100
13426,balances,111,34600170,99.6851147086,_100,8,>100
13427,latino,111,34600281,99.6854345061,_100,6,>100
13428,islamists,111,34600392,99.6857543036,_100,9,>100
13429,bras,111,34600503,99.6860741011,_100,4,>100
13430,organisers,111,34600614,99.6863938986,_100,10,>100
13431,felony,111,34600725,99.6867136961,_100,6,>100
13432,commodities,111,34600836,99.6870334936,_100,11,>100
13433,snail,111,34600947,99.6873532911,_100,5,>100
13434,brim,111,34601058,99.6876730886,_100,4,>100
13435,defy,111,34601169,99.6879928861,_100,4,>100
13436,gladys,111,34601280,99.6883126836,_100,6,>100
13437,valleys,111,34601391,99.6886324811,_100,7,>100
13438,irs,111,34601502,99.6889522786,_100,3,>100
13439,shrug,111,34601613,99.6892720761,_100,5,>100
13440,logging,111,34601724,99.6895918736,_100,7,>100
13441,russ,111,34601835,99.6899116711,_100,4,>100
13442,faulty,111,34601946,99.6902314686,_100,6,>100
13443,careless,111,34602057,99.6905512661,_100,8,>100
13444,loosen,111,34602168,99.6908710636,_100,6,>100
13445,richly,111,34602279,99.6911908611,_100,6,>100
13446,fetish,111,34602390,99.6915106585,_100,6,>100
13447,jade,111,34602501,99.691830456,_100,4,>100
13448,unavoidable,111,34602612,99.6921502535,_100,11,>100
13449,crank,111,34602723,99.692470051,_100,5,>100
13450,hallmark,111,34602834,99.6927898485,_100,8,>100
13451,googled,111,34602945,99.693109646,_100,7,>100
13452,candies,111,34603056,99.6934294435,_100,7,>100
13453,reset,111,34603167,99.693749241,_100,5,>100
13454,electorate,111,34603278,99.6940690385,_100,10,>100
13455,issuing,111,34603389,99.694388836,_100,7,>100
13456,veronica,111,34603500,99.6947086335,_100,8,>100
13457,antiques,111,34603611,99.695028431,_100,8,>100
13458,pollen,111,34603722,99.6953482285,_100,6,>100
13459,organisms,111,34603833,99.695668026,_100,9,>100
13460,facade,111,34603944,99.6959878235,_100,6,>100
13461,visualize,111,34604055,99.696307621,_100,9,>100
13462,strangest,111,34604166,99.6966274185,_100,9,>100
13463,demonic,111,34604277,99.696947216,_100,7,>100
13464,teased,111,34604388,99.6972670135,_100,6,>100
13465,copious,111,34604499,99.697586811,_100,7,>100
13466,aperture,111,34604610,99.6979066085,_100,8,>100
13467,wickedness,111,34604721,99.698226406,_100,10,>100
13468,copenhagen,111,34604832,99.6985462035,_100,10,>100
13469,stationed,111,34604943,99.698866001,_100,9,>100
13470,dissent,111,34605054,99.6991857985,_100,7,>100
13471,morton,111,34605165,99.699505596,_100,6,>100
13472,outings,111,34605276,99.6998253934,_100,7,>100
13473,consulted,110,34605386,99.7001423099,_100,9,>100
13474,winters,110,34605496,99.7004592263,_100,7,>100
13475,praising,110,34605606,99.7007761428,_100,8,>100
13476,steampunk,110,34605716,99.7010930592,_100,9,>100
13477,christy,110,34605826,99.7014099756,_100,7,>100
13478,infringing,110,34605936,99.7017268921,_100,10,>100
13479,craze,110,34606046,99.7020438085,_100,5,>100
13480,majors,110,34606156,99.7023607249,_100,6,>100
13481,pinpoint,110,34606266,99.7026776414,_100,8,>100
13482,intertwined,110,34606376,99.7029945578,_100,11,>100
13483,childcare,110,34606486,99.7033114743,_100,9,>100
13484,fleeing,110,34606596,99.7036283907,_100,7,>100
13485,chills,110,34606706,99.7039453071,_100,6,>100
13486,erik,110,34606816,99.7042622236,_100,4,>100
13487,sprinkling,110,34606926,99.70457914,_100,10,>100
13488,silicone,110,34607036,99.7048960565,_100,8,>100
13489,notoriously,110,34607146,99.7052129729,_100,11,>100
13490,dixie,110,34607256,99.7055298893,_100,5,>100
13491,courtroom,110,34607366,99.7058468058,_100,9,>100
13492,undone,110,34607476,99.7061637222,_100,6,>100
13493,realistically,110,34607586,99.7064806386,_100,13,>100
13494,joanne,110,34607696,99.7067975551,_100,6,>100
13495,mulch,110,34607806,99.7071144715,_100,5,>100
13496,110,110,34607916,99.707431388,_100,3,>100
13497,traveler,110,34608026,99.7077483044,_100,8,>100
13498,regulated,110,34608136,99.7080652208,_100,9,>100
13499,evelyn,110,34608246,99.7083821373,_100,6,>100
13500,inserts,110,34608356,99.7086990537,_100,7,>100
13501,ticked,110,34608466,99.7090159701,_100,6,>100
13502,burdens,110,34608576,99.7093328866,_100,7,>100
13503,seductive,110,34608686,99.709649803,_100,9,>100
13504,partake,110,34608796,99.7099667195,_100,7,>100
13505,cafes,110,34608906,99.7102836359,_100,5,>100
13506,diligence,110,34609016,99.7106005523,_100,9,>100
13507,obscene,110,34609126,99.7109174688,_100,7,>100
13508,proposes,110,34609236,99.7112343852,_100,8,>100
13509,uploading,110,34609346,99.7115513016,_100,9,>100
13510,keller,110,34609456,99.7118682181,_100,6,>100
13511,acknowledges,110,34609566,99.7121851345,_100,12,>100
13512,resumed,110,34609676,99.712502051,_100,7,>100
13513,unconditionally,110,34609786,99.7128189674,_100,15,>100
13514,booty,110,34609896,99.7131358838,_100,5,>100
13515,borderline,110,34610006,99.7134528003,_100,10,>100
13516,flannel,110,34610116,99.7137697167,_100,7,>100
13517,extravagant,110,34610226,99.7140866331,_100,11,>100
13518,sammy,110,34610336,99.7144035496,_100,5,>100
13519,zeus,110,34610446,99.714720466,_100,4,>100
13520,nikon,110,34610556,99.7150373825,_100,5,>100
13521,rallies,110,34610666,99.7153542989,_100,7,>100
13522,composers,110,34610776,99.7156712153,_100,9,>100
13523,comb,110,34610886,99.7159881318,_100,4,>100
13524,plantation,110,34610996,99.7163050482,_100,10,>100
13525,dome,110,34611106,99.7166219646,_100,4,>100
13526,underestimate,110,34611216,99.7169388811,_100,13,>100
13527,pits,110,34611326,99.7172557975,_100,4,>100
13528,xmas,110,34611436,99.717572714,_100,4,>100
13529,lester,110,34611546,99.7178896304,_100,6,>100
13530,mend,110,34611656,99.7182065468,_100,4,>100
13531,benign,110,34611766,99.7185234633,_100,6,>100
13532,bonuses,110,34611876,99.7188403797,_100,7,>100
13533,compulsory,110,34611986,99.7191572961,_100,10,>100
13534,serenity,110,34612096,99.7194742126,_100,8,>100
13535,gb,110,34612206,99.719791129,_100,2,>100
13536,autograph,110,34612316,99.7201080455,_100,9,>100
13537,dashed,110,34612426,99.7204249619,_100,6,>100
13538,tracing,110,34612536,99.7207418783,_100,7,>100
13539,exploits,110,34612646,99.7210587948,_100,8,>100
13540,staples,110,34612756,99.7213757112,_100,7,>100
13541,dominating,110,34612866,99.7216926276,_100,10,>100
13542,malicious,110,34612976,99.7220095441,_100,9,>100
13543,breadcrumbs,110,34613086,99.7223264605,_100,11,>100
13544,accessed,110,34613196,99.722643377,_100,8,>100
13545,switches,110,34613306,99.7229602934,_100,8,>100
13546,boxed,110,34613416,99.7232772098,_100,5,>100
13547,flooring,110,34613526,99.7235941263,_100,8,>100
13548,mitch,110,34613636,99.7239110427,_100,5,>100
13549,norton,110,34613746,99.7242279591,_100,6,>100
13550,offshore,110,34613856,99.7245448756,_100,8,>100
13551,tornadoes,110,34613966,99.724861792,_100,9,>100
13552,counties,110,34614076,99.7251787085,_100,8,>100
13553,necessities,110,34614186,99.7254956249,_100,11,>100
13554,anyhoo,110,34614296,99.7258125413,_100,6,>100
13555,marvellous,110,34614406,99.7261294578,_100,10,>100
13556,whatnot,109,34614515,99.7264434932,_100,7,>100
13557,primal,109,34614624,99.7267575285,_100,6,>100
13558,methodology,109,34614733,99.7270715639,_100,11,>100
13559,annoyance,109,34614842,99.7273855993,_100,9,>100
13560,regeneration,109,34614951,99.7276996347,_100,12,>100
13561,pathway,109,34615060,99.72801367,_100,7,>100
13562,hailed,109,34615169,99.7283277054,_100,6,>100
13563,manifesto,109,34615278,99.7286417408,_100,9,>100
13564,appreciating,109,34615387,99.7289557762,_100,12,>100
13565,injected,109,34615496,99.7292698116,_100,8,>100
13566,boyfriends,109,34615605,99.7295838469,_100,10,>100
13567,fiddle,109,34615714,99.7298978823,_100,6,>100
13568,unpacking,109,34615823,99.7302119177,_100,9,>100
13569,chewed,109,34615932,99.7305259531,_100,6,>100
13570,yielded,109,34616041,99.7308399885,_100,7,>100
13571,dal,109,34616150,99.7311540238,_100,3,>100
13572,maze,109,34616259,99.7314680592,_100,4,>100
13573,erected,109,34616368,99.7317820946,_100,7,>100
13574,hanger,109,34616477,99.73209613,_100,6,>100
13575,strung,109,34616586,99.7324101654,_100,6,>100
13576,claude,109,34616695,99.7327242007,_100,6,>100
13577,limitation,109,34616804,99.7330382361,_100,10,>100
13578,nods,109,34616913,99.7333522715,_100,4,>100
13579,adolescence,109,34617022,99.7336663069,_100,11,>100
13580,dreading,109,34617131,99.7339803422,_100,8,>100
13581,ahh,109,34617240,99.7342943776,_100,3,>100
13582,outreach,109,34617349,99.734608413,_100,8,>100
13583,scots,109,34617458,99.7349224484,_100,5,>100
13584,garnered,109,34617567,99.7352364838,_100,8,>100
13585,conan,109,34617676,99.7355505191,_100,5,>100
13586,harbour,109,34617785,99.7358645545,_100,7,>100
13587,soothe,109,34617894,99.7361785899,_100,6,>100
13588,captivated,109,34618003,99.7364926253,_100,10,>100
13589,marvin,109,34618112,99.7368066607,_100,6,>100
13590,cultivate,109,34618221,99.737120696,_100,9,>100
13591,tangy,109,34618330,99.7374347314,_100,5,>100
13592,survives,109,34618439,99.7377487668,_100,8,>100
13593,marital,109,34618548,99.7380628022,_100,7,>100
13594,semblance,109,34618657,99.7383768376,_100,9,>100
13595,storyteller,109,34618766,99.7386908729,_100,11,>100
13596,getaway,109,34618875,99.7390049083,_100,7,>100
13597,unprepared,109,34618984,99.7393189437,_100,10,>100
13598,aesthetics,109,34619093,99.7396329791,_100,10,>100
13599,advert,109,34619202,99.7399470145,_100,6,>100
13600,yrs,109,34619311,99.7402610498,_100,3,>100
13601,toothpaste,109,34619420,99.7405750852,_100,10,>100
13602,inning,109,34619529,99.7408891206,_100,6,>100
13603,exhibitions,109,34619638,99.741203156,_100,11,>100
13604,incompetent,109,34619747,99.7415171913,_100,11,>100
13605,fondant,109,34619856,99.7418312267,_100,7,>100
13606,cork,109,34619965,99.7421452621,_100,4,>100
13607,sensational,109,34620074,99.7424592975,_100,11,>100
13608,gingerbread,109,34620183,99.7427733329,_100,11,>100
13609,jacques,109,34620292,99.7430873682,_100,7,>100
13610,immersion,109,34620401,99.7434014036,_100,9,>100
13611,orgasm,109,34620510,99.743715439,_100,6,>100
13612,hendrix,109,34620619,99.7440294744,_100,7,>100
13613,reel,109,34620728,99.7443435098,_100,4,>100
13614,puke,109,34620837,99.7446575451,_100,4,>100
13615,strains,109,34620946,99.7449715805,_100,7,>100
13616,expenditure,109,34621055,99.7452856159,_100,11,>100
13617,heaps,109,34621164,99.7455996513,_100,5,>100
13618,emulate,109,34621273,99.7459136867,_100,7,>100
13619,canopy,109,34621382,99.746227722,_100,6,>100
13620,presenter,109,34621491,99.7465417574,_100,9,>100
13621,continental,109,34621600,99.7468557928,_100,11,>100
13622,wesley,109,34621709,99.7471698282,_100,6,>100
13623,patty,109,34621818,99.7474838636,_100,5,>100
13624,upgrades,109,34621927,99.7477978989,_100,8,>100
13625,tentative,109,34622036,99.7481119343,_100,9,>100
13626,churning,109,34622145,99.7484259697,_100,8,>100
13627,obligatory,109,34622254,99.7487400051,_100,10,>100
13628,blindness,108,34622362,99.7490511594,_100,9,>100
13629,partnerships,108,34622470,99.7493623137,_100,12,>100
13630,eyeshadow,108,34622578,99.749673468,_100,9,>100
13631,amaze,108,34622686,99.7499846224,_100,5,>100
13632,famine,108,34622794,99.7502957767,_100,6,>100
13633,rotting,108,34622902,99.750606931,_100,7,>100
13634,nuggets,108,34623010,99.7509180853,_100,7,>100
13635,citadel,108,34623118,99.7512292396,_100,7,>100
13636,builders,108,34623226,99.751540394,_100,8,>100
13637,fanatic,108,34623334,99.7518515483,_100,7,>100
13638,bolton,108,34623442,99.7521627026,_100,6,>100
13639,adviser,108,34623550,99.7524738569,_100,7,>100
13640,predicament,108,34623658,99.7527850112,_100,11,>100
13641,pensions,108,34623766,99.7530961656,_100,8,>100
13642,wr,108,34623874,99.7534073199,_100,2,>100
13643,prosper,108,34623982,99.7537184742,_100,7,>100
13644,proceeding,108,34624090,99.7540296285,_100,10,>100
13645,whisking,108,34624198,99.7543407828,_100,8,>100
13646,converting,108,34624306,99.7546519372,_100,10,>100
13647,kilometres,108,34624414,99.7549630915,_100,10,>100
13648,controller,108,34624522,99.7552742458,_100,10,>100
13649,indefinitely,108,34624630,99.7555854001,_100,12,>100
13650,advancing,108,34624738,99.7558965544,_100,9,>100
13651,vantage,108,34624846,99.7562077088,_100,7,>100
13652,cartridges,108,34624954,99.7565188631,_100,10,>100
13653,ganache,108,34625062,99.7568300174,_100,7,>100
13654,cellphone,108,34625170,99.7571411717,_100,9,>100
13655,seventy,108,34625278,99.757452326,_100,7,>100
13656,nottingham,108,34625386,99.7577634804,_100,10,>100
13657,restriction,108,34625494,99.7580746347,_100,11,>100
13658,nineteenth,108,34625602,99.758385789,_100,10,>100
13659,signatures,108,34625710,99.7586969433,_100,10,>100
13660,souvenir,108,34625818,99.7590080976,_100,8,>100
13661,paypal,108,34625926,99.759319252,_100,6,>100
13662,blu,108,34626034,99.7596304063,_100,3,>100
13663,spur,108,34626142,99.7599415606,_100,4,>100
13664,disrespect,108,34626250,99.7602527149,_100,10,>100
13665,mimi,108,34626358,99.7605638693,_100,4,>100
13666,marlene,108,34626466,99.7608750236,_100,7,>100
13667,dammit,108,34626574,99.7611861779,_100,6,>100
13668,superstar,108,34626682,99.7614973322,_100,9,>100
13669,truman,108,34626790,99.7618084865,_100,6,>100
13670,sensibility,108,34626898,99.7621196409,_100,11,>100
13671,brock,108,34627006,99.7624307952,_100,5,>100
13672,scallop,108,34627114,99.7627419495,_100,7,>100
13673,defenders,108,34627222,99.7630531038,_100,9,>100
13674,hipster,108,34627330,99.7633642581,_100,7,>100
13675,simmons,108,34627438,99.7636754125,_100,7,>100
13676,grit,108,34627546,99.7639865668,_100,4,>100
13677,tanner,108,34627654,99.7642977211,_100,6,>100
13678,trout,108,34627762,99.7646088754,_100,5,>100
13679,boyd,108,34627870,99.7649200297,_100,4,>100
13680,gracefully,108,34627978,99.7652311841,_100,10,>100
13681,shu,108,34628086,99.7655423384,_100,3,>100
13682,jug,108,34628194,99.7658534927,_100,3,>100
13683,papertrey,108,34628302,99.766164647,_100,9,>100
13684,protestors,108,34628410,99.7664758013,_100,10,>100
13685,pamela,108,34628518,99.7667869557,_100,6,>100
13686,halved,108,34628626,99.76709811,_100,6,>100
13687,dismal,108,34628734,99.7674092643,_100,6,>100
13688,slated,108,34628842,99.7677204186,_100,6,>100
13689,corrupted,108,34628950,99.7680315729,_100,9,>100
13690,groundbreaking,108,34629058,99.7683427273,_100,14,>100
13691,feasible,108,34629166,99.7686538816,_100,8,>100
13692,bottling,108,34629274,99.7689650359,_100,8,>100
13693,clutching,108,34629382,99.7692761902,_100,9,>100
13694,jenna,108,34629490,99.7695873445,_100,5,>100
13695,attained,108,34629598,99.7698984989,_100,8,>100
13696,manuel,108,34629706,99.7702096532,_100,6,>100
13697,beethoven,108,34629814,99.7705208075,_100,9,>100
13698,muttering,108,34629922,99.7708319618,_100,9,>100
13699,crippled,108,34630030,99.7711431162,_100,8,>100
13700,bach,108,34630138,99.7714542705,_100,4,>100
13701,newport,108,34630246,99.7717654248,_100,7,>100
13702,translations,108,34630354,99.7720765791,_100,12,>100
13703,onslaught,108,34630462,99.7723877334,_100,9,>100
13704,uprising,108,34630570,99.7726988878,_100,8,>100
13705,turmeric,108,34630678,99.7730100421,_100,8,>100
13706,patterson,108,34630786,99.7733211964,_100,9,>100
13707,upgraded,108,34630894,99.7736323507,_100,8,>100
13708,diversion,108,34631002,99.773943505,_100,9,>100
13709,claw,108,34631110,99.7742546594,_100,4,>100
13710,originals,108,34631218,99.7745658137,_100,9,>100
13711,bombers,108,34631326,99.774876968,_100,7,>100
13712,haired,108,34631434,99.7751881223,_100,6,>100
13713,provoke,108,34631542,99.7754992766,_100,7,>100
13714,displaced,108,34631650,99.775810431,_100,9,>100
13715,revolve,108,34631758,99.7761215853,_100,7,>100
13716,abusing,107,34631865,99.7764298585,_100,7,>100
13717,prized,107,34631972,99.7767381318,_100,6,>100
13718,breakup,107,34632079,99.7770464051,_100,7,>100
13719,brits,107,34632186,99.7773546783,_100,5,>100
13720,itch,107,34632293,99.7776629516,_100,4,>100
13721,lovecraft,107,34632400,99.7779712249,_100,9,>100
13722,faucet,107,34632507,99.7782794981,_100,6,>100
13723,bulls,107,34632614,99.7785877714,_100,5,>100
13724,devastation,107,34632721,99.7788960446,_100,11,>100
13725,stormy,107,34632828,99.7792043179,_100,6,>100
13726,sparkles,107,34632935,99.7795125912,_100,8,>100
13727,tucker,107,34633042,99.7798208644,_100,6,>100
13728,peterson,107,34633149,99.7801291377,_100,8,>100
13729,gorilla,107,34633256,99.7804374109,_100,7,>100
13730,marinated,107,34633363,99.7807456842,_100,9,>100
13731,skewed,107,34633470,99.7810539575,_100,6,>100
13732,regretted,107,34633577,99.7813622307,_100,9,>100
13733,deceived,107,34633684,99.781670504,_100,8,>100
13734,rust,107,34633791,99.7819787773,_100,4,>100
13735,ghee,107,34633898,99.7822870505,_100,4,>100
13736,cloths,107,34634005,99.7825953238,_100,6,>100
13737,peppermint,107,34634112,99.782903597,_100,10,>100
13738,trailing,107,34634219,99.7832118703,_100,8,>100
13739,warranty,107,34634326,99.7835201436,_100,8,>100
13740,spikes,107,34634433,99.7838284168,_100,6,>100
13741,freeman,107,34634540,99.7841366901,_100,7,>100
13742,initials,107,34634647,99.7844449634,_100,8,>100
13743,funnier,107,34634754,99.7847532366,_100,7,>100
13744,textbooks,107,34634861,99.7850615099,_100,9,>100
13745,kathryn,107,34634968,99.7853697831,_100,7,>100
13746,dialog,107,34635075,99.7856780564,_100,6,>100
13747,orderly,107,34635182,99.7859863297,_100,7,>100
13748,knack,107,34635289,99.7862946029,_100,5,>100
13749,riff,107,34635396,99.7866028762,_100,4,>100
13750,dine,107,34635503,99.7869111495,_100,4,>100
13751,leggings,107,34635610,99.7872194227,_100,8,>100
13752,pianist,107,34635717,99.787527696,_100,7,>100
13753,mockery,107,34635824,99.7878359692,_100,7,>100
13754,navigation,107,34635931,99.7881442425,_100,10,>100
13755,blinking,107,34636038,99.7884525158,_100,8,>100
13756,brightness,107,34636145,99.788760789,_100,10,>100
13757,offender,107,34636252,99.7890690623,_100,8,>100
13758,appetizers,107,34636359,99.7893773355,_100,10,>100
13759,bs,107,34636466,99.7896856088,_100,2,>100
13760,ceilings,107,34636573,99.7899938821,_100,8,>100
13761,dolphin,107,34636680,99.7903021553,_100,7,>100
13762,coined,107,34636787,99.7906104286,_100,6,>100
13763,wrongly,107,34636894,99.7909187019,_100,7,>100
13764,caption,107,34637001,99.7912269751,_100,7,>100
13765,highways,107,34637108,99.7915352484,_100,8,>100
13766,thatcher,107,34637215,99.7918435216,_100,8,>100
13767,delegation,107,34637322,99.7921517949,_100,10,>100
13768,severity,107,34637429,99.7924600682,_100,8,>100
13769,truthful,107,34637536,99.7927683414,_100,8,>100
13770,padded,107,34637643,99.7930766147,_100,6,>100
13771,renovated,107,34637750,99.793384888,_100,9,>100
13772,jasmine,107,34637857,99.7936931612,_100,7,>100
13773,resilient,107,34637964,99.7940014345,_100,9,>100
13774,originality,107,34638071,99.7943097077,_100,11,>100
13775,humming,107,34638178,99.794617981,_100,7,>100
13776,headband,107,34638285,99.7949262543,_100,8,>100
13777,inclination,107,34638392,99.7952345275,_100,11,>100
13778,menace,107,34638499,99.7955428008,_100,6,>100
13779,unchanged,107,34638606,99.7958510741,_100,9,>100
13780,gardner,107,34638713,99.7961593473,_100,7,>100
13781,kristin,107,34638820,99.7964676206,_100,7,>100
13782,acre,107,34638927,99.7967758938,_100,4,>100
13783,prague,107,34639034,99.7970841671,_100,6,>100
13784,swallowing,107,34639141,99.7973924404,_100,10,>100
13785,thermal,107,34639248,99.7977007136,_100,7,>100
13786,optimal,107,34639355,99.7980089869,_100,7,>100
13787,exposes,107,34639462,99.7983172601,_100,7,>100
13788,frown,107,34639569,99.7986255334,_100,5,>100
13789,roommates,107,34639676,99.7989338067,_100,9,>100
13790,enacted,107,34639783,99.7992420799,_100,7,>100
13791,interval,107,34639890,99.7995503532,_100,8,>100
13792,mtv,107,34639997,99.7998586265,_100,3,>100
13793,joss,107,34640104,99.8001668997,_100,4,>100
13794,collects,107,34640211,99.800475173,_100,8,>100
13795,riffs,107,34640318,99.8007834462,_100,5,>100
13796,effected,107,34640425,99.8010917195,_100,8,>100
13797,pitches,107,34640532,99.8013999928,_100,7,>100
13798,remorse,107,34640639,99.801708266,_100,7,>100
13799,receptionist,107,34640746,99.8020165393,_100,12,>100
13800,mugabe,106,34640852,99.8023219315,_100,6,>100
13801,tucson,106,34640958,99.8026273237,_100,6,>100
13802,mop,106,34641064,99.8029327159,_100,3,>100
13803,plump,106,34641170,99.8032381081,_100,5,>100
13804,bets,106,34641276,99.8035435003,_100,4,>100
13805,squat,106,34641382,99.8038488925,_100,5,>100
13806,drenched,106,34641488,99.8041542847,_100,8,>100
13807,strengthening,106,34641594,99.8044596769,_100,13,>100
13808,conceal,106,34641700,99.8047650691,_100,7,>100
13809,ecb,106,34641806,99.8050704613,_100,3,>100
13810,sift,106,34641912,99.8053758535,_100,4,>100
13811,tripped,106,34642018,99.8056812457,_100,7,>100
13812,hiked,106,34642124,99.8059866379,_100,5,>100
13813,flung,106,34642230,99.8062920301,_100,5,>100
13814,mysteriously,106,34642336,99.8065974223,_100,12,>100
13815,simone,106,34642442,99.8069028145,_100,6,>100
13816,foreground,106,34642548,99.8072082068,_100,10,>100
13817,sheltered,106,34642654,99.807513599,_100,9,>100
13818,textile,106,34642760,99.8078189912,_100,7,>100
13819,recreation,106,34642866,99.8081243834,_100,10,>100
13820,eloquent,106,34642972,99.8084297756,_100,8,>100
13821,marshmallow,106,34643078,99.8087351678,_100,11,>100
13822,broom,106,34643184,99.80904056,_100,5,>100
13823,adapting,106,34643290,99.8093459522,_100,8,>100
13824,manually,106,34643396,99.8096513444,_100,8,>100
13825,phoned,106,34643502,99.8099567366,_100,6,>100
13826,wednesdays,106,34643608,99.8102621288,_100,10,>100
13827,leafy,106,34643714,99.810567521,_100,5,>100
13828,salvage,106,34643820,99.8108729132,_100,7,>100
13829,morale,106,34643926,99.8111783054,_100,6,>100
13830,footprint,106,34644032,99.8114836976,_100,9,>100
13831,spinal,106,34644138,99.8117890898,_100,6,>100
13832,conflicted,106,34644244,99.812094482,_100,10,>100
13833,corpses,106,34644350,99.8123998742,_100,7,>100
13834,slicing,106,34644456,99.8127052664,_100,7,>100
13835,parable,106,34644562,99.8130106586,_100,7,>100
13836,disturb,106,34644668,99.8133160508,_100,7,>100
13837,revising,106,34644774,99.813621443,_100,8,>100
13838,sawyer,106,34644880,99.8139268352,_100,6,>100
13839,erica,106,34644986,99.8142322274,_100,5,>100
13840,inspector,106,34645092,99.8145376196,_100,9,>100
13841,majesty,106,34645198,99.8148430118,_100,7,>100
13842,wholeheartedly,106,34645304,99.815148404,_100,14,>100
13843,waxed,106,34645410,99.8154537962,_100,5,>100
13844,clara,106,34645516,99.8157591885,_100,5,>100
13845,overpowering,106,34645622,99.8160645807,_100,12,>100
13846,espn,106,34645728,99.8163699729,_100,4,>100
13847,overwhelm,106,34645834,99.8166753651,_100,9,>100
13848,strewn,106,34645940,99.8169807573,_100,6,>100
13849,misfortune,106,34646046,99.8172861495,_100,10,>100
13850,exempt,106,34646152,99.8175915417,_100,6,>100
13851,shreds,106,34646258,99.8178969339,_100,6,>100
13852,tantrum,106,34646364,99.8182023261,_100,7,>100
13853,bigotry,106,34646470,99.8185077183,_100,7,>100
13854,negatives,106,34646576,99.8188131105,_100,9,>100
13855,ceases,106,34646682,99.8191185027,_100,6,>100
13856,employing,106,34646788,99.8194238949,_100,9,>100
13857,accompaniment,106,34646894,99.8197292871,_100,13,>100
13858,sailors,106,34647000,99.8200346793,_100,7,>100
13859,finland,106,34647106,99.8203400715,_100,7,>100
13860,kosher,106,34647212,99.8206454637,_100,6,>100
13861,prairie,106,34647318,99.8209508559,_100,7,>100
13862,bashing,106,34647424,99.8212562481,_100,7,>100
13863,vinaigrette,106,34647530,99.8215616403,_100,11,>100
13864,rakeback,106,34647636,99.8218670325,_100,8,>100
13865,kuala,106,34647742,99.8221724247,_100,5,>100
13866,logos,106,34647848,99.8224778169,_100,5,>100
13867,cellular,106,34647954,99.8227832091,_100,8,>100
13868,planners,106,34648060,99.8230886013,_100,8,>100
13869,suv,106,34648166,99.8233939935,_100,3,>100
13870,shortening,106,34648272,99.8236993857,_100,10,>100
13871,colon,106,34648378,99.8240047779,_100,5,>100
13872,swarm,106,34648484,99.8243101702,_100,5,>100
13873,conveyed,106,34648590,99.8246155624,_100,8,>100
13874,manly,106,34648696,99.8249209546,_100,5,>100
13875,easel,106,34648802,99.8252263468,_100,5,>100
13876,interviewer,106,34648908,99.825531739,_100,11,>100
13877,scented,106,34649014,99.8258371312,_100,7,>100
13878,endeavour,106,34649120,99.8261425234,_100,9,>100
13879,nutella,106,34649226,99.8264479156,_100,7,>100
13880,preserves,105,34649331,99.8267504267,_100,9,>100
13881,yemen,105,34649436,99.8270529379,_100,5,>100
13882,allotment,105,34649541,99.827355449,_100,9,>100
13883,pillars,105,34649646,99.8276579602,_100,7,>100
13884,blissful,105,34649751,99.8279604713,_100,8,>100
13885,angie,105,34649856,99.8282629824,_100,5,>100
13886,lib,105,34649961,99.8285654936,_100,3,>100
13887,robes,105,34650066,99.8288680047,_100,5,>100
13888,escort,105,34650171,99.8291705159,_100,6,>100
13889,evocative,105,34650276,99.829473027,_100,9,>100
13890,perennial,105,34650381,99.8297755382,_100,9,>100
13891,porsche,105,34650486,99.8300780493,_100,7,>100
13892,trans,105,34650591,99.8303805605,_100,5,>100
13893,gov,105,34650696,99.8306830716,_100,3,>100
13894,peyton,105,34650801,99.8309855828,_100,6,>100
13895,esoteric,105,34650906,99.8312880939,_100,8,>100
13896,perfectionist,105,34651011,99.831590605,_100,13,>100
13897,pursuits,105,34651116,99.8318931162,_100,8,>100
13898,erased,105,34651221,99.8321956273,_100,6,>100
13899,aerial,105,34651326,99.8324981385,_100,6,>100
13900,accountant,105,34651431,99.8328006496,_100,10,>100
13901,deter,105,34651536,99.8331031608,_100,5,>100
13902,chronological,105,34651641,99.8334056719,_100,13,>100
13903,mca,105,34651746,99.8337081831,_100,3,>100
13904,coco,105,34651851,99.8340106942,_100,4,>100
13905,cosmos,105,34651956,99.8343132053,_100,6,>100
13906,marxism,105,34652061,99.8346157165,_100,7,>100
13907,pregnancies,105,34652166,99.8349182276,_100,11,>100
13908,snp,105,34652271,99.8352207388,_100,3,>100
13909,breadth,105,34652376,99.8355232499,_100,7,>100
13910,hotter,105,34652481,99.8358257611,_100,6,>100
13911,howling,105,34652586,99.8361282722,_100,7,>100
13912,dictated,105,34652691,99.8364307834,_100,8,>100
13913,leapt,105,34652796,99.8367332945,_100,5,>100
13914,screwing,105,34652901,99.8370358057,_100,8,>100
13915,exposition,105,34653006,99.8373383168,_100,10,>100
13916,soo,105,34653111,99.8376408279,_100,3,>100
13917,robertson,105,34653216,99.8379433391,_100,9,>100
13918,teas,105,34653321,99.8382458502,_100,4,>100
13919,ambient,105,34653426,99.8385483614,_100,7,>100
13920,reactors,105,34653531,99.8388508725,_100,8,>100
13921,plank,105,34653636,99.8391533837,_100,5,>100
13922,wilder,105,34653741,99.8394558948,_100,6,>100
13923,tweaked,105,34653846,99.839758406,_100,7,>100
13924,limitless,105,34653951,99.8400609171,_100,9,>100
13925,arcade,105,34654056,99.8403634282,_100,6,>100
13926,slumber,105,34654161,99.8406659394,_100,7,>100
13927,crosby,105,34654266,99.8409684505,_100,6,>100
13928,piecing,105,34654371,99.8412709617,_100,7,>100
13929,vibrations,105,34654476,99.8415734728,_100,10,>100
13930,populace,105,34654581,99.841875984,_100,8,>100
13931,hawk,105,34654686,99.8421784951,_100,4,>100
13932,jacqueline,105,34654791,99.8424810063,_100,10,>100
13933,undergraduate,105,34654896,99.8427835174,_100,13,>100
13934,gymnastics,105,34655001,99.8430860286,_100,10,>100
13935,bundled,105,34655106,99.8433885397,_100,7,>100
13936,fellows,105,34655211,99.8436910508,_100,7,>100
13937,sergeant,105,34655316,99.843993562,_100,8,>100
13938,tho,105,34655421,99.8442960731,_100,3,>100
13939,brien,105,34655526,99.8445985843,_100,5,>100
13940,solemn,105,34655631,99.8449010954,_100,6,>100
13941,jogging,105,34655736,99.8452036066,_100,7,>100
13942,spies,105,34655841,99.8455061177,_100,5,>100
13943,indulging,105,34655946,99.8458086289,_100,9,>100
13944,cynthia,105,34656051,99.84611114,_100,7,>100
13945,skepticism,105,34656156,99.8464136511,_100,10,>100
13946,nz,105,34656261,99.8467161623,_100,2,>100
13947,settles,105,34656366,99.8470186734,_100,7,>100
13948,disciplines,105,34656471,99.8473211846,_100,11,>100
13949,sensor,105,34656576,99.8476236957,_100,6,>100
13950,tempered,105,34656681,99.8479262069,_100,8,>100
13951,bronx,105,34656786,99.848228718,_100,5,>100
13952,cubs,105,34656891,99.8485312292,_100,4,>100
13953,reilly,105,34656996,99.8488337403,_100,6,>100
13954,rightful,105,34657101,99.8491362515,_100,8,>100
13955,racially,105,34657206,99.8494387626,_100,8,>100
13956,predator,105,34657311,99.8497412737,_100,8,>100
13957,showcased,105,34657416,99.8500437849,_100,9,>100
13958,nearer,105,34657521,99.850346296,_100,6,>100
13959,descending,105,34657626,99.8506488072,_100,10,>100
13960,tackles,105,34657731,99.8509513183,_100,7,>100
13961,lyric,105,34657836,99.8512538295,_100,5,>100
13962,grieve,104,34657940,99.8515534596,_100,6,>100
13963,uneventful,104,34658044,99.8518530896,_100,10,>100
13964,cf,104,34658148,99.8521527197,_100,2,>100
13965,prosperous,104,34658252,99.8524523498,_100,10,>100
13966,newcomers,104,34658356,99.8527519799,_100,9,>100
13967,thursdays,104,34658460,99.85305161,_100,9,>100
13968,flatten,104,34658564,99.8533512401,_100,7,>100
13969,neckline,104,34658668,99.8536508702,_100,8,>100
13970,accelerated,104,34658772,99.8539505002,_100,11,>100
13971,staging,104,34658876,99.8542501303,_100,7,>100
13972,marco,104,34658980,99.8545497604,_100,5,>100
13973,softness,104,34659084,99.8548493905,_100,8,>100
13974,bribe,104,34659188,99.8551490206,_100,5,>100
13975,picturesque,104,34659292,99.8554486507,_100,11,>100
13976,brittle,104,34659396,99.8557482808,_100,7,>100
13977,succeeds,104,34659500,99.8560479109,_100,8,>100
13978,romances,104,34659604,99.8563475409,_100,8,>100
13979,kidneys,104,34659708,99.856647171,_100,7,>100
13980,jubilee,104,34659812,99.8569468011,_100,7,>100
13981,daniels,104,34659916,99.8572464312,_100,7,>100
13982,kumar,104,34660020,99.8575460613,_100,5,>100
13983,contemporaries,104,34660124,99.8578456914,_100,14,>100
13984,strides,104,34660228,99.8581453215,_100,7,>100
13985,gays,104,34660332,99.8584449515,_100,4,>100
13986,clapping,104,34660436,99.8587445816,_100,8,>100
13987,unanswered,104,34660540,99.8590442117,_100,10,>100
13988,plunged,104,34660644,99.8593438418,_100,7,>100
13989,acclaim,104,34660748,99.8596434719,_100,7,>100
13990,meade,104,34660852,99.859943102,_100,5,>100
13991,bustle,104,34660956,99.8602427321,_100,6,>100
13992,backside,104,34661060,99.8605423621,_100,8,>100
13993,grooming,104,34661164,99.8608419922,_100,8,>100
13994,canoe,104,34661268,99.8611416223,_100,5,>100
13995,socrates,104,34661372,99.8614412524,_100,8,>100
13996,qualifying,104,34661476,99.8617408825,_100,10,>100
13997,mccarthy,104,34661580,99.8620405126,_100,8,>100
13998,introductory,104,34661684,99.8623401427,_100,12,>100
13999,labeling,104,34661788,99.8626397728,_100,8,>100
14000,existential,104,34661892,99.8629394028,_100,11,>100
14001,frail,104,34661996,99.8632390329,_100,5,>100
14002,propped,104,34662100,99.863538663,_100,7,>100
14003,vanish,104,34662204,99.8638382931,_100,6,>100
14004,shading,104,34662308,99.8641379232,_100,7,>100
14005,grading,104,34662412,99.8644375533,_100,7,>100
14006,compounds,104,34662516,99.8647371834,_100,9,>100
14007,unfairly,104,34662620,99.8650368134,_100,8,>100
14008,recollection,104,34662724,99.8653364435,_100,12,>100
14009,vegetation,104,34662828,99.8656360736,_100,10,>100
14010,fascist,104,34662932,99.8659357037,_100,7,>100
14011,tribune,104,34663036,99.8662353338,_100,7,>100
14012,pt,104,34663140,99.8665349639,_100,2,>100
14013,bloggy,104,34663244,99.866834594,_100,6,>100
14014,differentiate,104,34663348,99.8671342241,_100,13,>100
14015,refresh,104,34663452,99.8674338541,_100,7,>100
14016,epitome,104,34663556,99.8677334842,_100,7,>100
14017,metaphysical,104,34663660,99.8680331143,_100,12,>100
14018,bids,104,34663764,99.8683327444,_100,4,>100
14019,loyola,104,34663868,99.8686323745,_100,6,>100
14020,rushes,104,34663972,99.8689320046,_100,6,>100
14021,stevie,104,34664076,99.8692316347,_100,6,>100
14022,continents,104,34664180,99.8695312647,_100,10,>100
14023,lingerie,104,34664284,99.8698308948,_100,8,>100
14024,shareholders,104,34664388,99.8701305249,_100,12,>100
14025,forge,104,34664492,99.870430155,_100,5,>100
14026,brandy,104,34664596,99.8707297851,_100,6,>100
14027,payne,104,34664700,99.8710294152,_100,5,>100
14028,jonas,104,34664804,99.8713290453,_100,5,>100
14029,embraces,104,34664908,99.8716286753,_100,8,>100
14030,ufo,104,34665012,99.8719283054,_100,3,>100
14031,readable,104,34665116,99.8722279355,_100,8,>100
14032,sanded,103,34665219,99.8725246845,_100,6,>100
14033,strolling,103,34665322,99.8728214336,_100,9,>100
14034,undermining,103,34665425,99.8731181826,_100,11,>100
14035,intel,103,34665528,99.8734149316,_100,5,>100
14036,respite,103,34665631,99.8737116807,_100,7,>100
14037,benedict,103,34665734,99.8740084297,_100,8,>100
14038,contender,103,34665837,99.8743051787,_100,9,>100
14039,pier,103,34665940,99.8746019277,_100,4,>100
14040,adamant,103,34666043,99.8748986768,_100,7,>100
14041,spontaneously,103,34666146,99.8751954258,_100,13,>100
14042,activated,103,34666249,99.8754921748,_100,9,>100
14043,punctuation,103,34666352,99.8757889239,_100,11,>100
14044,datuk,103,34666455,99.8760856729,_100,5,>100
14045,rainbows,103,34666558,99.8763824219,_100,8,>100
14046,heartbreak,103,34666661,99.8766791709,_100,10,>100
14047,diva,103,34666764,99.87697592,_100,4,>100
14048,grasping,103,34666867,99.877272669,_100,8,>100
14049,narrated,103,34666970,99.877569418,_100,8,>100
14050,ollie,103,34667073,99.8778661671,_100,5,>100
14051,jailed,103,34667176,99.8781629161,_100,6,>100
14052,summoned,103,34667279,99.8784596651,_100,8,>100
14053,dawkins,103,34667382,99.8787564141,_100,7,>100
14054,leonardo,103,34667485,99.8790531632,_100,8,>100
14055,insulin,103,34667588,99.8793499122,_100,7,>100
14056,doubtful,103,34667691,99.8796466612,_100,8,>100
14057,minimalist,103,34667794,99.8799434102,_100,10,>100
14058,illuminated,103,34667897,99.8802401593,_100,11,>100
14059,notre,103,34668000,99.8805369083,_100,5,>100
14060,unlucky,103,34668103,99.8808336573,_100,7,>100
14061,illuminati,103,34668206,99.8811304064,_100,10,>100
14062,distortion,103,34668309,99.8814271554,_100,10,>100
14063,ornate,103,34668412,99.8817239044,_100,6,>100
14064,bolts,103,34668515,99.8820206534,_100,5,>100
14065,steadfast,103,34668618,99.8823174025,_100,9,>100
14066,loot,103,34668721,99.8826141515,_100,4,>100
14067,richards,103,34668824,99.8829109005,_100,8,>100
14068,peril,103,34668927,99.8832076496,_100,5,>100
14069,shrubs,103,34669030,99.8835043986,_100,6,>100
14070,baldwin,103,34669133,99.8838011476,_100,7,>100
14071,minions,103,34669236,99.8840978966,_100,7,>100
14072,bieber,103,34669339,99.8843946457,_100,6,>100
14073,breathless,103,34669442,99.8846913947,_100,10,>100
14074,apathy,103,34669545,99.8849881437,_100,6,>100
14075,spirited,103,34669648,99.8852848928,_100,8,>100
14076,plaintiff,103,34669751,99.8855816418,_100,9,>100
14077,scone,103,34669854,99.8858783908,_100,5,>100
14078,crockpot,103,34669957,99.8861751398,_100,8,>100
14079,parole,103,34670060,99.8864718889,_100,6,>100
14080,disclaimer,103,34670163,99.8867686379,_100,10,>100
14081,podcasts,103,34670266,99.8870653869,_100,8,>100
14082,betray,103,34670369,99.8873621359,_100,6,>100
14083,buff,103,34670472,99.887658885,_100,4,>100
14084,fiona,103,34670575,99.887955634,_100,5,>100
14085,unpacked,103,34670678,99.888252383,_100,8,>100
14086,hardback,103,34670781,99.8885491321,_100,8,>100
14087,crate,103,34670884,99.8888458811,_100,5,>100
14088,softball,103,34670987,99.8891426301,_100,8,>100
14089,eyeliner,103,34671090,99.8894393791,_100,8,>100
14090,revolutions,103,34671193,99.8897361282,_100,11,>100
14091,regiment,103,34671296,99.8900328772,_100,8,>100
14092,pitiful,103,34671399,99.8903296262,_100,7,>100
14093,inventions,103,34671502,99.8906263753,_100,10,>100
14094,commandment,103,34671605,99.8909231243,_100,11,>100
14095,adoration,103,34671708,99.8912198733,_100,9,>100
14096,sparrow,103,34671811,99.8915166223,_100,7,>100
14097,caster,103,34671914,99.8918133714,_100,6,>100
14098,bustling,103,34672017,99.8921101204,_100,8,>100
14099,scalp,103,34672120,99.8924068694,_100,5,>100
14100,lacrosse,103,34672223,99.8927036185,_100,8,>100
14101,mirrored,103,34672326,99.8930003675,_100,8,>100
14102,squarely,103,34672429,99.8932971165,_100,8,>100
14103,lenny,103,34672532,99.8935938655,_100,5,>100
14104,detection,103,34672635,99.8938906146,_100,9,>100
14105,ingrained,103,34672738,99.8941873636,_100,9,>100
14106,inhabited,103,34672841,99.8944841126,_100,9,>100
14107,fonts,103,34672944,99.8947808616,_100,5,>100
14108,gee,103,34673047,99.8950776107,_100,3,>100
14109,foreigner,103,34673150,99.8953743597,_100,9,>100
14110,ahhh,103,34673253,99.8956711087,_100,4,>100
14111,discharged,103,34673356,99.8959678578,_100,10,>100
14112,pinning,103,34673459,99.8962646068,_100,7,>100
14113,iq,103,34673562,99.8965613558,_100,2,>100
14114,falsely,103,34673665,99.8968581048,_100,7,>100
14115,implying,103,34673768,99.8971548539,_100,8,>100
14116,morocco,103,34673871,99.8974516029,_100,7,>100
14117,fairytale,103,34673974,99.8977483519,_100,9,>100
14118,103,103,34674077,99.898045101,_100,3,>100
14119,auntie,102,34674179,99.8983389689,_100,6,>100
14120,chuckled,102,34674281,99.8986328369,_100,8,>100
14121,grandmothers,102,34674383,99.8989267049,_100,12,>100
14122,converts,102,34674485,99.8992205728,_100,8,>100
14123,sh,102,34674587,99.8995144408,_100,2,>100
14124,pretzels,102,34674689,99.8998083088,_100,8,>100
14125,probation,102,34674791,99.9001021767,_100,9,>100
14126,mandy,102,34674893,99.9003960447,_100,5,>100
14127,imf,102,34674995,99.9006899127,_100,3,>100
14128,heartbroken,102,34675097,99.9009837806,_100,11,>100
14129,exchanging,102,34675199,99.9012776486,_100,10,>100
14130,reconnect,102,34675301,99.9015715166,_100,9,>100
14131,elaine,102,34675403,99.9018653846,_100,6,>100
14132,tunnels,102,34675505,99.9021592525,_100,7,>100
14133,gist,102,34675607,99.9024531205,_100,4,>100
14134,bf,102,34675709,99.9027469885,_100,2,>100
14135,shepard,102,34675811,99.9030408564,_100,7,>100
14136,repeal,102,34675913,99.9033347244,_100,6,>100
14137,aversion,102,34676015,99.9036285924,_100,8,>100
14138,shaker,102,34676117,99.9039224603,_100,6,>100
14139,han,102,34676219,99.9042163283,_100,3,>100
14140,lawsuits,102,34676321,99.9045101963,_100,8,>100
14141,dell,102,34676423,99.9048040643,_100,4,>100
14142,fingernails,102,34676525,99.9050979322,_100,11,>100
14143,realisation,102,34676627,99.9053918002,_100,11,>100
14144,sgt,102,34676729,99.9056856682,_100,3,>100
14145,booming,102,34676831,99.9059795361,_100,7,>100
14146,wrapper,102,34676933,99.9062734041,_100,7,>100
14147,macaroni,102,34677035,99.9065672721,_100,8,>100
14148,trajectory,102,34677137,99.90686114,_100,10,>100
14149,quieter,102,34677239,99.907155008,_100,7,>100
14150,ranting,102,34677341,99.907448876,_100,7,>100
14151,mouthful,102,34677443,99.9077427439,_100,8,>100
14152,phantom,102,34677545,99.9080366119,_100,7,>100
14153,reynolds,102,34677647,99.9083304799,_100,8,>100
14154,juggling,102,34677749,99.9086243479,_100,8,>100
14155,prudent,102,34677851,99.9089182158,_100,7,>100
14156,neal,102,34677953,99.9092120838,_100,4,>100
14157,debuted,102,34678055,99.9095059518,_100,7,>100
14158,transforms,102,34678157,99.9097998197,_100,10,>100
14159,multicultural,102,34678259,99.9100936877,_100,13,>100
14160,murderers,102,34678361,99.9103875557,_100,9,>100
14161,cuddly,102,34678463,99.9106814236,_100,6,>100
14162,hypocritical,102,34678565,99.9109752916,_100,12,>100
14163,proclaiming,102,34678667,99.9112691596,_100,11,>100
14164,ruffle,102,34678769,99.9115630275,_100,6,>100
14165,innovations,102,34678871,99.9118568955,_100,11,>100
14166,gripped,102,34678973,99.9121507635,_100,7,>100
14167,schmidt,102,34679075,99.9124446315,_100,7,>100
14168,lingered,102,34679177,99.9127384994,_100,8,>100
14169,unofficial,102,34679279,99.9130323674,_100,10,>100
14170,librarians,102,34679381,99.9133262354,_100,10,>100
14171,crease,102,34679483,99.9136201033,_100,6,>100
14172,seamless,102,34679585,99.9139139713,_100,8,>100
14173,tumble,102,34679687,99.9142078393,_100,6,>100
14174,junkie,102,34679789,99.9145017072,_100,6,>100
14175,untrue,102,34679891,99.9147955752,_100,6,>100
14176,swapped,102,34679993,99.9150894432,_100,7,>100
14177,sans,102,34680095,99.9153833112,_100,4,>100
14178,aptly,102,34680197,99.9156771791,_100,5,>100
14179,gratification,102,34680299,99.9159710471,_100,13,>100
14180,hysterically,102,34680401,99.9162649151,_100,12,>100
14181,dwarf,102,34680503,99.916558783,_100,5,>100
14182,comprising,102,34680605,99.916852651,_100,10,>100
14183,tinted,102,34680707,99.917146519,_100,6,>100
14184,peep,102,34680809,99.9174403869,_100,4,>100
14185,sheamus,102,34680911,99.9177342549,_100,7,>100
14186,basin,102,34681013,99.9180281229,_100,5,>100
14187,enchanted,102,34681115,99.9183219908,_100,9,>100
14188,honoring,102,34681217,99.9186158588,_100,8,>100
14189,professionalism,102,34681319,99.9189097268,_100,15,>100
14190,intently,102,34681421,99.9192035948,_100,8,>100
14191,carey,102,34681523,99.9194974627,_100,5,>100
14192,decency,102,34681625,99.9197913307,_100,7,>100
14193,edgy,102,34681727,99.9200851987,_100,4,>100
14194,appalled,102,34681829,99.9203790666,_100,8,>100
14195,queer,102,34681931,99.9206729346,_100,5,>100
14196,aftertaste,102,34682033,99.9209668026,_100,10,>100
14197,nuns,102,34682135,99.9212606705,_100,4,>100
14198,testified,102,34682237,99.9215545385,_100,9,>100
14199,investigative,102,34682339,99.9218484065,_100,13,>100
14200,patties,102,34682441,99.9221422744,_100,7,>100
14201,fencing,102,34682543,99.9224361424,_100,7,>100
14202,hitch,102,34682645,99.9227300104,_100,5,>100
14203,shelving,102,34682747,99.9230238784,_100,8,>100
14204,indulgence,102,34682849,99.9233177463,_100,10,>100
14205,apparel,102,34682951,99.9236116143,_100,7,>100
14206,seals,102,34683053,99.9239054823,_100,5,>100
14207,unjust,101,34683154,99.9241964692,_100,6,>100
14208,insider,101,34683255,99.9244874561,_100,7,>100
14209,elisabeth,101,34683356,99.924778443,_100,9,>100
14210,prepping,101,34683457,99.9250694299,_100,8,>100
14211,glances,101,34683558,99.9253604168,_100,7,>100
14212,distributing,101,34683659,99.9256514037,_100,12,>100
14213,hymns,101,34683760,99.9259423906,_100,5,>100
14214,binge,101,34683861,99.9262333776,_100,5,>100
14215,hippies,101,34683962,99.9265243645,_100,7,>100
14216,yankee,101,34684063,99.9268153514,_100,6,>100
14217,slopes,101,34684164,99.9271063383,_100,6,>100
14218,observes,101,34684265,99.9273973252,_100,8,>100
14219,radiant,101,34684366,99.9276883121,_100,7,>100
14220,excitedly,101,34684467,99.927979299,_100,9,>100
14221,weekday,101,34684568,99.9282702859,_100,7,>100
14222,contamination,101,34684669,99.9285612728,_100,13,>100
14223,irregular,101,34684770,99.9288522598,_100,9,>100
14224,perth,101,34684871,99.9291432467,_100,5,>100
14225,enterprises,101,34684972,99.9294342336,_100,11,>100
14226,procrastination,101,34685073,99.9297252205,_100,15,>100
14227,fruition,101,34685174,99.9300162074,_100,8,>100
14228,waterfalls,101,34685275,99.9303071943,_100,10,>100
14229,lanka,101,34685376,99.9305981812,_100,5,>100
14230,marines,101,34685477,99.9308891681,_100,7,>100
14231,registry,101,34685578,99.931180155,_100,8,>100
14232,brisbane,101,34685679,99.9314711419,_100,8,>100
14233,afrikaans,101,34685780,99.9317621289,_100,9,>100
14234,sacks,101,34685881,99.9320531158,_100,5,>100
14235,shortcomings,101,34685982,99.9323441027,_100,12,>100
14236,systematically,101,34686083,99.9326350896,_100,14,>100
14237,lumpur,101,34686184,99.9329260765,_100,6,>100
14238,conductor,101,34686285,99.9332170634,_100,9,>100
14239,tripping,101,34686386,99.9335080503,_100,8,>100
14240,merged,101,34686487,99.9337990372,_100,6,>100
14241,mardi,101,34686588,99.9340900241,_100,5,>100
14242,adobe,101,34686689,99.9343810111,_100,5,>100
14243,cliffs,101,34686790,99.934671998,_100,6,>100
14244,inexplicable,101,34686891,99.9349629849,_100,12,>100
14245,hardcover,101,34686992,99.9352539718,_100,9,>100
14246,unimaginable,101,34687093,99.9355449587,_100,12,>100
14247,labs,101,34687194,99.9358359456,_100,4,>100
14248,punishing,101,34687295,99.9361269325,_100,9,>100
14249,stoned,101,34687396,99.9364179194,_100,6,>100
14250,villa,101,34687497,99.9367089063,_100,5,>100
14251,demos,101,34687598,99.9369998933,_100,5,>100
14252,unstoppable,101,34687699,99.9372908802,_100,11,>100
14253,mccoy,101,34687800,99.9375818671,_100,5,>100
14254,treacherous,101,34687901,99.937872854,_100,11,>100
14255,aided,101,34688002,99.9381638409,_100,5,>100
14256,folklore,101,34688103,99.9384548278,_100,8,>100
14257,punctuated,101,34688204,99.9387458147,_100,10,>100
14258,convoluted,101,34688305,99.9390368016,_100,10,>100
14259,telly,101,34688406,99.9393277885,_100,5,>100
14260,psychologically,101,34688507,99.9396187755,_100,15,>100
14261,reconstruction,101,34688608,99.9399097624,_100,14,>100
14262,overt,101,34688709,99.9402007493,_100,5,>100
14263,cesare,101,34688810,99.9404917362,_100,6,>100
14264,chives,101,34688911,99.9407827231,_100,6,>100
14265,curling,101,34689012,99.94107371,_100,7,>100
14266,grinned,101,34689113,99.9413646969,_100,7,>100
14267,cardinals,101,34689214,99.9416556838,_100,9,>100
14268,zion,101,34689315,99.9419466707,_100,4,>100
14269,accusation,101,34689416,99.9422376577,_100,10,>100
14270,residue,101,34689517,99.9425286446,_100,7,>100
14271,deb,101,34689618,99.9428196315,_100,3,>100
14272,humane,101,34689719,99.9431106184,_100,6,>100
14273,rakyat,101,34689820,99.9434016053,_100,6,>100
14274,flagship,101,34689921,99.9436925922,_100,8,>100
14275,haste,101,34690022,99.9439835791,_100,5,>100
14276,aj,101,34690123,99.944274566,_100,2,>100
14277,lash,101,34690224,99.9445655529,_100,4,>100
14278,purge,101,34690325,99.9448565399,_100,5,>100
14279,bouncy,101,34690426,99.9451475268,_100,6,>100
14280,hives,101,34690527,99.9454385137,_100,5,>100
14281,fractured,101,34690628,99.9457295006,_100,9,>100
14282,wares,101,34690729,99.9460204875,_100,5,>100
14283,unravel,101,34690830,99.9463114744,_100,7,>100
14284,yorkers,101,34690931,99.9466024613,_100,7,>100
14285,castles,101,34691032,99.9468934482,_100,7,>100
14286,harmed,101,34691133,99.9471844351,_100,6,>100
14287,prevailing,101,34691234,99.947475422,_100,10,>100
14288,drumming,101,34691335,99.947766409,_100,8,>100
14289,inception,101,34691436,99.9480573959,_100,9,>100
14290,philippians,101,34691537,99.9483483828,_100,11,>100
14291,mould,101,34691638,99.9486393697,_100,5,>100
14292,barred,101,34691739,99.9489303566,_100,6,>100
14293,brace,101,34691840,99.9492213435,_100,5,>100
14294,pleases,101,34691941,99.9495123304,_100,7,>100
14295,gazed,101,34692042,99.9498033173,_100,5,>100
14296,lego,101,34692143,99.9500943042,_100,4,>100
14297,outlining,101,34692244,99.9503852912,_100,9,>100
14298,sq,101,34692345,99.9506762781,_100,2,>100
14299,offences,101,34692446,99.950967265,_100,8,>100
14300,formative,101,34692547,99.9512582519,_100,9,>100
14301,molds,101,34692648,99.9515492388,_100,5,>100
14302,responsive,101,34692749,99.9518402257,_100,10,>100
14303,owing,101,34692850,99.9521312126,_100,5,>100
14304,indicative,101,34692951,99.9524221995,_100,10,>100
14305,succeeding,101,34693052,99.9527131864,_100,10,>100
14306,101,101,34693153,99.9530041734,_100,3,>100
14307,radius,101,34693254,99.9532951603,_100,6,>100
14308,incorporates,101,34693355,99.9535861472,_100,12,>100
14309,rarity,101,34693456,99.9538771341,_100,6,>100
14310,blackberry,101,34693557,99.954168121,_100,10,>100
14311,mermaid,101,34693658,99.9544591079,_100,7,>100
14312,automated,101,34693759,99.9547500948,_100,9,>100
14313,penetrate,101,34693860,99.9550410817,_100,9,>100
14314,qb,101,34693961,99.9553320686,_100,2,>100
14315,jaded,101,34694062,99.9556230556,_100,5,>100
14316,israelites,101,34694163,99.9559140425,_100,10,>100
14317,usable,101,34694264,99.9562050294,_100,6,>100
14318,compression,101,34694365,99.9564960163,_100,11,>100
14319,selfless,101,34694466,99.9567870032,_100,8,>100
14320,placenta,100,34694566,99.9570751091,_100,8,>10
14321,hindi,100,34694666,99.9573632149,_100,5,>10
14322,rooftop,100,34694766,99.9576513208,_100,7,>10
14323,incorrectly,100,34694866,99.9579394266,_100,11,>10
14324,spear,100,34694966,99.9582275325,_100,5,>10
14325,mentors,100,34695066,99.9585156383,_100,7,>10
14326,mozart,100,34695166,99.9588037442,_100,6,>10
14327,deli,100,34695266,99.95909185,_100,4,>10
14328,atm,100,34695366,99.9593799559,_100,3,>10
14329,stillness,100,34695466,99.9596680617,_100,9,>10
14330,dogma,100,34695566,99.9599561676,_100,5,>10
14331,floss,100,34695666,99.9602442734,_100,5,>10
14332,acknowledgement,100,34695766,99.9605323793,_100,15,>10
14333,shawn,100,34695866,99.9608204851,_100,5,>10
14334,fc,100,34695966,99.961108591,_100,2,>10
14335,stationary,100,34696066,99.9613966968,_100,10,>10
14336,drilled,100,34696166,99.9616848027,_100,7,>10
14337,severed,100,34696266,99.9619729085,_100,7,>10
14338,recalling,100,34696366,99.9622610144,_100,9,>10
14339,chakra,100,34696466,99.9625491202,_100,6,>10
14340,adultery,100,34696566,99.9628372261,_100,8,>10
14341,ransom,100,34696666,99.963125332,_100,6,>10
14342,allie,100,34696766,99.9634134378,_100,5,>10
14343,defenses,100,34696866,99.9637015437,_100,8,>10
14344,babysitting,100,34696966,99.9639896495,_100,11,>10
14345,excursion,100,34697066,99.9642777554,_100,9,>10
14346,lifeless,100,34697166,99.9645658612,_100,8,>10
14347,vinci,100,34697266,99.9648539671,_100,5,>10
14348,rhythmic,100,34697366,99.9651420729,_100,8,>10
14349,angelic,100,34697466,99.9654301788,_100,7,>10
14350,fantastical,100,34697566,99.9657182846,_100,11,>10
14351,nephews,100,34697666,99.9660063905,_100,7,>10
14352,inflict,100,34697766,99.9662944963,_100,7,>10
14353,nerds,100,34697866,99.9665826022,_100,5,>10
14354,ouch,100,34697966,99.966870708,_100,4,>10
14355,unborn,100,34698066,99.9671588139,_100,6,>10
14356,distributor,100,34698166,99.9674469197,_100,11,>10
14357,masking,100,34698266,99.9677350256,_100,7,>10
14358,buckle,100,34698366,99.9680231314,_100,6,>10
14359,marge,100,34698466,99.9683112373,_100,5,>10
14360,deem,100,34698566,99.9685993431,_100,4,>10
14361,johns,100,34698666,99.968887449,_100,5,>10
14362,duh,100,34698766,99.9691755549,_100,3,>10
14363,100,100,34698866,99.9694636607,_100,3,>10
14364,seoul,100,34698966,99.9697517666,_100,5,>10
14365,waterfront,100,34699066,99.9700398724,_100,10,>10
14366,coordinator,100,34699166,99.9703279783,_100,11,>10
14367,lawful,100,34699266,99.9706160841,_100,6,>10
14368,cache,100,34699366,99.97090419,_100,5,>10
14369,romeo,100,34699466,99.9711922958,_100,5,>10
14370,sensibilities,100,34699566,99.9714804017,_100,13,>10
14371,attaching,100,34699666,99.9717685075,_100,9,>10
14372,thirds,100,34699766,99.9720566134,_100,6,>10
14373,inventor,100,34699866,99.9723447192,_100,8,>10
14374,zen,100,34699966,99.9726328251,_100,3,>10
14375,smiley,100,34700066,99.9729209309,_100,6,>10
14376,bert,100,34700166,99.9732090368,_100,4,>10
14377,idf,100,34700266,99.9734971426,_100,3,>10
14378,refrigerated,100,34700366,99.9737852485,_100,12,>10
14379,whomever,100,34700466,99.9740733543,_100,8,>10
14380,contrived,100,34700566,99.9743614602,_100,9,>10
14381,abiding,100,34700666,99.974649566,_100,7,>10
14382,bmw,100,34700766,99.9749376719,_100,3,>10
14383,characterization,100,34700866,99.9752257778,_100,16,>10
14384,100th,100,34700966,99.9755138836,_100,5,>10
14385,momentarily,100,34701066,99.9758019895,_100,11,>10
14386,pooh,100,34701166,99.9760900953,_100,4,>10
14387,bathed,100,34701266,99.9763782012,_100,6,>10
14388,customized,100,34701366,99.976666307,_100,10,>10
14389,invading,100,34701466,99.9769544129,_100,8,>10
14390,scarlet,100,34701566,99.9772425187,_100,7,>10
14391,unsalted,100,34701666,99.9775306246,_100,8,>10
14392,quarterly,100,34701766,99.9778187304,_100,9,>10
14393,fran,100,34701866,99.9781068363,_100,4,>10
14394,grayson,100,34701966,99.9783949421,_100,7,>10
14395,fondly,100,34702066,99.978683048,_100,6,>10
14396,reluctance,100,34702166,99.9789711538,_100,10,>10
14397,brennan,100,34702266,99.9792592597,_100,7,>10
14398,palpable,100,34702366,99.9795473655,_100,8,>10
14399,differs,100,34702466,99.9798354714,_100,7,>10
14400,swaying,100,34702566,99.9801235772,_100,7,>10
14401,flashy,100,34702666,99.9804116831,_100,6,>10
14402,grainy,100,34702766,99.9806997889,_100,6,>10
14403,nightclub,100,34702866,99.9809878948,_100,9,>10
14404,granite,100,34702966,99.9812760007,_100,7,>10
14405,reuse,100,34703066,99.9815641065,_100,5,>10
14406,constructing,100,34703166,99.9818522124,_100,12,>10
14407,ambiguity,100,34703266,99.9821403182,_100,9,>10
14408,crescent,100,34703366,99.9824284241,_100,8,>10
14409,99,99,34703465,99.9827136489,_100,2,>10
14410,98,98,34703563,99.9829959926,_100,2,>10
14411,97,97,34703660,99.9832754553,_100,2,>10
14412,96,96,34703756,99.9835520369,_100,2,>10
14413,95,95,34703851,99.9838257374,_100,2,>10
14414,94,94,34703945,99.9840965569,_100,2,>10
14415,93,93,34704038,99.9843644954,_100,2,>10
14416,92,92,34704130,99.9846295528,_100,2,>10
14417,91,91,34704221,99.9848917291,_100,2,>10
14418,90,90,34704311,99.9851510244,_100,2,>10
14419,90s,90,34704401,99.9854103196,_100,3,>10
14420,89,89,34704490,99.9856667338,_100,2,>10
14421,88,88,34704578,99.985920267,_100,2,>10
14422,87,87,34704665,99.9861709191,_100,2,>10
14423,86,86,34704751,99.9864186901,_100,2,>10
14424,85,85,34704836,99.9866635801,_100,2,>10
14425,84,84,34704920,99.986905589,_100,2,>10
14426,83,83,34705003,99.9871447169,_100,2,>10
14427,82,82,34705085,99.9873809637,_100,2,>10
14428,81,81,34705166,99.9876143294,_100,2,>10
14429,80,80,34705246,99.9878448141,_100,2,>10
14430,80s,80,34705326,99.9880752988,_100,3,>10
14431,79,79,34705405,99.9883029024,_100,2,>10
14432,78,78,34705483,99.988527625,_100,2,>10
14433,77,77,34705560,99.9887494665,_100,2,>10
14434,76,76,34705636,99.9889684269,_100,2,>10
14435,75,75,34705711,99.9891845063,_100,2,>10
14436,74,74,34705785,99.9893977046,_100,2,>10
14437,73,73,34705858,99.9896080219,_100,2,>10
14438,72,72,34705930,99.9898154581,_100,2,>10
14439,71,71,34706001,99.9900200133,_100,2,>10
14440,70s,70,34706071,99.9902216874,_100,3,>10
14441,70,70,34706141,99.9904233615,_100,2,>10
14442,69,69,34706210,99.9906221545,_100,2,>10
14443,68,68,34706278,99.9908180665,_100,2,>10
14444,67,67,34706345,99.9910110974,_100,2,>10
14445,66,66,34706411,99.9912012473,_100,2,>10
14446,65,65,34706476,99.9913885161,_100,2,>10
14447,64,64,34706540,99.9915729038,_100,2,>10
14448,63,63,34706603,99.9917544105,_100,2,>10
14449,62,62,34706665,99.9919330361,_100,2,>10
14450,61,61,34706726,99.9921087807,_100,2,>10
14451,60,60,34706786,99.9922816442,_100,2,>10
14452,60s,60,34706846,99.9924545077,_100,3,>10
14453,59,59,34706905,99.9926244902,_100,2,>10
14454,58,58,34706963,99.9927915916,_100,2,>10
14455,57,57,34707020,99.9929558119,_100,2,>10
14456,56,56,34707076,99.9931171512,_100,2,>10
14457,55,55,34707131,99.9932756094,_100,2,>10
14458,54,54,34707185,99.9934311866,_100,2,>10
14459,53,53,34707238,99.9935838827,_100,2,>10
14460,52,52,34707290,99.9937336977,_100,2,>10
14461,51,51,34707341,99.9938806317,_100,2,>10
14462,50s,50,34707391,99.9940246846,_100,3,>10
14463,50,50,34707441,99.9941687375,_100,2,>10
14464,49,49,34707490,99.9943099094,_100,2,>10
14465,48,48,34707538,99.9944482002,_100,2,>10
14466,47,47,34707585,99.99458361,_100,2,>10
14467,46,46,34707631,99.9947161387,_100,2,>10
14468,45,45,34707676,99.9948457863,_100,2,>10
14469,44,44,34707720,99.9949725529,_100,2,>10
14470,43,43,34707763,99.9950964384,_100,2,>10
14471,42,42,34707805,99.9952174429,_100,2,>10
14472,41,41,34707846,99.9953355662,_100,2,>10
14473,40,40,34707886,99.9954508086,_100,2,>10
14474,40s,40,34707926,99.9955660509,_100,3,>10
14475,39,39,34707965,99.9956784122,_100,2,>10
14476,38,38,34708003,99.9957878924,_100,2,>10
14477,37,37,34708040,99.9958944916,_100,2,>10
14478,36,36,34708076,99.9959982097,_100,2,>10
14479,35,35,34708111,99.9960990468,_100,2,>10
14480,34,34,34708145,99.9961970027,_100,2,>10
14481,33,33,34708178,99.9962920777,_100,2,>10
14482,32,32,34708210,99.9963842716,_100,2,>10
14483,31st,31,34708241,99.9964735844,_100,4,>10
14484,31,31,34708272,99.9965628972,_100,2,>10
14485,30pm,30,34708302,99.9966493289,_100,4,>10
14486,30am,30,34708332,99.9967357607,_100,4,>10
14487,30,30,34708362,99.9968221924,_100,2,>10
14488,30s,30,34708392,99.9969086242,_100,3,>10
14489,30th,30,34708422,99.996995056,_100,4,>10
14490,29,29,34708451,99.9970786067,_100,2,>10
14491,29th,29,34708480,99.9971621574,_100,4,>10
14492,28,28,34708508,99.997242827,_100,2,>10
14493,28th,28,34708536,99.9973234966,_100,4,>10
14494,27th,27,34708563,99.9974012852,_100,4,>10
14495,27,27,34708590,99.9974790738,_100,2,>10
14496,26,26,34708616,99.9975539813,_100,2,>10
14497,26th,26,34708642,99.9976288888,_100,4,>10
14498,25th,25,34708667,99.9977009153,_100,4,>10
14499,25,25,34708692,99.9977729418,_100,2,>10
14500,24,24,34708716,99.9978420872,_100,2,>10
14501,24th,24,34708740,99.9979112326,_100,4,>10
14502,23,23,34708763,99.9979774969,_100,2,>10
14503,23rd,23,34708786,99.9980437613,_100,4,>10
14504,22,22,34708808,99.9981071445,_100,2,>10
14505,22nd,22,34708830,99.9981705278,_100,4,>10
14506,21,21,34708851,99.9982310301,_100,2,>10
14507,21st,21,34708872,99.9982915323,_100,4,>10
14508,20,20,34708892,99.9983491535,_100,2,>10
14509,20s,20,34708912,99.9984067746,_100,3,>10
14510,20th,20,34708932,99.9984643958,_100,4,>10
14511,19,19,34708951,99.9985191359,_100,2,>10
14512,19th,19,34708970,99.998573876,_100,4,>10
14513,18th,18,34708988,99.9986257351,_100,4,>10
14514,18,18,34709006,99.9986775941,_100,2,>10
14515,17th,17,34709023,99.9987265721,_100,4,>10
14516,17,17,34709040,99.9987755501,_100,2,>10
14517,16th,16,34709056,99.9988216471,_100,4,>10
14518,16,16,34709072,99.998867744,_100,2,>10
14519,15th,15,34709087,99.9989109599,_100,4,>10
14520,15,15,34709102,99.9989541758,_100,2,>10
14521,14th,14,34709116,99.9989945106,_100,4,>10
14522,14,14,34709130,99.9990348454,_100,2,>10
14523,13th,13,34709143,99.9990722992,_100,4,>10
14524,13,13,34709156,99.9991097529,_100,2,>10
14525,12th,12,34709168,99.9991443256,_100,4,>10
14526,12,12,34709180,99.9991788983,_100,2,>10
14527,11th,11,34709191,99.99921059,_100,4,>10
14528,11,11,34709202,99.9992422816,_100,2,>10
14529,10pm,10,34709212,99.9992710922,_100,4,>=1
14530,10,10,34709222,99.9992999028,_100,2,>=1
14531,10th,10,34709232,99.9993287134,_100,4,>=1
14532,10am,10,34709242,99.9993575239,_100,4,>=1
14533,9th,9,34709251,99.9993834535,_100,3,>=1
14534,9pm,9,34709260,99.999409383,_100,3,>=1
14535,09,9,34709269,99.9994353125,_100,2,>=1
14536,9am,9,34709278,99.9994612421,_100,3,>=1
14537,9,9,34709287,99.9994871716,_100,1,>=1
14538,8am,8,34709295,99.9995102201,_100,3,>=1
14539,8pm,8,34709303,99.9995332685,_100,3,>=1
14540,8,8,34709311,99.999556317,_100,1,>=1
14541,8th,8,34709319,99.9995793655,_100,3,>=1
14542,08,8,34709327,99.9996024139,_100,2,>=1
14543,7pm,7,34709334,99.9996225813,_100,3,>=1
14544,07,7,34709341,99.9996427487,_100,2,>=1
14545,7th,7,34709348,99.9996629162,_100,3,>=1
14546,7,7,34709355,99.9996830836,_100,1,>=1
14547,7am,7,34709362,99.999703251,_100,3,>=1
14548,6am,6,34709368,99.9997205373,_100,3,>=1
14549,06,6,34709374,99.9997378237,_100,2,>=1
14550,6th,6,34709380,99.99975511,_100,3,>=1
14551,6pm,6,34709386,99.9997723964,_100,3,>=1
14552,6,6,34709392,99.9997896827,_100,1,>=1
14553,05,5,34709397,99.999804088,_100,2,>=1
14554,5pm,5,34709402,99.9998184933,_100,3,>=1
14555,5th,5,34709407,99.9998328986,_100,3,>=1
14556,5,5,34709412,99.9998473039,_100,1,>=1
14557,5k,5,34709417,99.9998617092,_100,2,>=1
14558,4th,4,34709421,99.9998732334,_100,3,>=1
14559,4,4,34709425,99.9998847577,_100,1,>=1
14560,04,4,34709429,99.9998962819,_100,2,>=1
14561,4pm,4,34709433,99.9999078061,_100,3,>=1
14562,mp3,3,34709436,99.9999164493,_100,3,>=1
14563,3d,3,34709439,99.9999250925,_100,2,>=1
14564,3rd,3,34709442,99.9999337357,_100,3,>=1
14565,03,3,34709445,99.9999423788,_100,2,>=1
14566,3,3,34709448,99.999951022,_100,1,>=1
14567,3am,3,34709451,99.9999596652,_100,3,>=1
14568,02,2,34709453,99.9999654273,_100,2,>=1
14569,co2,2,34709455,99.9999711894,_100,3,>=1
14570,2nd,2,34709457,99.9999769515,_100,3,>=1
14571,2,2,34709459,99.9999827136,_100,1,>=1
14572,2pm,2,34709461,99.9999884758,_100,3,>=1
14573,1,1,34709462,99.9999913568,_100,1,>=1
14574,1st,1,34709463,99.9999942379,_100,3,>=1
14575,f1,1,34709464,99.9999971189,_100,2,>=1
14576,01,1,34709465,100.0,_100,2,>=1
14577,00pm,0,34709465,100.0,_100,4,
14578,000,0,34709465,100.0,_100,3,
14579,00,0,34709465,100.0,_100,2,
14580,0,0,34709465,100.0,_100,1,
