,word,count,cum_freq,cum_perc,percentile,length,volume
0,the,1966998,1966998,6.33935902859,10,3,>1M
1,to,899907,2866905,9.23963323596,10,2,>100K
2,a,888024,3754929,12.1016101988,20,1,>100K
3,and,882571,4637500,14.9460129065,20,3,>100K
4,of,770019,5407519,17.4276762838,20,2,>100K
5,in,673173,6080692,19.5972185688,20,2,>100K
6,that,370734,6451426,20.7920423205,30,4,>100K
7,for,350543,6801969,21.9217933076,30,3,>100K
8,it,284799,7086768,22.8396605916,30,2,>100K
9,is,283730,7370498,23.7540826384,30,2,>100K
10,on,266462,7636960,24.61285234,30,2,>100K
11,with,254019,7890979,25.4315199955,30,4,>100K
12,he,253458,8144437,26.2483796266,30,2,>100K
13,said,250134,8394571,27.0545264713,30,4,>100K
14,was,228619,8623190,27.7913334847,30,3,>100K
15,at,212812,8836002,28.4771967513,30,2,>100K
16,i,192306,9028308,29.0969720522,30,1,>100K
17,as,186772,9215080,29.6989120463,30,2,>100K
18,his,157237,9372317,30.2056648725,40,3,>100K
19,be,151863,9524180,30.6950980494,40,2,>100K
20,from,151548,9675728,31.1835160254,40,4,>100K
21,but,150893,9826621,31.6698230282,40,3,>100K
22,have,143431,9970052,32.1320810503,40,4,>100K
23,are,138542,10108594,32.5785825101,40,3,>100K
24,by,132165,10240759,33.0045317923,40,2,>100K
25,they,129714,10370473,33.4225818447,40,4,>100K
26,we,124618,10495091,33.8242082029,40,2,>100K
27,an,122809,10617900,34.2200044076,40,2,>100K
28,this,121612,10739512,34.6119428489,40,4,>100K
29,has,120402,10859914,34.9999816297,40,3,>100K
30,you,113315,10973229,35.3651800022,40,3,>100K
31,also,112688,11085917,35.7283576415,40,4,>100K
32,not,111958,11197875,36.0891825931,40,3,>100K
33,who,111226,11309101,36.4476484112,40,3,>100K
34,will,107883,11416984,36.7953402086,40,4,>100K
35,or,97495,11514479,37.1095529371,40,2,>10K
36,s,89679,11604158,37.3985757924,40,1,>10K
37,about,89101,11693259,37.6857358347,40,5,>10K
38,more,87721,11780980,37.9684483302,40,4,>10K
39,their,86331,11867311,38.2466810505,40,5,>10K
40,one,85360,11952671,38.5217843738,40,3,>10K
41,had,83115,12035786,38.7896523765,40,3,>10K
42,she,81817,12117603,39.0533371071,40,3,>10K
43,when,78560,12196163,39.3065249829,40,4,>10K
44,were,73662,12269825,39.5439272907,40,4,>10K
45,would,72059,12341884,39.7761633541,40,5,>10K
46,up,71955,12413839,40.0080642401,50,2,>10K
47,out,71703,12485542,40.2391529654,50,3,>10K
48,new,70202,12555744,40.4654041779,50,3,>10K
49,can,69478,12625222,40.6893220398,50,3,>10K
50,there,69048,12694270,40.911854072,50,5,>10K
51,her,68564,12762834,41.13282624,50,3,>10K
52,all,68453,12831287,41.3534406705,50,3,>10K
53,been,66032,12897319,41.5662525571,50,4,>10K
54,if,64910,12962229,41.7754483949,50,2,>10K
55,make,63506,13025735,41.9801193373,50,4,>10K
56,after,62585,13088320,42.1818220258,50,5,>10K
57,two,60862,13149182,42.3779717266,50,3,>10K
58,what,60324,13209506,42.5723875288,50,4,>10K
59,which,59755,13269261,42.7649695237,50,5,>10K
60,year,59513,13328774,42.9567715864,50,4,>10K
61,than,58018,13386792,43.1437554736,50,4,>10K
62,its,57473,13444265,43.3289829021,50,3,>10K
63,so,56042,13500307,43.5095984181,50,2,>10K
64,first,55730,13556037,43.6892084018,50,5,>10K
65,state,54045,13610082,43.8633878665,50,5,>10K
66,no,53832,13663914,44.036880862,50,2,>10K
67,just,52950,13716864,44.2075312951,50,4,>10K
68,last,51680,13768544,44.3740886961,50,4,>10K
69,some,51397,13819941,44.5397340277,50,4,>10K
70,time,50592,13870533,44.7027849571,50,4,>10K
71,like,49205,13919738,44.8613657797,50,4,>10K
72,into,48363,13968101,45.0172329543,50,4,>10K
73,people,48335,14016436,45.1730098888,50,6,>10K
74,years,46482,14062918,45.3228148639,50,5,>10K
75,get,43556,14106474,45.4631897508,50,3,>10K
76,him,43227,14149701,45.6025043169,50,3,>10K
77,do,42687,14192388,45.7400785385,50,2,>10K
78,them,42400,14234788,45.8767277994,50,4,>10K
79,over,42318,14277106,46.0131127857,50,4,>10K
80,my,41861,14318967,46.1480249251,50,2,>10K
81,city,41708,14360675,46.2824439669,50,4,>10K
82,m,41124,14401799,46.4149808585,50,1,>10K
83,could,40475,14442274,46.545426114,50,5,>10K
84,our,39143,14481417,46.6715785201,50,3,>10K
85,because,38957,14520374,46.7971314742,50,7,>10K
86,three,36419,14556793,46.9145048098,50,5,>10K
87,now,35648,14592441,47.0293933205,50,3,>10K
88,school,35415,14627856,47.1435309047,50,6,>10K
89,most,34778,14662634,47.2556155272,50,4,>10K
90,only,34681,14697315,47.3673875323,50,4,>10K
91,before,33710,14731025,47.4760301404,50,6,>10K
92,how,33643,14764668,47.5844568169,50,3,>10K
93,back,33585,14798253,47.6926965675,50,4,>10K
94,game,31877,14830130,47.7954316734,50,4,>10K
95,says,31784,14861914,47.8978670533,50,4,>10K
96,where,31680,14893594,47.9999672557,50,5,>10K
97,your,31566,14925160,48.1017000522,50,4,>10K
98,county,31424,14956584,48.2029752025,50,6,>10K
99,going,31106,14987690,48.3032254833,50,5,>10K
100,those,30958,15018648,48.4029987809,50,5,>10K
101,don,30844,15049492,48.5024046725,50,3,>10K
102,many,30176,15079668,48.5996576936,50,4,>10K
103,team,30149,15109817,48.6968236975,50,4,>10K
104,even,30086,15139903,48.7937866612,50,4,>10K
105,million,29719,15169622,48.8895668354,50,7,>10K
106,good,29627,15199249,48.9850505064,50,4,>10K
107,then,29485,15228734,49.0800765313,50,4,>10K
108,through,29303,15258037,49.1745159957,50,7,>10K
109,home,29248,15287285,49.2687782028,50,4,>10K
110,while,28690,15315975,49.3612420541,50,5,>10K
111,off,28539,15344514,49.4532192535,50,3,>10K
112,day,28355,15372869,49.5446034467,50,3,>10K
113,may,28119,15400988,49.635227045,50,3,>10K
114,way,27878,15428866,49.725073934,50,3,>10K
115,season,27227,15456093,49.8128227412,50,6,>10K
116,me,27222,15483315,49.9005554341,50,2,>10K
117,police,26912,15510227,49.9872890405,50,6,>10K
118,much,26668,15536895,50.073236269,60,4,>10K
119,work,26397,15563292,50.1583101024,60,4,>10K
120,still,26243,15589535,50.2428876155,60,5,>10K
121,down,26238,15615773,50.3274490142,60,4,>10K
122,any,26020,15641793,50.4113078295,60,3,>10K
123,did,25335,15667128,50.4929589857,60,3,>10K
124,go,25056,15692184,50.573710964,60,2,>10K
125,p,25028,15717212,50.6543727022,60,1,>10K
126,u,24859,15742071,50.7344897771,60,1,>10K
127,think,24550,15766621,50.8136109883,60,5,>10K
128,take,24269,15790890,50.8918265758,60,4,>10K
129,well,24142,15815032,50.9696328602,60,4,>10K
130,high,23958,15838990,51.0468461383,60,4,>10K
131,since,23866,15862856,51.1237629133,60,5,>10K
132,say,23364,15886220,51.1990618126,60,3,>10K
133,know,23286,15909506,51.2741093288,60,4,>10K
134,during,23277,15932783,51.3491278393,60,6,>10K
135,against,23216,15955999,51.4239497554,60,7,>10K
136,week,22810,15978809,51.4974631903,60,4,>10K
137,right,22767,16001576,51.5708380422,60,5,>10K
138,being,22674,16024250,51.6439131682,60,5,>10K
139,four,22551,16046801,51.7165918824,60,4,>10K
140,public,22382,16069183,51.7887259332,60,6,>10K
141,another,21968,16091151,51.8595257201,60,7,>10K
142,company,21960,16113111,51.930299724,60,7,>10K
143,see,21940,16135051,52.0010092708,60,3,>10K
144,want,21769,16156820,52.0711677085,60,4,>10K
145,such,21572,16178392,52.1406912429,60,4,>10K
146,st,21527,16199919,52.2100697485,60,2,>10K
147,should,21000,16220919,52.2777498069,60,6,>10K
148,got,20872,16241791,52.3450173393,60,3,>10K
149,next,20804,16262595,52.4120657172,60,4,>10K
150,second,20724,16283319,52.4788562663,60,6,>10K
151,very,20697,16304016,52.5455597982,60,4,>10K
152,here,20435,16324451,52.6114189408,60,4,>10K
153,center,20238,16344689,52.67664318,60,6,>10K
154,long,20184,16364873,52.7416933847,60,4,>10K
155,president,20168,16385041,52.8066920237,60,9,>10K
156,big,20059,16405100,52.871339371,60,3,>10K
157,best,20027,16425127,52.9358835867,60,4,>10K
158,these,20009,16445136,53.0003697909,60,5,>10K
159,play,20009,16465145,53.0648559952,60,4,>10K
160,both,19989,16485134,53.1292777423,60,4,>10K
161,t,19943,16505077,53.1935512378,60,1,>10K
162,us,19804,16524881,53.2573767557,60,2,>10K
163,including,19753,16544634,53.3210379079,60,9,>10K
164,didn,19742,16564376,53.3846636085,60,4,>10K
165,family,19654,16584030,53.4480056975,60,6,>10K
166,part,19417,16603447,53.5105839687,60,4,>10K
167,house,19158,16622605,53.5723275191,60,5,>10K
168,around,19140,16641745,53.6340130581,60,6,>10K
169,really,18987,16660732,53.6952054995,60,6,>10K
170,too,18767,16679499,53.7556889118,60,3,>10K
171,told,18746,16698245,53.8161046439,60,4,>10K
172,lot,18316,16716561,53.8751345463,60,3,>10K
173,little,18251,16734812,53.9339549629,60,6,>10K
174,each,18158,16752970,53.9924756534,60,4,>10K
175,head,18019,16770989,54.0505483664,60,4,>10K
176,money,17876,16788865,54.1081602104,60,5,>10K
177,help,17817,16806682,54.1655819057,60,4,>10K
178,according,17775,16824457,54.2228682409,60,9,>10K
179,every,17605,16842062,54.2796066899,60,5,>10K
180,five,17415,16859477,54.3357327955,60,4,>10K
181,come,17216,16876693,54.391217552,60,4,>10K
182,left,17086,16893779,54.4462833367,60,4,>10K
183,need,17060,16910839,54.501265327,60,4,>10K
184,night,16979,16927818,54.5559862657,60,5,>10K
185,same,16979,16944797,54.6107072044,60,4,>10K
186,today,16949,16961746,54.6653314573,60,5,>10K
187,former,16875,16978621,54.7197172185,60,6,>10K
188,world,16872,16995493,54.7740933112,60,5,>10K
189,under,16855,17012348,54.8284146153,60,5,>10K
190,never,16814,17029162,54.8826037821,60,5,>10K
191,show,16808,17045970,54.9367736117,60,4,>10K
192,great,16672,17062642,54.9905051324,60,5,>10K
193,place,16538,17079180,55.0438047898,60,5,>10K
194,between,16537,17095717,55.0971012244,60,7,>10K
195,court,16486,17112203,55.1502332932,60,5,>10K
196,group,16321,17128524,55.20283359,60,5,>10K
197,end,16191,17144715,55.2550149151,60,3,>10K
198,won,16179,17160894,55.3071575658,60,3,>10K
199,officials,16118,17177012,55.3591036221,60,9,>10K
200,business,15981,17192993,55.4106081466,60,8,>10K
201,until,15907,17208900,55.4618741794,60,5,>10K
202,law,15858,17224758,55.5129822921,60,3,>10K
203,few,15843,17240601,55.5640420619,60,3,>10K
204,better,15666,17256267,55.6145313855,60,6,>10K
205,games,15605,17271872,55.6648241147,60,5,>10K
206,district,15453,17287325,55.7146269691,60,8,>10K
207,life,15363,17302688,55.7641397662,60,4,>10K
208,office,15051,17317739,55.8126470309,60,6,>10K
209,found,15018,17332757,55.8610479413,60,5,>10K
210,government,14944,17347701,55.90921036,60,10,>10K
211,children,14917,17362618,55.9572857615,60,8,>10K
212,health,14876,17377494,56.0052290258,60,6,>10K
213,put,14872,17392366,56.0531593986,60,3,>10K
214,came,14847,17407213,56.1010091999,60,4,>10K
215,run,14719,17421932,56.1484464752,60,3,>10K
216,man,14714,17436646,56.1958676361,60,3,>10K
217,board,14676,17451322,56.2431663284,60,5,>10K
218,federal,14667,17465989,56.2904360149,60,7,>10K
219,national,14643,17480632,56.3376283528,60,8,>10K
220,something,14544,17495176,56.3845016276,60,9,>10K
221,top,14503,17509679,56.4312427651,60,3,>10K
222,use,14499,17524178,56.4779710111,60,3,>10K
223,university,14465,17538643,56.52458968,60,10,>10K
224,program,14462,17553105,56.5711986802,60,7,>10K
225,called,14455,17567560,56.6177851205,60,6,>10K
226,days,14424,17581984,56.664271652,60,4,>10K
227,things,14421,17596405,56.710748515,60,6,>10K
228,might,14402,17610807,56.7571641437,60,5,>10K
229,took,14331,17625138,56.8033509493,60,4,>10K
230,students,14307,17639445,56.8494604062,60,8,>10K
231,department,14213,17653658,56.8952669144,60,10,>10K
232,several,14119,17667777,56.9407704737,60,7,>10K
233,coach,14098,17681875,56.9862063529,60,5,>10K
234,friday,13936,17695811,57.0311201288,60,6,>10K
235,case,13843,17709654,57.0757341788,60,4,>10K
236,ohio,13776,17723430,57.1201322971,60,4,>10K
237,without,13735,17737165,57.1643982782,60,7,>10K
238,set,13641,17750806,57.2083613104,60,3,>10K
239,job,13516,17764322,57.2519214852,60,3,>10K
240,times,13515,17777837,57.2954784371,60,5,>10K
241,later,13511,17791348,57.3390224976,60,5,>10K
242,tuesday,13475,17804823,57.3824505351,60,7,>10K
243,used,13433,17818256,57.4257432124,60,4,>10K
244,went,13419,17831675,57.4689907698,60,4,>10K
245,area,13297,17844972,57.5118451382,60,4,>10K
246,look,13137,17858109,57.5541838491,60,4,>10K
247,early,13126,17871235,57.5964871085,60,5,>10K
248,month,13087,17884322,57.6386646763,60,5,>10K
249,community,13058,17897380,57.6807487812,60,9,>10K
250,ago,12988,17910368,57.7226072859,60,3,>10K
251,though,12985,17923353,57.7644561221,60,6,>10K
252,director,12914,17936267,57.8060761352,60,8,>10K
253,six,12854,17949121,57.8475027767,60,3,>10K
254,pay,12834,17961955,57.8888649609,60,3,>10K
255,past,12815,17974770,57.9301659109,60,4,>10K
256,local,12755,17987525,57.9712734893,60,5,>10K
257,park,12704,18000229,58.0122167017,60,4,>10K
258,win,12665,18012894,58.0530342227,60,3,>10K
259,monday,12659,18025553,58.0938324065,60,6,>10K
260,york,12637,18038190,58.1345596874,60,4,>10K
261,bill,12625,18050815,58.175248294,60,4,>10K
262,cleveland,12608,18063423,58.2158821119,60,9,>10K
263,points,12606,18076029,58.2565094841,60,6,>10K
264,third,12580,18088609,58.297053062,60,5,>10K
265,thursday,12568,18101177,58.3375579656,60,8,>10K
266,start,12519,18113696,58.377904949,60,5,>10K
267,open,12462,18126158,58.4180682294,60,4,>10K
268,american,12438,18138596,58.4581541611,60,8,>10K
269,away,12425,18151021,58.4981981957,60,4,>10K
270,doesn,12405,18163426,58.5381777731,60,5,>10K
271,point,12392,18175818,58.5781154533,60,5,>10K
272,plan,12381,18188199,58.618017682,60,4,>10K
273,obama,12375,18200574,58.6579005736,60,5,>10K
274,among,12364,18212938,58.6977480137,60,5,>10K
275,country,12334,18225272,58.7374987681,60,7,>10K
276,keep,12294,18237566,58.777120608,60,4,>10K
277,members,12276,18249842,58.8166844364,60,7,>10K
278,tax,12253,18262095,58.8561741391,60,3,>10K
279,road,12130,18274225,58.89526743,60,4,>10K
280,saturday,12041,18286266,58.9340738864,60,8,>10K
281,least,12039,18298305,58.972873897,60,5,>10K
282,months,12021,18310326,59.0116158962,60,6,>10K
283,always,12002,18322328,59.050296661,60,6,>10K
284,san,11971,18334299,59.0888775172,60,3,>10K
285,call,11961,18346260,59.1274261448,60,4,>10K
286,hall,11937,18358197,59.1658974237,60,4,>10K
287,enough,11920,18370117,59.204313914,60,6,>10K
288,free,11901,18382018,59.24266917,60,4,>10K
289,april,11873,18393891,59.2809341859,60,5,>10K
290,does,11871,18405762,59.3191927561,60,4,>10K
291,wednesday,11842,18417604,59.3573578633,60,9,>10K
292,why,11809,18429413,59.3954166162,60,3,>10K
293,street,11794,18441207,59.4334270262,60,6,>10K
294,find,11636,18452843,59.4709282243,60,4,>10K
295,players,11617,18464460,59.508368188,60,7,>10K
296,jersey,11541,18476001,59.5455632144,60,6,>10K
297,asked,11483,18487484,59.582571315,60,5,>10K
298,small,11451,18498935,59.619476284,60,5,>10K
299,young,11449,18510384,59.6563748073,60,5,>10K
300,care,11432,18521816,59.6932185419,60,4,>10K
301,making,11394,18533210,59.7299398079,60,6,>10K
302,hit,11389,18544599,59.7666449596,60,3,>10K
303,committee,11346,18555945,59.8032115284,60,9,>10K
304,john,11282,18567227,59.839571834,60,4,>10K
305,less,11240,18578467,59.8757967796,60,4,>10K
306,food,11144,18589611,59.9117123306,60,4,>10K
307,give,11032,18600643,59.9472669213,60,4,>10K
308,college,10999,18611642,59.9827151576,60,7,>10K
309,report,10922,18622564,60.0179152338,70,6,>10K
310,service,10917,18633481,60.0530991956,70,7,>10K
311,again,10917,18644398,60.0882831574,70,5,>10K
312,along,10892,18655290,60.1233865477,70,5,>10K
313,system,10850,18666140,60.1583545779,70,6,>10K
314,once,10843,18676983,60.1933000481,70,4,>10K
315,already,10783,18687766,60.2280521466,70,7,>10K
316,washington,10776,18698542,60.2627816852,70,10,>10K
317,line,10724,18709266,60.2973436351,70,4,>10K
318,water,10713,18719979,60.3318701334,70,5,>10K
319,states,10608,18730587,60.3660582315,70,6,>10K
320,schools,10607,18741194,60.4002431068,70,7,>10K
321,information,10606,18751800,60.4344247591,70,11,>10K
322,thing,10569,18762369,60.4684871657,70,5,>10K
323,support,10550,18772919,60.5024883379,70,7,>10K
324,room,10469,18783388,60.5362284585,70,4,>10K
325,sunday,10469,18793857,60.569968579,70,6,>10K
326,far,10423,18804280,60.6035604481,70,3,>10K
327,old,10413,18814693,60.6371200885,70,3,>10K
328,news,10391,18825084,60.670608826,70,4,>10K
329,working,10367,18835451,60.7040202148,70,7,>10K
330,women,10324,18845775,60.7372930207,70,5,>10K
331,north,10288,18856063,60.7704498036,70,5,>10K
332,number,10225,18866288,60.8034035463,70,6,>10K
333,half,10218,18876506,60.8363347291,70,4,>10K
334,minutes,10173,18886679,60.8691208831,70,7,>10K
335,hard,10134,18896813,60.9017813456,70,4,>10K
336,market,10087,18906900,60.9342903337,70,6,>10K
337,louis,10081,18916981,60.9667799846,70,5,>10K
338,white,10046,18927027,60.9991568354,70,5,>10K
339,building,10023,18937050,61.0314595604,70,8,>10K
340,played,10007,18947057,61.0637107197,70,6,>10K
341,different,9919,18956976,61.0956782673,70,9,>1K
342,trying,9898,18966874,61.1275781349,70,6,>1K
343,started,9801,18976675,61.159165385,70,7,>1K
344,yet,9767,18986442,61.1906430579,70,3,>1K
345,field,9754,18996196,61.2220788336,70,5,>1K
346,nearly,9746,19005942,61.2534888264,70,6,>1K
347,lead,9725,19015667,61.2848311392,70,4,>1K
348,series,9703,19025370,61.3161025491,70,6,>1K
349,billion,9639,19035009,61.3471676959,70,7,>1K
350,west,9627,19044636,61.3781941684,70,4,>1K
351,south,9616,19054252,61.4091851895,70,5,>1K
352,late,9532,19063784,61.4399054903,70,4,>1K
353,march,9524,19073308,61.4706000082,70,5,>1K
354,others,9507,19082815,61.5012397375,70,6,>1K
355,oregon,9500,19092315,61.5318569068,70,6,>1K
356,lost,9450,19101765,61.5623129331,70,4,>1K
357,deal,9432,19111197,61.5927109479,70,4,>1K
358,let,9405,19120602,61.6230219455,70,3,>1K
359,doing,9380,19129982,61.6532523717,70,5,>1K
360,love,9347,19139329,61.6833764434,70,4,>1K
361,done,9311,19148640,61.7133844922,70,4,>1K
362,able,9293,19157933,61.7433345294,70,4,>1K
363,campaign,9284,19167217,61.773255561,70,8,>1K
364,car,9274,19176491,61.8031443639,70,3,>1K
365,feel,9195,19185686,61.832778561,70,4,>1K
366,companies,9148,19194834,61.8622612836,70,9,>1K
367,recent,9117,19203951,61.8916440975,70,6,>1K
368,general,9080,19213031,61.9209076656,70,7,>1K
369,real,9064,19222095,61.950119668,70,4,>1K
370,often,9054,19231149,61.9792994418,70,5,>1K
371,budget,9037,19240186,62.0084244269,70,6,>1K
372,wanted,9019,19249205,62.0374914006,70,6,>1K
373,sure,9016,19258221,62.0665487057,70,4,>1K
374,side,9014,19267235,62.0955995651,70,4,>1K
375,jobs,9011,19276246,62.1246407559,70,4,>1K
376,change,9010,19285256,62.1536787238,70,6,>1K
377,move,9008,19294264,62.182710246,70,4,>1K
378,com,8996,19303260,62.2117030939,70,3,>1K
379,become,8959,19312219,62.240576696,70,6,>1K
380,must,8909,19321128,62.2692891551,70,4,>1K
381,power,8880,19330008,62.2979081512,70,5,>1K
382,per,8859,19338867,62.3264594673,70,3,>1K
383,cost,8845,19347712,62.3549656633,70,4,>1K
384,together,8817,19356529,62.3833816193,70,8,>1K
385,expected,8817,19365346,62.4117975753,70,8,>1K
386,major,8808,19374154,62.4401845255,70,5,>1K
387,final,8801,19382955,62.4685489157,70,5,>1K
388,council,8760,19391715,62.4967811686,70,7,>1K
389,hours,8752,19400467,62.5249876387,70,5,>1K
390,looking,8741,19409208,62.5531586573,70,7,>1K
391,attorney,8733,19417941,62.5813038931,70,8,>1K
392,party,8697,19426638,62.6093331058,70,5,>1K
393,however,8689,19435327,62.6373365357,70,7,>1K
394,wasn,8682,19444009,62.6653174056,70,4,>1K
395,project,8675,19452684,62.6932757155,70,7,>1K
396,portland,8668,19461352,62.7212114653,70,8,>1K
397,kind,8665,19470017,62.7491375466,70,4,>1K
398,added,8664,19478681,62.777060405,70,5,>1K
399,shot,8636,19487317,62.8048930233,70,4,>1K
400,california,8626,19495943,62.832693413,70,10,>1K
401,kids,8616,19504559,62.8604615741,70,4,>1K
402,full,8611,19513170,62.888213621,70,4,>1K
403,services,8592,19521762,62.9159044334,70,8,>1K
404,playing,8558,19530320,62.9434856687,70,7,>1K
405,close,8532,19538852,62.9709831096,70,5,>1K
406,behind,8493,19547345,62.9983548589,70,6,>1K
407,having,8488,19555833,63.025710494,70,6,>1K
408,near,8454,19564287,63.0529565518,70,4,>1K
409,chief,8408,19572695,63.080054358,70,5,>1K
410,music,8384,19581079,63.1070748157,70,5,>1K
411,thought,8379,19589458,63.134079159,70,7,>1K
412,league,8365,19597823,63.1610383823,70,6,>1K
413,sales,8363,19606186,63.1879911598,70,5,>1K
414,story,8339,19614525,63.2148665887,70,5,>1K
415,coming,8336,19622861,63.2417323491,70,6,>1K
416,weeks,8312,19631173,63.2685207608,70,5,>1K
417,history,8304,19639477,63.2952833896,70,7,>1K
418,political,8302,19647779,63.3220395727,70,9,>1K
419,medical,8301,19656080,63.348792533,70,7,>1K
420,men,8301,19664381,63.3755454932,70,3,>1K
421,player,8282,19672663,63.4022372191,70,6,>1K
422,makes,8263,19680926,63.4288677107,70,5,>1K
423,fire,8228,19689154,63.4553854022,70,4,>1K
424,cut,8214,19697368,63.4818579736,70,3,>1K
425,across,8199,19705567,63.5082822021,70,6,>1K
426,plans,8162,19713729,63.5345871848,70,5,>1K
427,seven,8155,19721884,63.5608696075,70,5,>1K
428,large,8152,19730036,63.5871423617,70,5,>1K
429,executive,8096,19738132,63.6132346356,70,9,>1K
430,began,8089,19746221,63.6393043496,70,5,>1K
431,education,8073,19754294,63.6653224977,70,9,>1K
432,running,8068,19762362,63.6913245316,70,7,>1K
433,include,8066,19770428,63.7173201198,70,7,>1K
434,career,8027,19778455,63.7431900164,70,6,>1K
435,republican,8025,19786480,63.7690534673,70,10,>1K
436,taking,8017,19794497,63.7948911353,70,6,>1K
437,held,7956,19802453,63.8205322089,70,4,>1K
438,ever,7928,19810381,63.8460830424,70,4,>1K
439,name,7903,19818284,63.8715533044,70,4,>1K
440,outside,7899,19826183,63.897010675,70,7,>1K
441,mr,7868,19834051,63.9223681368,70,2,>1K
442,decision,7843,19841894,63.9476450272,70,8,>1K
443,financial,7838,19849732,63.9729058033,70,9,>1K
444,led,7832,19857564,63.9981472423,70,3,>1K
445,event,7813,19865377,64.0233274469,70,5,>1K
446,likely,7787,19873164,64.0484238571,70,6,>1K
447,morning,7738,19880902,64.0733623472,70,7,>1K
448,issue,7728,19888630,64.0982686087,70,5,>1K
449,teams,7704,19896334,64.1230975216,70,5,>1K
450,important,7671,19904005,64.1478200801,70,9,>1K
451,isn,7658,19911663,64.1725007414,70,3,>1K
452,saying,7633,19919296,64.1971008312,70,6,>1K
453,mother,7627,19926923,64.2216815839,70,6,>1K
454,conference,7624,19934547,64.246252668,70,10,>1K
455,believe,7604,19942151,64.2707592948,70,7,>1K
456,comes,7599,19949750,64.2952498074,70,5,>1K
457,try,7597,19957347,64.3197338743,70,3,>1K
458,live,7589,19964936,64.3441921583,70,4,>1K
459,east,7575,19972511,64.3686053222,70,4,>1K
460,almost,7549,19980060,64.3929346918,70,6,>1K
461,earlier,7534,19987594,64.4172157185,70,7,>1K
462,staff,7505,19995099,64.4414032822,70,5,>1K
463,employees,7473,20002572,64.4654877144,70,9,>1K
464,special,7463,20010035,64.4895399181,70,7,>1K
465,person,7462,20017497,64.5135888988,70,6,>1K
466,summer,7425,20024922,64.5375186338,70,6,>1K
467,workers,7413,20032335,64.5614096944,70,7,>1K
468,instead,7411,20039746,64.5852943093,70,7,>1K
469,course,7410,20047156,64.6091757014,70,6,>1K
470,whose,7385,20054541,64.6329765219,70,5,>1K
471,death,7348,20061889,64.6566580967,70,5,>1K
472,friends,7346,20069235,64.6803332257,70,7,>1K
473,future,7339,20076574,64.7039857947,70,6,>1K
474,known,7317,20083891,64.7275674607,70,5,>1K
475,seen,7313,20091204,64.7511362354,70,4,>1K
476,united,7307,20098511,64.7746856729,70,6,>1K
477,worked,7304,20105815,64.7982254418,70,6,>1K
478,meeting,7284,20113099,64.8217007535,70,7,>1K
479,black,7273,20120372,64.8451406137,70,5,>1K
480,available,7232,20127604,64.8684483367,70,9,>1K
481,eight,7226,20134830,64.8917367225,70,5,>1K
482,given,7223,20142053,64.9150154398,70,5,>1K
483,reported,7219,20149272,64.9382812656,70,8,>1K
484,manager,7216,20156488,64.9615374228,70,7,>1K
485,parents,7213,20163701,64.9847839114,70,7,>1K
486,anything,7205,20170906,65.0080046172,70,8,>1K
487,gave,7141,20178047,65.0310190599,70,4,>1K
488,couple,7132,20185179,65.0540044969,70,6,>1K
489,ball,7102,20192281,65.0768932481,70,4,>1K
490,defense,7094,20199375,65.0997562164,70,7,>1K
491,woman,7085,20206460,65.122590179,70,5,>1K
492,red,7084,20213544,65.1454209187,70,3,>1K
493,using,7083,20220627,65.1682484356,70,5,>1K
494,america,7040,20227667,65.1909373695,70,7,>1K
495,economy,7039,20234706,65.2136230805,70,7,>1K
496,someone,7038,20241744,65.2363055686,70,7,>1K
497,brown,7031,20248775,65.2589654968,70,5,>1K
498,front,7029,20255804,65.2816189792,70,5,>1K
499,senior,7015,20262819,65.3042273416,70,6,>1K
500,process,6998,20269817,65.3267809153,70,7,>1K
501,face,6988,20276805,65.3493022605,70,4,>1K
502,taken,6988,20283793,65.3718236057,70,5,>1K
503,list,6963,20290756,65.3942643793,70,4,>1K
504,wife,6959,20297715,65.4166922615,70,4,>1K
505,everything,6950,20304665,65.439091138,70,10,>1K
506,statement,6918,20311583,65.461386883,70,9,>1K
507,re,6891,20318474,65.4835956107,70,2,>1K
508,recently,6886,20325360,65.5057882242,70,8,>1K
509,continue,6884,20332244,65.5279743919,70,8,>1K
510,return,6872,20339116,65.5501218853,70,6,>1K
511,judge,6855,20345971,65.5722145901,70,5,>1K
512,race,6850,20352821,65.5942911806,70,4,>1K
513,goal,6834,20359655,65.6163162054,70,4,>1K
514,economic,6834,20366489,65.6383412301,70,8,>1K
515,romney,6803,20373292,65.6602663462,70,6,>1K
516,mayor,6775,20380067,65.6821012222,70,5,>1K
517,saw,6762,20386829,65.703894201,70,3,>1K
518,child,6751,20393580,65.7256517283,70,5,>1K
519,chance,6740,20400320,65.7473738042,70,6,>1K
520,agency,6736,20407056,65.7690829887,70,6,>1K
521,needs,6734,20413790,65.7907857274,70,5,>1K
522,david,6719,20420509,65.8124401233,70,5,>1K
523,bring,6716,20427225,65.8340848506,70,5,>1K
524,residents,6716,20433941,65.8557295778,70,9,>1K
525,vote,6707,20440648,65.8773452993,70,4,>1K
526,based,6686,20447334,65.8988933408,70,5,>1K
527,club,6684,20454018,65.9204349365,70,4,>1K
528,forward,6675,20460693,65.9419475266,70,7,>1K
529,bad,6670,20467363,65.9634440023,70,3,>1K
530,bank,6656,20474019,65.9848953579,70,4,>1K
531,fans,6639,20480658,66.006291925,70,4,>1K
532,probably,6636,20487294,66.0276788234,70,8,>1K
533,average,6626,20493920,66.0490334933,70,7,>1K
534,spring,6620,20500540,66.070368826,70,6,>1K
535,nothing,6612,20507152,66.0916783759,70,7,>1K
536,everyone,6579,20513731,66.1128815713,70,8,>1K
537,drive,6559,20520290,66.1340203096,70,5,>1K
538,hospital,6545,20526835,66.1551139278,70,8,>1K
539,although,6542,20533377,66.1761978774,70,8,>1K
540,within,6540,20539917,66.1972753813,70,6,>1K
541,quarter,6540,20546457,66.2183528852,70,7,>1K
542,officer,6523,20552980,66.2393756005,70,7,>1K
543,runs,6521,20559501,66.2603918701,70,4,>1K
544,needed,6517,20566018,66.2813952483,70,6,>1K
545,son,6514,20572532,66.3023889578,70,3,>1K
546,experience,6511,20579043,66.3233729988,70,10,>1K
547,town,6493,20585536,66.3442990283,70,4,>1K
548,pretty,6491,20592027,66.3652186121,70,6,>1K
549,football,6486,20598513,66.3861220815,70,8,>1K
550,problem,6482,20604995,66.4070126596,70,7,>1K
551,james,6471,20611466,66.4278677862,70,5,>1K
552,spent,6467,20617933,66.4487100213,70,5,>1K
553,received,6448,20624381,66.4694910221,70,8,>1K
554,property,6418,20630799,66.4901753371,70,8,>1K
555,fall,6417,20637216,66.5108564293,70,4,>1K
556,became,6376,20643592,66.5314053841,70,6,>1K
557,restaurant,6365,20649957,66.5519188876,70,10,>1K
558,himself,6341,20656298,66.5723550424,70,7,>1K
559,level,6327,20662625,66.5927460771,70,5,>1K
560,smith,6323,20668948,66.6131242204,70,5,>1K
561,development,6323,20675271,66.6335023637,70,11,>1K
562,film,6310,20681581,66.6538386099,70,4,>1K
563,strong,6303,20687884,66.674152296,70,6,>1K
564,costs,6298,20694182,66.6944498678,70,5,>1K
565,current,6296,20700478,66.7147409939,70,7,>1K
566,private,6296,20706774,66.73503212,70,7,>1K
567,security,6295,20713069,66.7553200232,70,8,>1K
568,green,6291,20719360,66.775595035,70,5,>1K
569,energy,6289,20725649,66.7958636011,70,6,>1K
570,union,6269,20731918,66.81606771,70,5,>1K
571,book,6267,20738185,66.8362653731,70,4,>1K
572,fact,6261,20744446,66.8564436991,70,4,>1K
573,loss,6257,20750703,66.8766091337,70,4,>1K
574,michael,6255,20756958,66.8967681225,70,7,>1K
575,increase,6247,20763205,66.9169013285,70,8,>1K
576,safety,6242,20769447,66.9370184201,70,6,>1K
577,officers,6235,20775682,66.9571129518,70,8,>1K
578,father,6220,20781902,66.9771591405,70,6,>1K
579,short,6217,20788119,66.9971956607,70,5,>1K
580,chicago,6197,20794316,67.0171677236,70,7,>1K
581,provide,6197,20800513,67.0371397866,70,7,>1K
582,voters,6196,20806709,67.0571086267,70,6,>1K
583,especially,6194,20812903,67.0770710211,70,10,>1K
584,share,6183,20819086,67.096997964,70,5,>1K
585,industry,6179,20825265,67.1169120155,70,8,>1K
586,issues,6175,20831440,67.1368131755,70,6,>1K
587,starting,6167,20837607,67.1566885527,70,8,>1K
588,senate,6157,20843764,67.1765317012,70,6,>1K
589,died,6156,20849920,67.1963716269,70,4,>1K
590,possible,6145,20856065,67.2161761012,70,8,>1K
591,control,6144,20862209,67.2359773526,70,7,>1K
592,e,6129,20868338,67.2557302611,70,1,>1K
593,guys,6124,20874462,67.2754670552,70,4,>1K
594,feet,6118,20880580,67.2951845123,70,4,>1K
595,stop,6102,20886682,67.3148504035,70,4,>1K
596,tell,6097,20892779,67.3345001805,70,4,>1K
597,turn,6086,20898865,67.354114506,70,4,>1K
598,talk,6070,20904935,67.3736772658,70,4,>1K
599,bit,6058,20910993,67.3932013512,70,3,>1K
600,space,6048,20917041,67.412693208,70,5,>1K
601,fourth,6048,20923089,67.4321850649,70,6,>1K
602,released,6046,20929135,67.451670476,70,8,>1K
603,price,6038,20935173,67.4711301042,70,5,>1K
604,clear,6036,20941209,67.4905832867,70,5,>1K
605,question,6033,20947242,67.5100268007,70,8,>1K
606,guy,6020,20953262,67.5294284174,70,3,>1K
607,turned,6009,20959271,67.5487945827,70,6,>1K
608,wrote,5996,20965267,67.5681188508,70,5,>1K
609,rate,5984,20971251,67.5874044446,70,4,>1K
610,nation,5941,20977192,67.6065514554,70,6,>1K
611,idea,5930,20983122,67.6256630148,70,4,>1K
612,announced,5898,20989020,67.6446714426,70,9,>1K
613,d,5893,20994913,67.6636637562,70,1,>1K
614,pick,5892,21000805,67.6826528469,70,4,>1K
615,higher,5890,21006695,67.7016354918,70,6,>1K
616,helped,5884,21012579,67.7205987996,70,6,>1K
617,wants,5874,21018453,67.7395298788,70,5,>1K
618,church,5867,21024320,67.758438398,70,6,>1K
619,mark,5865,21030185,67.7773404715,70,4,>1K
620,scored,5854,21036039,67.7962070935,70,6,>1K
621,paid,5847,21041886,67.8150511555,70,4,>1K
622,hope,5841,21047727,67.8338758803,70,4,>1K
623,add,5823,21053550,67.8526425937,70,3,>1K
624,arizona,5817,21059367,67.8713899699,70,7,>1K
625,offer,5810,21065177,67.890114786,70,5,>1K
626,member,5804,21070981,67.908820265,70,6,>1K
627,oil,5797,21076778,67.927503184,70,3,>1K
628,spokesman,5795,21082573,67.9461796573,70,9,>1K
629,inside,5791,21088364,67.9648432391,70,6,>1K
630,age,5774,21094138,67.9834520323,70,3,>1K
631,air,5750,21099888,68.0019834769,70,3,>1K
632,international,5741,21105629,68.0204859157,70,13,>1K
633,student,5737,21111366,68.0389754631,70,7,>1K
634,rose,5736,21117102,68.0574617877,70,4,>1K
635,knew,5728,21122830,68.0759223293,70,4,>1K
636,low,5724,21128554,68.0943699795,70,3,>1K
637,charges,5717,21134271,68.1127950697,70,7,>1K
638,los,5706,21139977,68.1311847085,70,3,>1K
639,am,5701,21145678,68.1495582329,70,2,>1K
640,annual,5694,21151372,68.1679091973,70,6,>1K
641,includes,5688,21157060,68.1862408246,70,8,>1K
642,order,5687,21162747,68.204569229,70,5,>1K
643,stay,5678,21168425,68.2228686277,70,4,>1K
644,meet,5666,21174091,68.241129352,70,4,>1K
645,art,5663,21179754,68.2593804078,70,3,>1K
646,position,5660,21185414,68.2776217949,70,8,>1K
647,prices,5655,21191069,68.2958470678,70,6,>1K
648,problems,5655,21196724,68.3140723407,70,8,>1K
649,store,5654,21202378,68.3322943907,70,5,>1K
650,spending,5649,21208027,68.3505003264,70,8,>1K
651,research,5648,21213675,68.3687030393,70,8,>1K
652,force,5623,21219298,68.3868251807,70,5,>1K
653,role,5609,21224907,68.404902202,70,4,>1K
654,sports,5608,21230515,68.4229760005,70,6,>1K
655,single,5585,21236100,68.4409756731,70,6,>1K
656,administration,5584,21241684,68.458972123,70,14,>1K
657,leave,5548,21247232,68.4768525498,70,5,>1K
658,paul,5538,21252770,68.4947007481,70,4,>1K
659,despite,5525,21258295,68.5125070492,70,7,>1K
660,investigation,5524,21263819,68.5303101274,70,13,>1K
661,anyone,5521,21269340,68.5481035371,70,6,>1K
662,christie,5515,21274855,68.5658776096,70,8,>1K
663,key,5509,21280364,68.5836323449,70,3,>1K
664,governor,5506,21285870,68.6013774117,70,8,>1K
665,means,5504,21291374,68.6191160327,70,5,>1K
666,whole,5487,21296861,68.6367998651,70,5,>1K
667,buy,5484,21302345,68.6544740289,70,3,>1K
668,river,5478,21307823,68.6721288556,70,5,>1K
669,star,5476,21313299,68.6897772366,70,4,>1K
670,either,5475,21318774,68.7074223947,70,6,>1K
671,matter,5475,21324249,68.7250675528,70,6,>1K
672,wine,5469,21329718,68.7426933737,70,4,>1K
673,actually,5463,21335181,68.7602998575,70,8,>1K
674,war,5453,21340634,68.7778741126,70,3,>1K
675,j,5452,21346086,68.795445145,70,1,>1K
676,leaders,5451,21351537,68.8130129544,70,7,>1K
677,works,5449,21356986,68.8305743182,70,5,>1K
678,middle,5447,21362433,68.8481292362,70,6,>1K
679,light,5442,21367875,68.8656680399,70,5,>1K
680,phone,5440,21373315,68.8832003979,70,5,>1K
681,round,5434,21378749,68.9007134187,70,5,>1K
682,dr,5429,21384178,68.9182103253,70,2,>1K
683,charged,5428,21389606,68.9357040089,70,7,>1K
684,interest,5416,21395022,68.9531590183,70,8,>1K
685,july,5404,21400426,68.9705753533,70,4,>1K
686,social,5374,21405800,68.9878950026,70,6,>1K
687,questions,5352,21411152,69.0051437489,70,9,>1K
688,moved,5344,21416496,69.0223667123,70,5,>1K
689,records,5339,21421835,69.0395735615,70,7,>1K
690,growth,5330,21427165,69.0567514049,70,6,>1K
691,lives,5327,21432492,69.0739195797,70,5,>1K
692,site,5319,21437811,69.0910619717,70,4,>1K
693,allowed,5313,21443124,69.1081850265,70,7,>1K
694,programs,5308,21448432,69.1252919669,70,8,>1K
695,media,5305,21453737,69.1423892388,70,5,>1K
696,johnson,5304,21459041,69.1594832879,70,7,>1K
697,lake,5303,21464344,69.1765741141,70,4,>1K
698,gets,5286,21469630,69.1936101516,70,4,>1K
699,valley,5272,21474902,69.2106010692,70,6,>1K
700,maybe,5271,21480173,69.2275887638,70,5,>1K
701,following,5265,21485438,69.2445571214,70,9,>1K
702,n,5250,21490688,69.261477136,70,1,>1K
703,hand,5243,21495931,69.2783745906,70,4,>1K
704,contract,5239,21501170,69.2952591537,70,8,>1K
705,c,5237,21506407,69.3121372711,70,1,>1K
706,central,5212,21511619,69.3289348171,70,7,>1K
707,chris,5212,21516831,69.345732363,70,5,>1K
708,gas,5201,21522032,69.3624944575,70,3,>1K
709,fell,5197,21527229,69.3792436605,70,4,>1K
710,soon,5196,21532425,69.3959896407,70,4,>1K
711,mike,5187,21537612,69.4127066151,70,4,>1K
712,takes,5176,21542788,69.4293881381,70,5,>1K
713,heart,5169,21547957,69.4460471011,70,5,>1K
714,tried,5160,21553117,69.4626770583,70,5,>1K
715,credit,5158,21558275,69.4793005698,70,6,>1K
716,training,5157,21563432,69.4959208584,70,8,>1K
717,press,5157,21568589,69.5125411471,70,5,>1K
718,shows,5140,21573729,69.5291066471,70,5,>1K
719,sometimes,5138,21578867,69.5456657014,70,9,>1K
720,angeles,5137,21584004,69.5622215328,70,7,>1K
721,involved,5114,21589118,69.5787032385,70,8,>1K
722,online,5105,21594223,69.5951559384,70,6,>1K
723,toward,5105,21599328,69.6116086383,70,6,>1K
724,rest,5096,21604424,69.6280323325,70,4,>1K
725,visit,5093,21609517,69.6444463581,70,5,>1K
726,reason,5090,21614607,69.6608507151,70,6,>1K
727,block,5085,21619692,69.6772389579,70,5,>1K
728,miles,5076,21624768,69.6935981948,70,5,>1K
729,avenue,5060,21629828,69.7099058661,70,6,>1K
730,included,5060,21634888,69.7262135373,70,8,>1K
731,served,5052,21639940,69.7424954256,70,6,>1K
732,changes,5049,21644989,69.7587676454,70,7,>1K
733,calls,5043,21650032,69.775020528,70,5,>1K
734,living,5036,21655068,69.7912508506,70,6,>1K
735,families,5035,21660103,69.8074779503,70,8,>1K
736,brought,5017,21665120,69.8236470386,70,7,>1K
737,performance,5016,21670136,69.839812904,70,11,>1K
738,nine,5013,21675149,69.8559691008,70,4,>1K
739,reports,5004,21680153,69.8720962918,70,7,>1K
740,policy,4998,21685151,69.8882041457,70,6,>1K
741,opportunity,4990,21690141,69.9042862168,70,11,>1K
742,body,4989,21695130,69.9203650649,70,4,>1K
743,study,4987,21700117,69.9364374674,70,5,>1K
744,felt,4976,21705093,69.9524744184,70,4,>1K
745,effort,4973,21710066,69.9685017008,70,6,>1K
746,legal,4972,21715038,69.9845257604,70,5,>1K
747,election,4971,21720009,70.000546597,80,8,>1K
748,create,4950,21724959,70.0164997537,80,6,>1K
749,francisco,4947,21729906,70.0324432417,80,9,>1K
750,weekend,4947,21734853,70.0483867298,80,7,>1K
751,couldn,4946,21739799,70.064326995,80,6,>1K
752,draft,4942,21744741,70.0802543687,80,5,>1K
753,republicans,4941,21749682,70.0961785196,80,11,>1K
754,homes,4931,21754613,70.1120704419,80,5,>1K
755,potential,4930,21759543,70.1279591414,80,9,>1K
756,authorities,4928,21764471,70.1438413951,80,11,>1K
757,personal,4928,21769399,70.1597236488,80,8,>1K
758,co,4924,21774323,70.1755930111,80,2,>1K
759,customers,4923,21779246,70.1914591505,80,9,>1K
760,comment,4915,21784161,70.207299507,80,7,>1K
761,rather,4901,21789062,70.2230947435,80,6,>1K
762,goes,4896,21793958,70.2388738657,80,4,>1K
763,action,4887,21798845,70.2546239822,80,6,>1K
764,else,4884,21803729,70.27036443,80,4,>1K
765,commission,4876,21808605,70.286079095,80,10,>1K
766,biggest,4849,21813454,70.3017067428,80,7,>1K
767,insurance,4846,21818300,70.317324722,80,9,>1K
768,fund,4831,21823131,70.3328943583,80,4,>1K
769,winning,4830,21827961,70.3484607718,80,7,>1K
770,total,4829,21832790,70.3640239624,80,5,>1K
771,events,4829,21837619,70.3795871529,80,6,>1K
772,sent,4828,21842447,70.3951471207,80,4,>1K
773,movie,4824,21847271,70.4106941969,80,5,>1K
774,hold,4820,21852091,70.4262283818,80,4,>1K
775,groups,4815,21856906,70.4417464523,80,6,>1K
776,practice,4809,21861715,70.4572451857,80,8,>1K
777,gov,4798,21866513,70.4727084676,80,3,>1K
778,showed,4796,21871309,70.4881653038,80,6,>1K
779,bar,4796,21876105,70.50362214,80,3,>1K
780,drug,4788,21880893,70.5190531934,80,4,>1K
781,rights,4787,21885680,70.5344810238,80,6,>1K
782,built,4785,21890465,70.5499024086,80,5,>1K
783,easy,4783,21895248,70.5653173476,80,4,>1K
784,main,4780,21900028,70.5807226181,80,4,>1K
785,ready,4775,21904803,70.5961117742,80,5,>1K
786,cases,4774,21909577,70.6114977075,80,5,>1K
787,seems,4764,21914341,70.6268514122,80,5,>1K
788,hotel,4762,21919103,70.6421986711,80,5,>1K
789,guard,4760,21923863,70.6575394844,80,5,>1K
790,democrats,4758,21928621,70.6728738519,80,9,>1K
791,missouri,4752,21933373,70.6881888823,80,8,>1K
792,similar,4752,21938125,70.7035039126,80,7,>1K
793,nfl,4732,21942857,70.7187544858,80,3,>1K
794,act,4726,21947583,70.7339857218,80,3,>1K
795,longer,4725,21952308,70.749213735,80,6,>1K
796,sign,4721,21957029,70.7644288567,80,4,>1K
797,sense,4720,21961749,70.7796407555,80,5,>1K
798,taxes,4719,21966468,70.7948494315,80,5,>1K
799,florida,4713,21971181,70.8100387704,80,7,>1K
800,named,4708,21975889,70.8252119949,80,5,>1K
801,period,4704,21980593,70.840372328,80,6,>1K
802,daughter,4687,21985280,70.8554778725,80,8,>1K
803,heard,4680,21989960,70.8705608569,80,5,>1K
804,opened,4658,21994618,70.8855729384,80,6,>1K
805,victory,4655,21999273,70.9005753514,80,7,>1K
806,allow,4652,22003925,70.9155680958,80,5,>1K
807,owner,4650,22008575,70.9305543944,80,5,>1K
808,friend,4650,22013225,70.9455406931,80,6,>1K
809,revenue,4643,22017868,70.9605044317,80,7,>1K
810,data,4639,22022507,70.9754552789,80,4,>1K
811,downtown,4632,22027139,70.9903835661,80,8,>1K
812,bowl,4628,22031767,71.0052989618,80,4,>1K
813,happened,4605,22036372,71.0201402318,80,8,>1K
814,businesses,4604,22040976,71.0349782789,80,10,>1K
815,focus,4592,22045568,71.0497776517,80,5,>1K
816,detroit,4590,22050158,71.0645705787,80,7,>1K
817,happy,4585,22054743,71.0793473915,80,5,>1K
818,bay,4582,22059325,71.0941145357,80,3,>1K
819,fun,4556,22063881,71.1087978855,80,3,>1K
820,sold,4530,22068411,71.123397441,80,4,>1K
821,yards,4528,22072939,71.1379905507,80,5,>1K
822,shooting,4524,22077463,71.152570769,80,8,>1K
823,opening,4524,22081987,71.1671509873,80,7,>1K
824,killed,4523,22086510,71.1817279828,80,6,>1K
825,themselves,4523,22091033,71.1963049782,80,10,>1K
826,benefits,4514,22095547,71.2108529679,80,8,>1K
827,finished,4503,22100050,71.2253655062,80,8,>1K
828,ways,4485,22104535,71.2398200329,80,4,>1K
829,firm,4480,22109015,71.2542584454,80,4,>1K
830,wouldn,4472,22113487,71.268671075,80,6,>1K
831,post,4471,22117958,71.2830804817,80,4,>1K
832,arrested,4470,22122428,71.2974866656,80,8,>1K
833,decided,4467,22126895,71.3118831809,80,7,>1K
834,organization,4446,22131341,71.3262120161,80,12,>1K
835,ask,4446,22135787,71.3405408513,80,3,>1K
836,difficult,4442,22140229,71.3548567951,80,9,>1K
837,democratic,4439,22144668,71.3691630703,80,10,>1K
838,base,4438,22149106,71.3834661227,80,4,>1K
839,plant,4435,22153541,71.3977595065,80,5,>1K
840,track,4433,22157974,71.4120464445,80,5,>1K
841,americans,4429,22162403,71.4263204911,80,9,>1K
842,hearing,4423,22166826,71.4405752006,80,7,>1K
843,cuts,4423,22171249,71.45482991,80,4,>1K
844,jones,4418,22175667,71.4690685052,80,5,>1K
845,stadium,4416,22180083,71.4833006546,80,7,>1K
846,example,4406,22184489,71.4975005754,80,7,>1K
847,lower,4406,22188895,71.5117004963,80,5,>1K
848,quickly,4403,22193298,71.5258907485,80,7,>1K
849,teachers,4401,22197699,71.5400745551,80,8,>1K
850,happen,4391,22202090,71.554226133,80,6,>1K
851,filed,4384,22206474,71.5683551509,80,5,>1K
852,williams,4378,22210852,71.5824648317,80,8,>1K
853,regular,4361,22215213,71.5965197238,80,7,>1K
854,construction,4360,22219573,71.6105713931,80,12,>1K
855,beat,4356,22223929,71.6246101709,80,4,>1K
856,met,4355,22228284,71.6386457259,80,3,>1K
857,afternoon,4351,22232635,71.6526683894,80,9,>1K
858,plays,4339,22236974,71.6666523787,80,5,>1K
859,ground,4339,22241313,71.6806363679,80,6,>1K
860,watch,4338,22245651,71.6946171342,80,5,>1K
861,attention,4329,22249980,71.7085688949,80,9,>1K
862,robert,4324,22254304,71.7225045412,80,6,>1K
863,tv,4318,22258622,71.7364208503,80,2,>1K
864,rates,4312,22262934,71.7503178223,80,5,>1K
865,true,4309,22267243,71.7642051258,80,4,>1K
866,overall,4309,22271552,71.7780924292,80,7,>1K
867,trial,4307,22275859,71.7919732869,80,5,>1K
868,o,4304,22280163,71.805844476,80,1,>1K
869,favorite,4296,22284459,71.8196898822,80,8,>1K
870,read,4294,22288753,71.8335288428,80,4,>1K
871,beach,4291,22293044,71.8473581347,80,5,>1K
872,basketball,4289,22297333,71.8611809809,80,10,>1K
873,tough,4285,22301618,71.8749909357,80,5,>1K
874,rock,4283,22305901,71.8887944448,80,4,>1K
875,build,4274,22310175,71.9025689481,80,5,>1K
876,raised,4269,22314444,71.9163273371,80,6,>1K
877,husband,4268,22318712,71.9300825033,80,7,>1K
878,band,4268,22322980,71.9438376694,80,4,>1K
879,signed,4265,22327245,71.957583167,80,6,>1K
880,ended,4246,22331491,71.9712674303,80,5,>1K
881,confidence,4246,22335737,71.9849516935,80,10,>1K
882,patients,4244,22339981,71.998629511,80,8,>1K
883,gone,4244,22344225,72.0123073286,80,4,>1K
884,worth,4230,22348455,72.0259400261,80,5,>1K
885,throughout,4228,22352683,72.0395662778,80,10,>1K
886,closed,4227,22356910,72.0531893067,80,6,>1K
887,joe,4226,22361136,72.0668091128,80,3,>1K
888,neighborhood,4211,22365347,72.0803805759,80,12,>1K
889,release,4209,22369556,72.0939455934,80,7,>1K
890,areas,4208,22373764,72.1075073879,80,5,>1K
891,january,4204,22377968,72.1210562911,80,7,>1K
892,region,4200,22382168,72.1345923027,80,6,>1K
893,cancer,4200,22386368,72.1481283144,80,6,>1K
894,step,4197,22390565,72.1616546575,80,4,>1K
895,scott,4190,22394755,72.1751584406,80,5,>1K
896,expect,4171,22398926,72.1886009894,80,6,>1K
897,land,4169,22403095,72.2020370924,80,4,>1K
898,looked,4166,22407261,72.2154635269,80,6,>1K
899,moving,4158,22411419,72.2288641784,80,6,>1K
900,leading,4156,22415575,72.2422583843,80,7,>1K
901,scheduled,4155,22419730,72.2556493673,80,9,>1K
902,offered,4153,22423883,72.2690339046,80,7,>1K
903,driving,4148,22428031,72.2824023275,80,7,>1K
904,video,4142,22432173,72.2957514133,80,5,>1K
905,details,4140,22436313,72.3090940534,80,7,>1K
906,evidence,4140,22440453,72.3224366935,80,8,>1K
907,trip,4140,22444593,72.3357793336,80,4,>1K
908,giving,4136,22448729,72.3491090823,80,6,>1K
909,stock,4130,22452859,72.3624194938,80,5,>1K
910,ahead,4125,22456984,72.375713791,80,5,>1K
911,wall,4115,22461099,72.3889758596,80,4,>1K
912,remains,4113,22465212,72.4022314824,80,7,>1K
913,addition,4103,22469315,72.4154548767,80,8,>1K
914,rules,4102,22473417,72.4286750481,80,5,>1K
915,largest,4101,22477518,72.4418919967,80,7,>1K
916,trade,4097,22481615,72.4550960538,80,5,>1K
917,numbers,4096,22485711,72.4682968881,80,7,>1K
918,technology,4096,22489807,72.4814977223,80,10,>1K
919,walk,4089,22493896,72.4946759965,80,4,>1K
920,prison,4083,22497979,72.5078349336,80,6,>1K
921,spot,4083,22502062,72.5209938707,80,4,>1K
922,kept,4077,22506139,72.5341334706,80,4,>1K
923,debt,4070,22510209,72.5472505105,80,4,>1K
924,baseball,4068,22514277,72.5603611047,80,8,>1K
925,human,4067,22518344,72.573468476,80,5,>1K
926,heat,4065,22522409,72.5865694016,80,4,>1K
927,results,4064,22526473,72.5996671044,80,7,>1K
928,official,4062,22530535,72.6127583614,80,8,>1K
929,military,4061,22534596,72.6258463955,80,8,>1K
930,cash,4060,22538656,72.6389312068,80,4,>1K
931,mean,4049,22542705,72.6519805667,80,4,>1K
932,amount,4046,22546751,72.6650202579,80,6,>1K
933,thomas,4045,22550796,72.6780567263,80,6,>1K
934,hot,4044,22554840,72.6910899719,80,3,>1K
935,result,4043,22558883,72.7041199946,80,6,>1K
936,inc,4041,22562924,72.7171435715,80,3,>1K
937,talking,4036,22566960,72.7301510342,80,7,>1K
938,newark,4033,22570993,72.7431488283,80,6,>1K
939,baltimore,4025,22575018,72.7561208395,80,9,>1K
940,mind,4022,22579040,72.7690831821,80,4,>1K
941,growing,4022,22583062,72.7820455247,80,7,>1K
942,previous,4016,22587078,72.7949885302,80,8,>1K
943,tour,4015,22591093,72.8079283128,80,4,>1K
944,division,4013,22595106,72.8208616496,80,8,>1K
945,additional,4012,22599118,72.8337917637,80,10,>1K
946,interview,4010,22603128,72.846715432,80,9,>1K
947,save,4007,22607135,72.8596294317,80,4,>1K
948,museum,4006,22611141,72.8725402086,80,6,>1K
949,congress,4002,22615143,72.885438094,80,8,>1K
950,remain,3996,22619139,72.8983166422,80,6,>1K
951,perhaps,3995,22623134,72.9111919677,80,7,>1K
952,begin,3990,22627124,72.9240511788,80,5,>1K
953,test,3990,22631114,72.9369103899,80,4,>1K
954,texas,3987,22635101,72.9497599324,80,5,>1K
955,fight,3986,22639087,72.9626062521,80,5,>1K
956,aren,3982,22643069,72.9754396803,80,4,>1K
957,success,3980,22647049,72.9882666628,80,7,>1K
958,leader,3974,22651023,73.0010743081,80,6,>1K
959,finally,3963,22654986,73.013846502,80,7,>1K
960,november,3961,22658947,73.0266122502,80,8,>1K
961,hits,3957,22662904,73.0393651069,80,4,>1K
962,goals,3955,22666859,73.0521115179,80,5,>1K
963,break,3949,22670808,73.0648385918,80,5,>1K
964,followed,3948,22674756,73.0775624427,80,8,>1K
965,view,3948,22678704,73.0902862937,80,4,>1K
966,yes,3947,22682651,73.1030069219,80,3,>1K
967,george,3944,22686595,73.1157178814,80,6,>1K
968,charge,3933,22690528,73.1283933895,80,6,>1K
969,efforts,3933,22694461,73.1410688976,80,7,>1K
970,ran,3923,22698384,73.1537121771,80,3,>1K
971,fresh,3923,22702307,73.1663554566,80,5,>1K
972,required,3919,22706226,73.1789858446,80,8,>1K
973,stand,3919,22710145,73.1916162327,80,5,>1K
974,serve,3911,22714056,73.2042208378,80,5,>1K
975,consider,3911,22717967,73.216825443,80,8,>1K
976,blue,3905,22721872,73.229410711,80,4,>1K
977,traffic,3901,22725773,73.2419830876,80,7,>1K
978,risk,3900,22729673,73.2545522413,80,4,>1K
979,stage,3900,22733573,73.267121395,80,5,>1K
980,fine,3894,22737467,73.2796712116,80,4,>1K
981,agreed,3892,22741359,73.2922145824,80,6,>1K
982,further,3888,22745247,73.3047450618,80,7,>1K
983,championship,3879,22749126,73.3172465354,80,12,>1K
984,created,3875,22753001,73.3297351177,80,7,>1K
985,management,3873,22756874,73.3422172541,80,10,>1K
986,tournament,3870,22760744,73.3546897221,80,10,>1K
987,simply,3865,22764609,73.3671460757,80,6,>1K
988,funding,3864,22768473,73.3795992064,80,7,>1K
989,china,3855,22772328,73.3920233314,80,5,>1K
990,chairman,3852,22776180,73.4044377879,80,8,>1K
991,agreement,3828,22780008,73.4167748957,80,9,>1K
992,defensive,3826,22783834,73.4291055578,80,9,>1K
993,serious,3824,22787658,73.4414297741,80,7,>1K
994,check,3818,22791476,73.4537346533,80,5,>1K
995,tickets,3814,22795290,73.4660266411,80,7,>1K
996,dinner,3809,22799099,73.4783025145,80,6,>1K
997,projects,3807,22802906,73.4905719423,80,8,>1K
998,wrong,3806,22806712,73.5028381471,80,5,>1K
999,situation,3799,22810511,73.515081792,80,9,>1K
1000,orange,3798,22814309,73.527322214,80,6,>1K
1001,michigan,3796,22818105,73.5395561903,80,8,>1K
1002,cover,3790,22821895,73.5517708294,80,5,>1K
1003,floor,3787,22825682,73.5639757999,80,5,>1K
1004,square,3786,22829468,73.5761775476,80,6,>1K
1005,offers,3781,22833249,73.588363181,80,6,>1K
1006,popular,3779,22837028,73.6005423687,80,7,>1K
1007,tom,3778,22840806,73.6127183335,80,3,>1K
1008,huge,3770,22844576,73.6248685154,80,4,>1K
1009,double,3770,22848346,73.6370186973,80,6,>1K
1010,understand,3769,22852115,73.6491656564,80,10,>1K
1011,spend,3766,22855881,73.6613029468,80,5,>1K
1012,ryan,3765,22859646,73.6734370145,80,4,>1K
1013,production,3757,22863403,73.6855452992,80,10,>1K
1014,station,3749,22867152,73.6976278011,80,7,>1K
1015,hour,3746,22870898,73.7097006343,80,4,>1K
1016,cars,3744,22874642,73.7217670219,80,4,>1K
1017,garden,3742,22878384,73.7338269637,80,6,>1K
1018,proposed,3740,22882124,73.7458804599,80,8,>1K
1019,reached,3737,22885861,73.7579242874,80,7,>1K
1020,considered,3731,22889592,73.7699487778,80,10,>1K
1021,justice,3729,22893321,73.7819668225,80,7,>1K
1022,cup,3723,22897044,73.79396553,80,3,>1K
1023,door,3723,22900767,73.8059642375,80,4,>1K
1024,scene,3722,22904489,73.8179597221,80,5,>1K
1025,straight,3717,22908206,73.8299390925,80,8,>1K
1026,blazers,3713,22911919,73.8419055714,80,7,>1K
1027,dollars,3711,22915630,73.8538656045,80,7,>1K
1028,grand,3708,22919338,73.8658159692,80,5,>1K
1029,failed,3704,22923042,73.8777534423,80,6,>1K
1030,crowd,3701,22926743,73.8896812469,80,5,>1K
1031,martin,3700,22930443,73.9016058286,80,6,>1K
1032,income,3693,22934136,73.9135078503,80,6,>1K
1033,reach,3691,22937827,73.9254034263,80,5,>1K
1034,raise,3682,22941509,73.9372699966,80,5,>1K
1035,immediately,3673,22945182,73.9491075611,80,11,>1K
1036,seemed,3673,22948855,73.9609451256,80,6,>1K
1037,hear,3671,22952526,73.9727762444,80,4,>1K
1038,de,3669,22956195,73.9846009174,80,2,>1K
1039,sale,3669,22959864,73.9964255905,80,4,>1K
1040,g,3665,22963529,74.0082373721,80,1,>1K
1041,hands,3665,22967194,74.0200491538,80,5,>1K
1042,table,3658,22970852,74.0318383754,80,5,>1K
1043,measure,3654,22974506,74.0436147055,80,7,>1K
1044,learn,3648,22978154,74.0553716986,80,5,>1K
1045,parking,3642,22981796,74.0671093544,80,7,>1K
1046,girl,3636,22985432,74.0788276731,80,4,>1K
1047,thousands,3631,22989063,74.0905298775,80,9,>1K
1048,knows,3630,22992693,74.102228859,80,5,>1K
1049,latest,3629,22996322,74.1139246177,80,6,>1K
1050,declined,3627,22999949,74.1256139306,80,8,>1K
1051,colorado,3624,23003573,74.137293575,80,8,>1K
1052,authority,3611,23007184,74.1489313222,80,9,>1K
1053,letter,3611,23010795,74.1605690694,80,6,>1K
1054,daily,3611,23014406,74.1722068166,80,5,>1K
1055,looks,3610,23018016,74.1838413409,80,5,>1K
1056,hill,3610,23021626,74.1954758653,80,4,>1K
1057,challenge,3609,23025235,74.2071071667,80,9,>1K
1058,entire,3602,23028837,74.2187159082,80,6,>1K
1059,travel,3601,23032438,74.2303214268,80,6,>1K
1060,injury,3599,23036037,74.2419204997,80,6,>1K
1061,due,3591,23039628,74.2534937896,80,3,>1K
1062,cause,3590,23043218,74.2650638568,80,5,>1K
1063,owners,3588,23046806,74.2766274782,80,6,>1K
1064,moment,3583,23050389,74.2881749853,80,6,>1K
1065,beyond,3578,23053967,74.2997063781,80,6,>1K
1066,natural,3572,23057539,74.3112184338,80,7,>1K
1067,adding,3565,23061104,74.3227079294,80,6,>1K
1068,access,3561,23064665,74.3341845336,80,6,>1K
1069,primary,3560,23068225,74.3456579149,80,7,>1K
1070,vehicle,3560,23071785,74.3571312963,80,7,>1K
1071,q,3557,23075342,74.368595009,80,1,>1K
1072,certain,3555,23078897,74.3800522761,80,7,>1K
1073,seem,3552,23082449,74.3914998745,80,4,>1K
1074,deep,3547,23085996,74.4029313587,80,4,>1K
1075,changed,3547,23089543,74.4143628428,80,7,>1K
1076,approved,3546,23093089,74.4257911041,80,8,>1K
1077,impact,3543,23096632,74.4372096969,80,6,>1K
1078,value,3540,23100172,74.448618621,80,5,>1K
1079,vice,3537,23103709,74.4600178766,80,4,>1K
1080,remember,3528,23107237,74.4713881264,80,8,>1K
1081,jackson,3525,23110762,74.4827487076,80,7,>1K
1082,ve,3518,23114280,74.4940867288,80,2,>1K
1083,quality,3517,23117797,74.5054215272,80,7,>1K
1084,quarterback,3514,23121311,74.516746657,80,11,>1K
1085,choice,3508,23124819,74.5280524496,80,6,>1K
1086,products,3506,23128325,74.5393517965,80,8,>1K
1087,seasons,3504,23131829,74.5506446977,80,7,>1K
1088,returned,3498,23135327,74.5619182617,80,8,>1K
1089,miller,3496,23138823,74.57318538,80,6,>1K
1090,review,3495,23142318,74.5844492754,80,6,>1K
1091,bridge,3494,23145812,74.595709948,80,6,>1K
1092,website,3493,23149305,74.6069673977,80,7,>1K
1093,candidate,3492,23152797,74.6182216246,80,9,>1K
1094,beginning,3490,23156287,74.6294694057,80,9,>1K
1095,proposal,3483,23159770,74.6406946269,80,8,>1K
1096,stores,3473,23163243,74.6518876194,80,6,>1K
1097,itself,3473,23166716,74.6630806119,80,6,>1K
1098,prosecutors,3471,23170187,74.6742671587,80,11,>1K
1099,ability,3467,23173654,74.6854408141,80,7,>1K
1100,criminal,3456,23177110,74.696579018,80,8,>1K
1101,capital,3456,23180566,74.7077172219,80,7,>1K
1102,words,3454,23184020,74.7188489801,80,5,>1K
1103,investors,3450,23187470,74.7299678468,80,9,>1K
1104,township,3448,23190918,74.7410802678,80,8,>1K
1105,sell,3443,23194361,74.7521765746,80,4,>1K
1106,jim,3440,23197801,74.7632632127,80,3,>1K
1107,sen,3440,23201241,74.7743498509,80,3,>1K
1108,february,3438,23204679,74.7854300433,80,8,>1K
1109,crime,3431,23208110,74.7964876757,80,5,>1K
1110,nice,3429,23211539,74.8075388624,80,4,>1K
1111,learned,3426,23214965,74.8185803805,80,7,>1K
1112,hasn,3421,23218386,74.8296057843,80,4,>1K
1113,brother,3421,23221807,74.8406311881,80,7,>1K
1114,planned,3420,23225227,74.851653369,80,7,>1K
1115,form,3412,23228639,74.8626497671,80,4,>1K
1116,girls,3409,23232048,74.8736364966,80,5,>1K
1117,appeared,3408,23235456,74.8846200032,80,8,>1K
1118,above,3403,23238859,74.8955873955,80,5,>1K
1119,charles,3403,23242262,74.9065547879,80,7,>1K
1120,housing,3394,23245656,74.9174931745,80,7,>1K
1121,districts,3392,23249048,74.9284251153,80,9,>1K
1122,boy,3388,23252436,74.9393441648,80,3,>1K
1123,wide,3388,23255824,74.9502632142,80,4,>1K
1124,mostly,3387,23259211,74.9611790408,80,6,>1K
1125,pressure,3386,23262597,74.9720916445,80,8,>1K
1126,rep,3378,23265975,74.9829784653,80,3,>1K
1127,score,3372,23269347,74.993845949,80,5,>1K
1128,original,3364,23272711,75.0046876498,80,8,>1K
1129,shots,3363,23276074,75.0155261277,80,5,>1K
1130,dead,3362,23279436,75.0263613828,80,4,>1K
1131,haven,3362,23282798,75.0371966378,80,5,>1K
1132,cities,3359,23286157,75.0480222243,80,6,>1K
1133,leaving,3359,23289516,75.0588478108,80,7,>1K
1134,certainly,3353,23292869,75.0696540601,80,9,>1K
1135,denver,3351,23296220,75.0804538638,80,6,>1K
1136,benefit,3348,23299568,75.0912439988,80,7,>1K
1137,answer,3345,23302913,75.1020244652,80,6,>1K
1138,treatment,3340,23306253,75.1127888174,80,9,>1K
1139,usually,3336,23309589,75.1235402781,80,7,>1K
1140,range,3334,23312923,75.1342852931,80,5,>1K
1141,quite,3334,23316257,75.1450303081,80,5,>1K
1142,fair,3331,23319588,75.1557656545,80,4,>1K
1143,whatever,3329,23322917,75.1664945552,80,8,>1K
1144,transportation,3328,23326245,75.177220233,80,14,>1K
1145,investment,3326,23329571,75.1879394652,80,10,>1K
1146,foundation,3319,23332890,75.1986361372,80,10,>1K
1147,steve,3317,23336207,75.2093263636,80,5,>1K
1148,tonight,3317,23339524,75.22001659,80,7,>1K
1149,dropped,3317,23342841,75.2307068164,80,7,>1K
1150,eventually,3308,23346149,75.241368037,80,10,>1K
1151,award,3306,23349455,75.2520228119,80,5,>1K
1152,receive,3304,23352759,75.2626711411,80,7,>1K
1153,common,3303,23356062,75.2733162474,80,6,>1K
1154,dog,3298,23359360,75.2839452395,80,3,>1K
1155,maryland,3298,23362658,75.2945742315,80,8,>1K
1156,plus,3295,23365953,75.305193555,80,4,>1K
1157,candidates,3295,23369248,75.3158128784,80,10,>1K
1158,noted,3290,23372538,75.3264160876,80,5,>1K
1159,nba,3286,23375824,75.3370064053,80,3,>1K
1160,offense,3274,23379098,75.3475580487,80,7,>1K
1161,phoenix,3272,23382370,75.3581032464,80,7,>1K
1162,innings,3271,23385641,75.3686452212,80,7,>1K
1163,teacher,3270,23388911,75.3791839732,80,7,>1K
1164,hopes,3267,23392178,75.3897130565,80,5,>1K
1165,decades,3265,23395443,75.4002356942,80,7,>1K
1166,kansas,3260,23398703,75.4107422176,80,6,>1K
1167,december,3258,23401961,75.4212422952,80,8,>1K
1168,junior,3254,23405215,75.4317294814,80,6,>1K
1169,king,3251,23408466,75.442206999,80,4,>1K
1170,address,3247,23411713,75.4526716252,80,7,>1K
1171,legislation,3242,23414955,75.4631201371,80,11,>1K
1172,fish,3242,23418197,75.4735686489,80,4,>1K
1173,simple,3241,23421438,75.484013938,80,6,>1K
1174,provided,3241,23424679,75.494459227,80,8,>1K
1175,message,3240,23427919,75.5049012931,80,7,>1K
1176,complete,3237,23431156,75.5153336907,80,8,>1K
1177,follow,3235,23434391,75.5257596426,80,6,>1K
1178,everybody,3232,23437623,75.5361759259,80,9,>1K
1179,davis,3228,23440851,75.5465793177,80,5,>1K
1180,lose,3227,23444078,75.5569794867,80,4,>1K
1181,perfect,3226,23447304,75.5673764328,80,7,>1K
1182,extra,3225,23450529,75.5777701561,80,5,>1K
1183,books,3215,23453744,75.5881316507,80,5,>1K
1184,losing,3214,23456958,75.5984899225,80,6,>1K
1185,menu,3206,23460164,75.6088224115,80,4,>1K
1186,parts,3205,23463369,75.6191516775,80,5,>1K
1187,jan,3204,23466573,75.6294777207,80,3,>1K
1188,missed,3202,23469775,75.6397973182,80,6,>1K
1189,continued,3201,23472976,75.6501136928,80,9,>1K
1190,starts,3201,23476177,75.6604300675,80,6,>1K
1191,concerns,3199,23479376,75.6707399964,80,8,>1K
1192,places,3196,23482572,75.6810402567,80,6,>1K
1193,enforcement,3196,23485768,75.691340517,80,11,>1K
1194,design,3195,23488963,75.7016375545,80,6,>1K
1195,version,3193,23492156,75.7119281462,80,7,>1K
1196,evening,3190,23495346,75.7222090694,80,7,>1K
1197,camp,3189,23498535,75.7324867697,80,4,>1K
1198,lines,3187,23501722,75.7427580243,80,5,>1K
1199,planning,3175,23504897,75.7529906045,80,8,>1K
1200,older,3172,23508069,75.7632135162,80,5,>1K
1201,word,3155,23511224,75.7733816393,80,4,>1K
1202,cook,3150,23514374,75.783533648,80,4,>1K
1203,significant,3147,23517521,75.7936759882,80,11,>1K
1204,injuries,3147,23520668,75.8038183284,80,8,>1K
1205,labor,3142,23523810,75.8139445543,80,5,>1K
1206,marriage,3140,23526950,75.8240643345,80,8,>1K
1207,ford,3140,23530090,75.8341841146,80,4,>1K
1208,earned,3139,23533229,75.8443006719,80,6,>1K
1209,winter,3136,23536365,75.8544075607,80,6,>1K
1210,network,3133,23539498,75.8645047808,80,7,>1K
1211,twice,3127,23542625,75.8745826638,80,5,>1K
1212,arts,3125,23545750,75.8846541011,80,4,>1K
1213,majority,3125,23548875,75.8947255383,80,8,>1K
1214,banks,3120,23551995,75.9047808613,80,5,>1K
1215,ice,3116,23555111,75.9148232928,80,3,>1K
1216,thinking,3115,23558226,75.9248625015,80,8,>1K
1217,giants,3109,23561335,75.934882373,80,6,>1K
1218,grew,3106,23564441,75.944892576,80,4,>1K
1219,regional,3099,23567540,75.9548802189,80,8,>1K
1220,effect,3095,23570635,75.9648549703,80,6,>1K
1221,jr,3094,23573729,75.9748264989,80,2,>1K
1222,terms,3090,23576819,75.9847851361,80,5,>1K
1223,attack,3090,23579909,75.9947437733,80,6,>1K
1224,items,3081,23582990,76.0046734047,80,5,>1K
1225,poor,3080,23586070,76.0145998133,80,4,>1K
1226,southern,3078,23589148,76.0245197761,80,8,>1K
1227,seconds,3077,23592225,76.0344365161,80,7,>1K
1228,gives,3075,23595300,76.0443468104,80,5,>1K
1229,increased,3071,23598371,76.0542442132,80,9,>1K
1230,w,3069,23601440,76.0641351704,80,1,>1K
1231,seeking,3068,23604508,76.0740229046,80,7,>1K
1232,particularly,3063,23607571,76.0838945246,80,12,>1K
1233,bills,3058,23610629,76.0937500302,80,5,>1K
1234,contact,3054,23613683,76.1035926444,80,7,>1K
1235,coast,3053,23616736,76.1134320358,80,5,>1K
1236,fifth,3052,23619788,76.1232682043,80,5,>1K
1237,apple,3052,23622840,76.1331043728,80,5,>1K
1238,finish,3051,23625891,76.1429373184,80,6,>1K
1239,approach,3048,23628939,76.1527605955,80,8,>1K
1240,presidential,3045,23631984,76.1625742039,80,12,>1K
1241,search,3045,23635029,76.1723878124,80,6,>1K
1242,figure,3044,23638073,76.182198198,80,6,>1K
1243,decade,3041,23641114,76.1919989151,80,6,>1K
1244,response,3040,23644154,76.2017964092,80,8,>1K
1245,consumers,3034,23647188,76.2115745662,80,9,>1K
1246,spokeswoman,3032,23650220,76.2213462775,80,11,>1K
1247,term,3031,23653251,76.231114766,80,4,>1K
1248,host,3025,23656276,76.2408639173,80,4,>1K
1249,currently,3023,23659299,76.2506066228,80,9,>1K
1250,forced,3013,23662312,76.2603170998,80,6,>1K
1251,serving,3012,23665324,76.2700243539,80,7,>1K
1252,global,3011,23668335,76.2797283851,80,6,>1K
1253,sheriff,3008,23671343,76.2894227478,80,7,>1K
1254,compared,3007,23674350,76.2991138876,80,8,>1K
1255,kitchen,3005,23677355,76.3087985816,80,7,>1K
1256,driver,3004,23680359,76.3184800528,80,6,>1K
1257,lawmakers,3003,23683362,76.3281583012,80,9,>1K
1258,stories,3001,23686363,76.3378301038,80,7,>1K
1259,www,2989,23689352,76.3474632322,80,3,>1K
1260,offensive,2986,23692338,76.3570866919,80,9,>1K
1261,designed,2984,23695322,76.3667037059,80,8,>1K
1262,civil,2981,23698303,76.3763110514,80,5,>1K
1263,stopped,2978,23701281,76.3859087282,80,7,>1K
1264,island,2975,23704256,76.3954967365,80,6,>1K
1265,chicken,2975,23707231,76.4050847448,80,7,>1K
1266,healthy,2975,23710206,76.4146727531,80,7,>1K
1267,feb,2974,23713180,76.4242575385,80,3,>1K
1268,guilty,2972,23716152,76.4338358782,80,6,>1K
1269,safe,2971,23719123,76.443410995,80,4,>1K
1270,individual,2970,23722093,76.452982889,80,10,>1K
1271,meanwhile,2965,23725058,76.4625386687,80,9,>1K
1272,emergency,2960,23728018,76.4720783341,80,9,>1K
1273,sept,2960,23730978,76.4816179994,80,4,>1K
1274,hundreds,2959,23733937,76.491154442,80,8,>1K
1275,blood,2954,23736891,76.5006747702,80,5,>1K
1276,relationship,2953,23739844,76.5101918755,80,12,>1K
1277,ones,2950,23742794,76.5196993123,80,4,>1K
1278,sound,2939,23745733,76.5291712976,80,5,>1K
1279,western,2939,23748672,76.538643283,80,7,>1K
1280,piece,2937,23751609,76.5481088226,80,5,>1K
1281,caught,2936,23754545,76.5575711393,80,6,>1K
1282,calling,2934,23757479,76.5670270103,80,7,>1K
1283,asking,2926,23760405,76.5764570985,80,6,>1K
1284,wait,2926,23763331,76.5858871866,80,4,>1K
1285,boys,2923,23766254,76.5953076062,80,4,>1K
1286,fast,2922,23769176,76.6047248029,80,4,>1K
1287,la,2921,23772097,76.6141387767,80,2,>1K
1288,restaurants,2921,23775018,76.6235527506,80,11,>1K
1289,incident,2920,23777938,76.6329635016,80,8,>1K
1290,campus,2917,23780855,76.642364584,80,6,>1K
1291,born,2906,23783761,76.6517302149,80,4,>1K
1292,accused,2899,23786660,76.6610732858,80,7,>1K
1293,facility,2898,23789558,76.6704131339,80,8,>1K
1294,minnesota,2895,23792453,76.6797433134,80,9,>1K
1295,gop,2891,23795344,76.6890606014,80,3,>1K
1296,arrived,2888,23798232,76.6983682209,80,7,>1K
1297,stuff,2888,23801120,76.7076758404,80,5,>1K
1298,operations,2880,23804000,76.716957677,80,10,>1K
1299,ceo,2874,23806874,76.7262201764,80,3,>1K
1300,society,2872,23809746,76.7354762301,80,7,>1K
1301,written,2871,23812617,76.7447290609,80,7,>1K
1302,described,2869,23815486,76.7539754461,80,9,>1K
1303,avoid,2867,23818353,76.7632153855,80,5,>1K
1304,drop,2867,23821220,76.7724553249,80,4,>1K
1305,size,2867,23824087,76.7816952643,80,4,>1K
1306,blues,2862,23826949,76.7909190894,80,5,>1K
1307,style,2860,23829809,76.8001364688,80,5,>1K
1308,options,2855,23832664,76.8093377339,80,7,>1K
1309,features,2854,23835518,76.8185357761,80,8,>1K
1310,numerous,2853,23838371,76.8277305955,80,8,>1K
1311,heights,2852,23841223,76.836922192,80,7,>1K
1312,immigration,2849,23844072,76.8461041199,80,11,>1K
1313,card,2847,23846919,76.8552796021,80,4,>1K
1314,improve,2846,23849765,76.8644518615,80,7,>1K
1315,sun,2845,23852610,76.873620898,80,3,>1K
1316,seeing,2844,23855454,76.8827867116,80,6,>1K
1317,television,2842,23858296,76.8919460795,80,10,>1K
1318,super,2841,23861137,76.9011022245,80,5,>1K
1319,cardinals,2841,23863978,76.9102583696,80,9,>1K
1320,mexico,2837,23866815,76.9194016232,80,6,>1K
1321,alone,2831,23869646,76.9285255397,80,5,>1K
1322,science,2827,23872473,76.9376365647,80,7,>1K
1323,require,2826,23875299,76.9467443668,80,7,>1K
1324,l,2823,23878122,76.9558425004,80,1,>1K
1325,murder,2822,23880944,76.9649374111,80,6,>1K
1326,europe,2820,23883764,76.9740258761,80,6,>1K
1327,struck,2820,23886584,76.9831143411,80,6,>1K
1328,prosecutor,2819,23889403,76.9921995832,80,10,>1K
1329,diego,2818,23892221,77.0012816025,80,5,>1K
1330,inning,2815,23895036,77.0103539532,80,6,>1K
1331,crisis,2813,23897849,77.0194198581,80,6,>1K
1332,laws,2811,23900660,77.0284793174,80,4,>1K
1333,joined,2810,23903470,77.0375355538,80,6,>1K
1334,professional,2810,23906280,77.0465917902,80,12,>1K
1335,bought,2807,23909087,77.055638358,80,6,>1K
1336,mary,2802,23911889,77.0646688115,80,4,>1K
1337,lived,2796,23914685,77.0736799279,80,5,>1K
1338,environmental,2793,23917478,77.0826813756,80,13,>1K
1339,date,2789,23920267,77.091669932,80,4,>1K
1340,levels,2789,23923056,77.1006584883,80,6,>1K
1341,mountain,2788,23925844,77.1096438218,80,8,>1K
1342,richard,2786,23928630,77.1186227095,80,7,>1K
1343,beer,2785,23931415,77.1275983744,80,4,>1K
1344,commissioner,2784,23934199,77.1365708164,80,12,>1K
1345,bottom,2781,23936980,77.1455335899,80,6,>1K
1346,paper,2780,23939760,77.1544931405,80,5,>1K
1347,watching,2777,23942537,77.1634430225,80,8,>1K
1348,demand,2776,23945313,77.1723896817,80,6,>1K
1349,matt,2772,23948085,77.1813234494,80,4,>1K
1350,ave,2770,23950855,77.1902507714,80,3,>1K
1351,sweet,2769,23953624,77.1991748705,80,5,>1K
1352,voice,2766,23956390,77.2080893011,80,5,>1K
1353,claims,2764,23959154,77.2169972859,80,6,>1K
1354,festival,2764,23961918,77.2259052707,80,8,>1K
1355,whom,2764,23964682,77.2348132556,80,4,>1K
1356,browns,2760,23967442,77.243708349,80,6,>1K
1357,plenty,2758,23970200,77.2525969966,80,6,>1K
1358,note,2757,23972957,77.2614824215,80,4,>1K
1359,successful,2755,23975712,77.2703614006,80,10,>1K
1360,august,2755,23978467,77.2792403797,80,6,>1K
1361,match,2753,23981220,77.288112913,80,5,>1K
1362,walked,2753,23983973,77.2969854464,80,6,>1K
1363,september,2753,23986726,77.3058579798,80,9,>1K
1364,cannot,2753,23989479,77.3147305132,80,6,>1K
1365,advantage,2753,23992232,77.3236030465,80,9,>1K
1366,ncaa,2752,23994984,77.332472357,80,4,>1K
1367,kevin,2751,23997735,77.3413384447,80,5,>1K
1368,leadership,2750,24000485,77.3502013095,80,10,>1K
1369,account,2747,24003232,77.3590545057,80,7,>1K
1370,model,2746,24005978,77.3679044791,80,5,>1K
1371,coaches,2744,24008722,77.3767480067,80,7,>1K
1372,paying,2744,24011466,77.3855915343,80,6,>1K
1373,reduce,2742,24014208,77.3944286163,80,6,>1K
1374,shop,2735,24016943,77.4032431382,80,4,>1K
1375,grow,2734,24019677,77.4120544372,80,4,>1K
1376,putting,2732,24022409,77.4208592905,80,7,>1K
1377,airport,2731,24025140,77.429660921,80,7,>1K
1378,lee,2730,24027870,77.4384593286,80,3,>1K
1379,issued,2729,24030599,77.4472545133,80,6,>1K
1380,pulled,2726,24033325,77.4560400295,80,6,>1K
1381,investigators,2726,24036051,77.4648255456,80,13,>1K
1382,feeling,2722,24038773,77.4735981703,80,7,>1K
1383,continues,2719,24041492,77.4823611265,80,9,>1K
1384,agent,2718,24044210,77.4911208598,80,5,>1K
1385,missing,2717,24046927,77.4998773702,80,7,>1K
1386,seat,2716,24049643,77.5086306577,80,4,>1K
1387,fees,2715,24052358,77.5173807224,80,4,>1K
1388,complex,2715,24055073,77.5261307871,80,7,>1K
1389,experts,2709,24057782,77.5348615147,80,7,>1K
1390,lawyer,2708,24060490,77.5435890194,80,6,>1K
1391,resources,2708,24063198,77.552316524,80,9,>1K
1392,markets,2706,24065904,77.561037583,80,7,>1K
1393,onto,2706,24068610,77.569758642,80,4,>1K
1394,nearby,2703,24071313,77.5784700323,80,6,>1K
1395,playoff,2701,24074014,77.587174977,80,7,>1K
1396,debate,2698,24076712,77.5958702531,80,6,>1K
1397,hurt,2698,24079410,77.6045655292,80,4,>1K
1398,traditional,2695,24082105,77.6132511367,80,11,>1K
1399,trail,2695,24084800,77.6219367442,80,5,>1K
1400,cents,2693,24087493,77.6306159059,80,5,>1K
1401,lack,2688,24090181,77.6392789534,80,4,>1K
1402,miss,2679,24092860,77.6479129952,80,4,>1K
1403,radio,2678,24095538,77.656543814,80,5,>1K
1404,protect,2668,24098206,77.6651424043,80,7,>1K
1405,resident,2668,24100874,77.6737409946,80,8,>1K
1406,theater,2667,24103541,77.682336362,80,7,>1K
1407,illegal,2663,24106204,77.690918838,80,7,>1K
1408,waiting,2663,24108867,77.699501314,80,7,>1K
1409,october,2662,24111529,77.7080805671,80,7,>1K
1410,box,2656,24114185,77.7166404831,80,3,>1K
1411,net,2655,24116840,77.7251971762,80,3,>1K
1412,professor,2653,24119493,77.7337474236,80,9,>1K
1413,winner,2653,24122146,77.7422976709,80,6,>1K
1414,consumer,2649,24124795,77.7508350269,80,8,>1K
1415,cheese,2646,24127441,77.7593627143,80,6,>1K
1416,millions,2641,24130082,77.7678742873,80,8,>1K
1417,estate,2639,24132721,77.7763794147,80,6,>1K
1418,limited,2638,24135359,77.7848813192,80,7,>1K
1419,disease,2636,24137995,77.7933767779,80,7,>1K
1420,difference,2635,24140630,77.8018690138,80,10,>1K
1421,damage,2630,24143260,77.8103451354,80,6,>1K
1422,god,2628,24145888,77.8188148113,80,3,>1K
1423,baby,2625,24148513,77.8272748186,80,4,>1K
1424,helping,2623,24151136,77.8357283802,80,7,>1K
1425,internet,2620,24153756,77.8441722732,80,8,>1K
1426,plants,2619,24156375,77.8526129434,80,6,>1K
1427,brian,2619,24158994,77.8610536135,80,5,>1K
1428,exactly,2619,24161613,77.8694942836,80,7,>1K
1429,throw,2616,24164229,77.8779252852,80,5,>1K
1430,frank,2609,24166838,77.8863337268,80,5,>1K
1431,offering,2606,24169444,77.8947324997,80,8,>1K
1432,rich,2604,24172048,77.903124827,80,4,>1K
1433,surgery,2601,24174649,77.9115074856,80,7,>1K
1434,standard,2593,24177242,77.9198643614,80,8,>1K
1435,native,2592,24179834,77.9282180144,80,6,>1K
1436,broke,2592,24182426,77.9365716673,80,5,>1K
1437,holding,2592,24185018,77.9449253202,80,7,>1K
1438,golf,2591,24187609,77.9532757503,80,4,>1K
1439,spoke,2589,24190198,77.9616197346,80,5,>1K
1440,unemployment,2589,24192787,77.969963719,80,12,>1K
1441,lawsuit,2588,24195375,77.9783044805,80,7,>1K
1442,highway,2587,24197962,77.9866420191,80,7,>1K
1443,doctors,2583,24200545,77.9949666663,80,7,>1K
1444,keeping,2583,24203128,78.0032913135,80,7,>1K
1445,positive,2582,24205710,78.0116127378,80,8,>1K
1446,audience,2580,24208290,78.0199277164,80,8,>1K
1447,battle,2579,24210869,78.0282394722,80,6,>1K
1448,french,2579,24213448,78.0365512279,80,6,>1K
1449,legislature,2578,24216026,78.0448597608,80,11,>1K
1450,location,2577,24218603,78.0531650708,80,8,>1K
1451,walking,2576,24221179,78.061467158,80,7,>1K
1452,route,2571,24223750,78.0697531309,80,5,>1K
1453,speed,2570,24226320,78.0780358809,80,5,>1K
1454,philadelphia,2566,24228886,78.0863057394,80,12,>1K
1455,library,2565,24231451,78.0945723752,80,7,>1K
1456,signs,2563,24234014,78.1028325651,80,5,>1K
1457,remaining,2563,24236577,78.1110927551,80,9,>1K
1458,pounds,2561,24239138,78.1193464994,80,6,>1K
1459,faces,2561,24241699,78.1276002437,80,5,>1K
1460,reform,2560,24244259,78.1358507651,80,6,>1K
1461,greater,2560,24246819,78.1441012865,80,7,>1K
1462,dec,2557,24249376,78.1523421393,80,3,>1K
1463,streets,2555,24251931,78.1605765464,80,7,>1K
1464,b,2555,24254486,78.1688109535,80,1,>1K
1465,scoring,2555,24257041,78.1770453607,80,7,>1K
1466,appear,2555,24259596,78.1852797678,80,6,>1K
1467,boston,2555,24262151,78.1935141749,80,6,>1K
1468,sacramento,2553,24264704,78.2017421363,80,10,>1K
1469,bob,2553,24267257,78.2099700977,80,3,>1K
1470,cool,2549,24269806,78.2181851676,80,4,>1K
1471,army,2549,24272355,78.2264002376,80,4,>1K
1472,physical,2548,24274903,78.2346120847,80,8,>1K
1473,jury,2547,24277450,78.2428207089,80,4,>1K
1474,drugs,2547,24279997,78.2510293331,80,5,>1K
1475,european,2545,24282542,78.2592315116,80,8,>1K
1476,clean,2541,24285083,78.2674207987,80,5,>1K
1477,playoffs,2540,24287623,78.2756068629,80,8,>1K
1478,retired,2537,24290160,78.2837832585,80,7,>1K
1479,victims,2534,24292694,78.2919499856,80,7,>1K
1480,enjoy,2531,24295225,78.3001070441,80,5,>1K
1481,talked,2529,24297754,78.3082576568,80,6,>1K
1482,song,2528,24300282,78.3164050467,80,4,>1K
1483,santa,2527,24302809,78.3245492137,80,5,>1K
1484,picked,2526,24305335,78.3326901579,80,6,>1K
1485,corp,2524,24307859,78.3408246564,80,4,>1K
1486,population,2523,24310382,78.348955932,80,10,>1K
1487,mix,2518,24312900,78.3570710933,80,3,>1K
1488,quick,2515,24315415,78.365176586,80,5,>1K
1489,various,2515,24317930,78.3732820787,80,7,>1K
1490,shares,2514,24320444,78.3813843485,80,6,>1K
1491,dark,2509,24322953,78.3894705041,80,4,>1K
1492,request,2509,24325462,78.3975566597,80,7,>1K
1493,push,2508,24327970,78.4056395923,80,4,>1K
1494,send,2506,24330476,78.4137160793,80,4,>1K
1495,r,2504,24332980,78.4217861206,80,1,>1K
1496,trust,2499,24335479,78.4298400475,80,5,>1K
1497,facebook,2499,24337978,78.4378939745,80,8,>1K
1498,bus,2496,24340474,78.4459382329,80,3,>1K
1499,honor,2492,24342966,78.4539695998,80,5,>1K
1500,names,2490,24345456,78.461994521,80,5,>1K
1501,myself,2489,24347945,78.4700162194,80,6,>1K
1502,present,2488,24350433,78.4780346949,80,7,>1K
1503,ride,2485,24352918,78.4860435018,80,4,>1K
1504,session,2484,24355402,78.4940490858,80,7,>1K
1505,elected,2483,24357885,78.502051447,80,7,>1K
1506,anthony,2482,24360367,78.5100505854,80,7,>1K
1507,type,2481,24362848,78.5180465008,80,4,>1K
1508,operating,2480,24365328,78.5260391935,80,9,>1K
1509,sister,2479,24367807,78.5340286632,80,6,>1K
1510,sauce,2477,24370284,78.5420116873,80,5,>1K
1511,caused,2476,24372760,78.5499914884,80,6,>1K
1512,ll,2472,24375232,78.5579583982,80,2,>1K
1513,writing,2471,24377703,78.565922085,80,7,>1K
1514,dozen,2469,24380172,78.5738793262,80,5,>1K
1515,product,2467,24382639,78.5818301216,80,7,>1K
1516,finding,2464,24385103,78.5897712485,80,7,>1K
1517,houston,2463,24387566,78.5977091525,80,7,>1K
1518,chinese,2457,24390023,78.6056277193,80,7,>1K
1519,notes,2456,24392479,78.6135430633,80,5,>1K
1520,selling,2455,24394934,78.6214551844,80,7,>1K
1521,violence,2455,24397389,78.6293673055,80,8,>1K
1522,eyes,2454,24399843,78.6372762038,80,4,>1K
1523,gay,2454,24402297,78.6451851021,80,3,>1K
1524,computer,2452,24404749,78.6530875546,80,8,>1K
1525,countries,2450,24407199,78.6609835614,80,9,>1K
1526,character,2449,24409648,78.6688763454,80,9,>1K
1527,cast,2447,24412095,78.6767626836,80,4,>1K
1528,weren,2441,24414536,78.6846296847,80,5,>1K
1529,william,2439,24416975,78.6924902401,80,7,>1K
1530,jail,2433,24419408,78.7003314583,80,4,>1K
1531,bigger,2433,24421841,78.7081726765,80,6,>1K
1532,kid,2432,24424273,78.7160106718,80,3,>1K
1533,balance,2431,24426704,78.7238454443,80,7,>1K
1534,carolina,2431,24429135,78.7316802168,80,8,>1K
1535,mission,2431,24431566,78.7395149892,80,7,>1K
1536,protection,2430,24433996,78.7473465389,80,10,>1K
1537,voted,2430,24436426,78.7551780885,80,5,>1K
1538,reading,2429,24438855,78.7630064152,80,7,>1K
1539,eat,2428,24441283,78.7708315191,80,3,>1K
1540,picture,2426,24443709,78.7786501773,80,7,>1K
1541,dance,2425,24446134,78.7864656126,80,5,>1K
1542,independent,2425,24448559,78.794281048,80,11,>1K
1543,decisions,2423,24450982,78.8020900376,80,9,>1K
1544,retirement,2423,24453405,78.8098990272,80,10,>1K
1545,tim,2419,24455824,78.8176951253,80,3,>1K
1546,speak,2419,24458243,78.8254912235,80,5,>1K
1547,committed,2418,24460661,78.8332840988,80,9,>1K
1548,focused,2416,24463077,78.8410705284,80,7,>1K
1549,corner,2415,24465492,78.8488537351,80,6,>1K
1550,unit,2413,24467905,78.8566304961,80,4,>1K
1551,definitely,2413,24470318,78.8644072571,80,10,>1K
1552,larger,2413,24472731,78.8721840181,80,6,>1K
1553,suffered,2412,24475143,78.8799575562,80,8,>1K
1554,necessary,2410,24477553,78.8877246486,80,9,>1K
1555,buildings,2408,24479961,78.8954852953,80,9,>1K
1556,weight,2407,24482368,78.9032427192,80,6,>1K
1557,tied,2403,24484771,78.9109872516,80,4,>1K
1558,lunch,2401,24487172,78.9187253383,80,5,>1K
1559,miami,2399,24489571,78.9264569792,80,5,>1K
1560,employee,2397,24491968,78.9341821745,80,8,>1K
1561,multiple,2397,24494365,78.9419073697,80,8,>1K
1562,smaller,2397,24496762,78.949632565,80,7,>1K
1563,believes,2396,24499158,78.9573545373,80,8,>1K
1564,willing,2395,24501553,78.9650732869,80,7,>1K
1565,commercial,2393,24503946,78.9727855907,80,10,>1K
1566,activities,2393,24506339,78.9804978945,80,10,>1K
1567,golden,2392,24508731,78.9882069754,80,6,>1K
1568,vehicles,2392,24511123,78.9959160564,80,8,>1K
1569,conservative,2392,24513515,79.0036251373,80,12,>1K
1570,jeff,2385,24515900,79.0113116582,80,4,>1K
1571,rise,2385,24518285,79.0189981791,80,4,>1K
1572,appears,2385,24520670,79.0266847001,80,7,>1K
1573,highest,2383,24523053,79.0343647753,80,7,>1K
1574,degree,2381,24525434,79.0420384048,80,6,>1K
1575,visitors,2379,24527813,79.0497055885,80,8,>1K
1576,sitting,2378,24530191,79.0573695494,80,7,>1K
1577,pieces,2376,24532567,79.0650270646,80,6,>1K
1578,collection,2376,24534943,79.0726845798,80,10,>1K
1579,citizens,2373,24537316,79.0803324264,80,8,>1K
1580,none,2372,24539688,79.0879770501,80,4,>1K
1581,nov,2370,24542058,79.0956152282,80,3,>1K
1582,placed,2367,24544425,79.1032437376,80,6,>1K
1583,athletic,2367,24546792,79.1108722471,80,8,>1K
1584,sides,2366,24549158,79.1184975336,80,5,>1K
1585,corporate,2363,24551521,79.1261131516,80,9,>1K
1586,grant,2359,24553880,79.1337158782,80,5,>1K
1587,concerned,2359,24556239,79.1413186048,80,9,>1K
1588,wild,2357,24558596,79.1489148856,80,4,>1K
1589,gold,2355,24560951,79.1565047207,80,4,>1K
1590,fired,2350,24563301,79.1640784416,80,5,>1K
1591,happens,2348,24565649,79.1716457167,80,7,>1K
1592,holiday,2346,24567995,79.1792065461,80,7,>1K
1593,chef,2345,24570340,79.1867641526,80,4,>1K
1594,standing,2345,24572685,79.1943217591,80,8,>1K
1595,option,2344,24575029,79.2018761428,80,6,>1K
1596,peter,2344,24577373,79.2094305265,80,5,>1K
1597,adults,2342,24579715,79.2169784644,80,6,>1K
1598,arrest,2340,24582055,79.2245199566,80,6,>1K
1599,reasons,2339,24584394,79.232058226,80,7,>1K
1600,attempt,2338,24586732,79.2395932725,80,7,>1K
1601,salt,2338,24589070,79.247128319,80,4,>1K
1602,younger,2338,24591408,79.2546633655,80,7,>1K
1603,claim,2338,24593746,79.262198412,80,5,>1K
1604,politics,2334,24596080,79.2697205671,80,8,>1K
1605,hired,2333,24598413,79.2772394993,80,5,>1K
1606,exchange,2324,24600737,79.2847294258,80,8,>1K
1607,filled,2323,24603060,79.2922161294,80,6,>1K
1608,parks,2321,24605381,79.2996963873,80,5,>1K
1609,stars,2321,24607702,79.3071766451,80,5,>1K
1610,join,2320,24610022,79.3146536802,80,4,>1K
1611,drew,2318,24612340,79.3221242695,80,4,>1K
1612,communities,2317,24614657,79.3295916359,80,11,>1K
1613,decide,2311,24616968,79.3370396652,80,6,>1K
1614,target,2310,24619278,79.3444844716,80,6,>1K
1615,clearly,2310,24621588,79.3519292781,80,7,>1K
1616,modern,2307,24623895,79.3593644159,80,6,>1K
1617,trouble,2304,24626199,79.3667898852,80,7,>1K
1618,pitch,2302,24628501,79.3742089087,80,5,>1K
1619,taste,2302,24630803,79.3816279323,80,5,>1K
1620,rule,2301,24633104,79.389043733,80,4,>1K
1621,era,2301,24635405,79.3964595337,80,3,>1K
1622,veteran,2298,24637703,79.4038656658,80,7,>1K
1623,lots,2298,24640001,79.4112717979,80,4,>1K
1624,taylor,2297,24642298,79.4186747071,80,6,>1K
1625,count,2297,24644595,79.4260776164,80,5,>1K
1626,learning,2296,24646891,79.4334773028,80,8,>1K
1627,feels,2295,24649186,79.4408737663,80,5,>1K
1628,fewer,2295,24651481,79.4482702298,80,5,>1K
1629,status,2294,24653775,79.4556634705,80,6,>1K
1630,supporters,2293,24656068,79.4630534883,80,10,>1K
1631,systems,2292,24658360,79.4704402833,80,7,>1K
1632,coverage,2292,24660652,79.4778270782,80,8,>1K
1633,sit,2291,24662943,79.4852106503,80,3,>1K
1634,howard,2291,24665234,79.4925942224,80,6,>1K
1635,conditions,2291,24667525,79.4999777945,80,10,>1K
1636,hills,2291,24669816,79.5073613666,80,5,>1K
1637,heavy,2286,24672102,79.5147288244,80,5,>1K
1638,pool,2286,24674388,79.5220962822,80,4,>1K
1639,wearing,2284,24676672,79.5294572942,80,7,>1K
1640,marketing,2282,24678954,79.5368118606,80,9,>1K
1641,sort,2281,24681235,79.5441632041,80,4,>1K
1642,schedule,2280,24683515,79.5515113247,80,8,>1K
1643,prepared,2277,24685792,79.5588497768,80,8,>1K
1644,closer,2277,24688069,79.5661882288,80,6,>1K
1645,oct,2277,24690346,79.5735266809,80,3,>1K
1646,telling,2274,24692620,79.5808554643,80,7,>1K
1647,injured,2274,24694894,79.5881842478,80,7,>1K
1648,provides,2273,24697167,79.5955098084,80,8,>1K
1649,bond,2272,24699439,79.6028321462,80,4,>1K
1650,suit,2270,24701709,79.6101480382,80,4,>1K
1651,upon,2270,24703979,79.6174639302,80,4,>1K
1652,loans,2270,24706249,79.6247798223,80,5,>1K
1653,fit,2267,24708516,79.6320860457,80,3,>1K
1654,barack,2265,24710781,79.6393858235,80,6,>1K
1655,movement,2264,24713045,79.6466823783,80,8,>1K
1656,votes,2263,24715308,79.6539757103,80,5,>1K
1657,reporters,2263,24717571,79.6612690423,80,9,>1K
1658,believed,2263,24719834,79.6685623744,80,8,>1K
1659,standards,2260,24722094,79.6758460378,80,9,>1K
1660,ticket,2257,24724351,79.6831200326,80,6,>1K
1661,christmas,2256,24726607,79.6903908046,80,9,>1K
1662,hitting,2255,24728862,79.6976583538,80,7,>1K
1663,previously,2255,24731117,79.7049259029,80,10,>1K
1664,eye,2253,24733370,79.7121870063,80,3,>1K
1665,nature,2252,24735622,79.7194448869,80,6,>1K
1666,fiscal,2251,24737873,79.7266995446,80,6,>1K
1667,pain,2250,24740123,79.7339509794,80,4,>1K
1668,sixth,2245,24742368,79.7411862999,80,5,>1K
1669,allowing,2244,24744612,79.7484183976,80,8,>1K
1670,kelly,2243,24746855,79.7556472724,80,5,>1K
1671,source,2243,24749098,79.7628761472,80,6,>1K
1672,foreign,2240,24751338,79.7700953535,80,7,>1K
1673,fan,2239,24753577,79.7773113368,80,3,>1K
1674,equipment,2239,24755816,79.7845273202,80,9,>1K
1675,victim,2238,24758054,79.7917400807,80,6,>1K
1676,combined,2238,24760292,79.7989528412,80,8,>1K
1677,tony,2236,24762528,79.806159156,80,4,>1K
1678,pair,2235,24764763,79.813362248,80,4,>1K
1679,trees,2235,24766998,79.8205653399,80,5,>1K
1680,showing,2234,24769232,79.827765209,80,7,>1K
1681,london,2230,24771462,79.8349521866,80,6,>1K
1682,culture,2229,24773691,79.8421359414,80,7,>1K
1683,meetings,2227,24775918,79.8493132504,80,8,>1K
1684,sugar,2222,24778140,79.8564744452,80,5,>1K
1685,zone,2221,24780361,79.8636324171,80,4,>1K
1686,supposed,2221,24782582,79.870790389,80,8,>1K
1687,worst,2221,24784803,79.8779483609,80,5,>1K
1688,condition,2220,24787023,79.8851031099,80,9,>1K
1689,meant,2218,24789241,79.8922514132,80,5,>1K
1690,apartment,2218,24791459,79.8993997166,80,9,>1K
1691,critical,2218,24793677,79.9065480199,80,8,>1K
1692,champion,2217,24795894,79.9136931003,80,8,>1K
1693,manning,2217,24798111,79.9208381808,80,7,>1K
1694,carry,2217,24800328,79.9279832612,80,5,>1K
1695,fat,2215,24802543,79.935121896,80,3,>1K
1696,page,2215,24804758,79.9422605307,80,4,>1K
1697,gm,2214,24806972,79.9493959426,80,2,>1K
1698,academy,2212,24809184,79.9565249087,80,7,>1K
1699,farm,2210,24811394,79.9636474292,80,4,>1K
1700,concern,2209,24813603,79.9707667268,80,7,>1K
1701,partner,2205,24815808,79.9778731329,80,7,>1K
1702,loved,2205,24818013,79.984979539,80,5,>1K
1703,figures,2205,24820218,79.9920859452,90,7,>1K
1704,leaves,2203,24822421,79.9991859056,90,6,>1K
1705,speech,2202,24824623,80.0062826431,90,6,>1K
1706,supreme,2198,24826821,80.0133664893,90,7,>1K
1707,historic,2195,24829016,80.0204406668,90,8,>1K
1708,posted,2195,24831211,80.0275148443,90,6,>1K
1709,slow,2193,24833404,80.0345825761,90,4,>1K
1710,estimated,2191,24835595,80.0416438622,90,9,>1K
1711,catch,2189,24837784,80.0486987026,90,5,>1K
1712,parties,2189,24839973,80.055753543,90,7,>1K
1713,counties,2188,24842161,80.0628051605,90,8,>1K
1714,al,2187,24844348,80.0698535552,90,2,>1K
1715,lineup,2184,24846532,80.0768922813,90,6,>1K
1716,org,2183,24848715,80.0839277845,90,3,>1K
1717,urban,2183,24850898,80.0909632877,90,5,>1K
1718,flight,2183,24853081,80.0979987909,90,6,>1K
1719,tree,2179,24855260,80.1050214027,90,4,>1K
1720,identified,2177,24857437,80.1120375687,90,10,>1K
1721,cold,2176,24859613,80.1190505119,90,4,>1K
1722,rebounds,2174,24861787,80.1260570094,90,8,>1K
1723,percentage,2173,24863960,80.133060284,90,10,>1K
1724,facing,2173,24866133,80.1400635587,90,6,>1K
1725,interested,2172,24868305,80.1470636104,90,10,>1K
1726,contracts,2171,24870476,80.1540604393,90,9,>1K
1727,married,2170,24872646,80.1610540454,90,7,>1K
1728,subject,2169,24874815,80.1680444285,90,7,>1K
1729,helps,2168,24876983,80.1750315889,90,5,>1K
1730,bureau,2167,24879150,80.1820155263,90,6,>1K
1731,cross,2164,24881314,80.1889897952,90,5,>1K
1732,turns,2163,24883477,80.1959608412,90,5,>1K
1733,obviously,2162,24885639,80.2029286644,90,9,>1K
1734,suggested,2160,24887799,80.2098900418,90,9,>1K
1735,mom,2160,24889959,80.2168514193,90,3,>1K
1736,agree,2160,24892119,80.2238127967,90,5,>1K
1737,lane,2159,24894278,80.2307709513,90,4,>1K
1738,joseph,2159,24896437,80.2377291059,90,6,>1K
1739,surprise,2159,24898596,80.2446872604,90,8,>1K
1740,language,2157,24900753,80.2516389693,90,8,>1K
1741,volunteers,2152,24902905,80.2585745639,90,10,>1K
1742,fill,2152,24905057,80.2655101584,90,4,>1K
1743,allows,2142,24907199,80.2724135244,90,6,>1K
1744,recession,2138,24909337,80.2793039989,90,9,>1K
1745,sat,2137,24911474,80.2861912506,90,3,>1K
1746,gun,2137,24913611,80.2930785022,90,3,>1K
1747,cards,2137,24915748,80.2999657539,90,5,>1K
1748,creating,2135,24917883,80.3068465598,90,8,>1K
1749,attend,2133,24920016,80.3137209201,90,6,>1K
1750,choose,2132,24922148,80.3205920574,90,6,>1K
1751,centers,2130,24924278,80.3274567491,90,7,>1K
1752,neither,2130,24926408,80.3343214407,90,7,>1K
1753,approval,2130,24928538,80.3411861323,90,8,>1K
1754,skills,2130,24930668,80.348050824,90,6,>1K
1755,rick,2127,24932795,80.354905847,90,4,>1K
1756,prevent,2126,24934921,80.3617576473,90,7,>1K
1757,environment,2125,24937046,80.3686062246,90,11,>1K
1758,plate,2125,24939171,80.3754548019,90,5,>1K
1759,comments,2125,24941296,80.3823033793,90,8,>1K
1760,thanks,2123,24943419,80.3891455109,90,6,>1K
1761,truck,2123,24945542,80.3959876425,90,5,>1K
1762,increases,2122,24947664,80.4028265513,90,9,>1K
1763,produce,2122,24949786,80.40966546,90,7,>1K
1764,agencies,2122,24951908,80.4165043688,90,8,>1K
1765,allen,2121,24954029,80.4233400547,90,5,>1K
1766,memorial,2121,24956150,80.4301757406,90,8,>1K
1767,hoping,2121,24958271,80.4370114265,90,6,>1K
1768,separate,2119,24960390,80.4438406667,90,8,>1K
1769,mid,2117,24962507,80.4506634612,90,3,>1K
1770,dogs,2115,24964622,80.4574798099,90,4,>1K
1771,fuel,2113,24966735,80.4642897129,90,4,>1K
1772,appeal,2112,24968847,80.4710963931,90,6,>1K
1773,easily,2110,24970957,80.4778966275,90,6,>1K
1774,village,2109,24973066,80.4846936391,90,7,>1K
1775,color,2109,24975175,80.4914906507,90,5,>1K
1776,discuss,2107,24977282,80.4982812166,90,7,>1K
1777,christian,2102,24979384,80.5050556681,90,9,>1K
1778,seats,2101,24981485,80.5118268968,90,5,>1K
1779,begins,2100,24983585,80.5185949027,90,6,>1K
1780,abuse,2099,24985684,80.5253596857,90,5,>1K
1781,jump,2093,24987777,80.5321051315,90,4,>1K
1782,responded,2093,24989870,80.5388505773,90,9,>1K
1783,adams,2093,24991963,80.5455960231,90,5,>1K
1784,santorum,2093,24994056,80.552341469,90,8,>1K
1785,northeast,2090,24996146,80.5590772462,90,9,>1K
1786,atlanta,2090,24998236,80.5658130235,90,7,>1K
1787,activity,2089,25000325,80.5725455778,90,8,>1K
1788,determine,2089,25002414,80.5792781322,90,9,>1K
1789,freshman,2088,25004502,80.5860074638,90,8,>1K
1790,variety,2087,25006589,80.5927335724,90,7,>1K
1791,coffee,2087,25008676,80.5994596811,90,6,>1K
1792,charter,2086,25010762,80.6061825669,90,7,>1K
1793,congressional,2085,25012847,80.6129022298,90,13,>1K
1794,survey,2083,25014930,80.6196154471,90,6,>1K
1795,creek,2083,25017013,80.6263286643,90,5,>1K
1796,wind,2082,25019095,80.6330386587,90,4,>1K
1797,indians,2080,25021175,80.6397422073,90,7,>1K
1798,beautiful,2079,25023254,80.6464425331,90,9,>1K
1799,train,2079,25025333,80.6531428589,90,5,>1K
1800,english,2077,25027410,80.6598367389,90,7,>1K
1801,remove,2074,25029484,80.6665209504,90,6,>1K
1802,reality,2072,25031556,80.6731987162,90,7,>1K
1803,completed,2071,25033627,80.6798732591,90,9,>1K
1804,northern,2070,25035697,80.6865445791,90,8,>1K
1805,dan,2070,25037767,80.6932158992,90,3,>1K
1806,awards,2069,25039836,80.6998839964,90,6,>1K
1807,roll,2067,25041903,80.7065456478,90,4,>1K
1808,eric,2065,25043968,80.7132008536,90,4,>1K
1809,email,2064,25046032,80.7198528365,90,5,>1K
1810,studies,2062,25048094,80.7264983736,90,7,>1K
1811,patient,2062,25050156,80.7331439108,90,7,>1K
1812,specific,2061,25052217,80.7397862251,90,8,>1K
1813,elementary,2061,25054278,80.7464285394,90,10,>1K
1814,fellow,2061,25056339,80.7530708537,90,6,>1K
1815,cream,2061,25058400,80.759713168,90,5,>1K
1816,century,2058,25060458,80.7663458138,90,7,>1K
1817,killing,2057,25062515,80.7729752366,90,7,>1K
1818,forest,2056,25064571,80.7796014366,90,6,>1K
1819,worse,2051,25066622,80.7862115224,90,5,>1K
1820,secretary,2048,25068670,80.7928119395,90,9,>1K
1821,expensive,2048,25070718,80.7994123566,90,9,>1K
1822,apparently,2047,25072765,80.8060095509,90,10,>1K
1823,expects,2047,25074812,80.8126067451,90,7,>1K
1824,knocked,2045,25076857,80.8191974937,90,7,>1K
1825,largely,2043,25078900,80.8257817965,90,7,>1K
1826,recovery,2042,25080942,80.8323628765,90,8,>1K
1827,spread,2042,25082984,80.8389439565,90,6,>1K
1828,musical,2041,25085025,80.8455218136,90,7,>1K
1829,suspect,2041,25087066,80.8520996707,90,7,>1K
1830,becoming,2040,25089106,80.8586743049,90,8,>1K
1831,interesting,2039,25091145,80.8652457163,90,11,>1K
1832,progress,2035,25093180,80.8718042363,90,8,>1K
1833,panel,2032,25095212,80.8783530876,90,5,>1K
1834,trading,2032,25097244,80.884901939,90,7,>1K
1835,section,2031,25099275,80.8914475675,90,7,>1K
1836,artists,2031,25101306,80.897993196,90,7,>1K
1837,payments,2030,25103336,80.9045356017,90,8,>1K
1838,owned,2027,25105363,80.9110683387,90,5,>1K
1839,responsible,2026,25107389,80.917597853,90,11,>1K
1840,plain,2026,25109415,80.9241273672,90,5,>1K
1841,vs,2022,25111437,80.9306439899,90,2,>1K
1842,google,2022,25113459,80.9371606127,90,6,>1K
1843,wilson,2022,25115481,80.9436772355,90,6,>1K
1844,related,2022,25117503,80.9501938582,90,7,>1K
1845,advance,2021,25119524,80.9567072582,90,7,>1K
1846,attacks,2020,25121544,80.9632174352,90,7,>1K
1847,2020,2020,25123564,80.9697276123,90,4,>1K
1848,ideas,2020,25125584,80.9762377893,90,5,>1K
1849,youth,2019,25127603,80.9827447435,90,5,>1K
1850,2018,2018,25129621,80.9892484748,90,4,>1K
1851,2017,2017,25131638,80.9957489833,90,4,>1K
1852,2016,2016,25133654,81.0022462689,90,4,>1K
1853,2015,2015,25135669,81.0087403317,90,4,>1K
1854,setting,2015,25137684,81.0152343944,90,7,>1K
1855,edge,2014,25139698,81.0217252343,90,4,>1K
1856,2014,2014,25141712,81.0282160742,90,4,>1K
1857,2013,2013,25143725,81.0347036912,90,4,>1K
1858,2012,2012,25145737,81.0411880854,90,4,>1K
1859,talent,2012,25147749,81.0476724796,90,6,>1K
1860,fee,2012,25149761,81.0541568737,90,3,>1K
1861,contributed,2011,25151772,81.060638045,90,11,>1K
1862,2011,2011,25153783,81.0671192164,90,4,>1K
1863,ordered,2011,25155794,81.0736003877,90,7,>1K
1864,2010,2010,25157804,81.0800783361,90,4,>1K
1865,2009,2009,25159813,81.0865530617,90,4,>1K
1866,wood,2008,25161821,81.0930245644,90,4,>1K
1867,2008,2008,25163829,81.0994960672,90,4,>1K
1868,finance,2007,25165836,81.105964347,90,7,>1K
1869,slightly,2007,25167843,81.1124326269,90,8,>1K
1870,oakland,2007,25169850,81.1189009068,90,7,>1K
1871,directly,2007,25171857,81.1253691867,90,8,>1K
1872,losses,2007,25173864,81.1318374665,90,6,>1K
1873,2007,2007,25175871,81.1383057464,90,4,>1K
1874,orlando,2007,25177878,81.1447740263,90,7,>1K
1875,andrew,2007,25179885,81.1512423061,90,6,>1K
1876,2006,2006,25181891,81.1577073632,90,4,>1K
1877,2005,2005,25183896,81.1641691973,90,4,>1K
1878,steps,2005,25185901,81.1706310315,90,5,>1K
1879,2004,2004,25187905,81.1770896428,90,4,>1K
1880,2003,2003,25189908,81.1835450312,90,4,>1K
1881,unless,2002,25191910,81.1899971968,90,6,>1K
1882,2002,2002,25193912,81.1964493623,90,4,>1K
1883,warm,2002,25195914,81.2029015279,90,4,>1K
1884,2001,2001,25197915,81.2093504706,90,4,>1K
1885,threw,2001,25199916,81.2157994133,90,5,>1K
1886,2000s,2000,25201916,81.2222451332,90,5,>1K
1887,2000,2000,25203916,81.228690853,90,4,>1K
1888,1999,1999,25205915,81.23513335,90,4,>1K
1889,attended,1998,25207913,81.2415726242,90,8,>1K
1890,1998,1998,25209911,81.2480118983,90,4,>1K
1891,sea,1998,25211909,81.2544511724,90,3,>1K
1892,ballot,1997,25213906,81.2608872237,90,6,>1K
1893,1997,1997,25215903,81.267323275,90,4,>1K
1894,considering,1997,25217900,81.2737593262,90,11,>1K
1895,1996,1996,25219896,81.2801921546,90,4,>1K
1896,fighting,1996,25221892,81.2866249831,90,8,>1K
1897,1995,1995,25223887,81.2930545886,90,4,>1K
1898,photos,1994,25225881,81.2994809713,90,6,>1K
1899,easier,1994,25227875,81.305907354,90,6,>1K
1900,1994,1994,25229869,81.3123337367,90,4,>1K
1901,pension,1993,25231862,81.3187568965,90,7,>1K
1902,familiar,1993,25233855,81.3251800563,90,8,>1K
1903,1993,1993,25235848,81.3316032162,90,4,>1K
1904,1992,1992,25237840,81.3380231532,90,4,>1K
1905,typically,1992,25239832,81.3444430901,90,9,>1K
1906,1991,1991,25241823,81.3508598042,90,4,>1K
1907,requires,1991,25243814,81.3572765184,90,8,>1K
1908,consecutive,1991,25245805,81.3636932325,90,11,>1K
1909,wins,1990,25247795,81.3701067237,90,4,>1K
1910,1990,1990,25249785,81.376520215,90,4,>1K
1911,1990s,1990,25251775,81.3829337062,90,5,>1K
1912,rice,1989,25253764,81.3893439746,90,4,>1K
1913,excited,1989,25255753,81.395754243,90,7,>1K
1914,1989,1989,25257742,81.4021645114,90,4,>1K
1915,1988,1988,25259730,81.4085715569,90,4,>1K
1916,1987,1987,25261717,81.4149753796,90,4,>1K
1917,1986,1986,25263703,81.4213759794,90,4,>1K
1918,stretch,1985,25265688,81.4277733564,90,7,>1K
1919,1985,1985,25267673,81.4341707333,90,4,>1K
1920,task,1984,25269657,81.4405648874,90,4,>1K
1921,1984,1984,25271641,81.4469590415,90,4,>1K
1922,determined,1983,25273624,81.4533499727,90,10,>1K
1923,1983,1983,25275607,81.459740904,90,4,>1K
1924,1982,1982,25277589,81.4661286124,90,4,>1K
1925,1981,1981,25279570,81.4725130979,90,4,>1K
1926,aid,1980,25281550,81.4788943605,90,3,>1K
1927,1980s,1980,25283530,81.4852756232,90,5,>1K
1928,1980,1980,25285510,81.4916568858,90,4,>1K
1929,1979,1979,25287489,81.4980349256,90,4,>1K
1930,1978,1978,25289467,81.5044097426,90,4,>1K
1931,eastern,1978,25291445,81.5107845595,90,7,>1K
1932,doctor,1977,25293422,81.5171561536,90,6,>1K
1933,1977,1977,25295399,81.5235277476,90,4,>1K
1934,1976,1976,25297375,81.5298961188,90,4,>1K
1935,rising,1976,25299351,81.5362644901,90,6,>1K
1936,meat,1975,25301326,81.5426296384,90,4,>1K
1937,1975,1975,25303301,81.5489947868,90,4,>1K
1938,longtime,1975,25305276,81.5553599351,90,8,>1K
1939,1974,1974,25307250,81.5617218606,90,4,>1K
1940,songs,1973,25309223,81.5680805632,90,5,>1K
1941,1973,1973,25311196,81.5744392659,90,4,>1K
1942,loan,1973,25313169,81.5807979685,90,4,>1K
1943,1972,1972,25315141,81.5871534483,90,4,>1K
1944,broken,1972,25317113,81.5935089281,90,6,>1K
1945,opportunities,1972,25319085,81.5998644078,90,13,>1K
1946,1971,1971,25321056,81.6062166648,90,4,>1K
1947,1970s,1970,25323026,81.6125656988,90,5,>1K
1948,aside,1970,25324996,81.6189147329,90,5,>1K
1949,1970,1970,25326966,81.6252637669,90,4,>1K
1950,1969,1969,25328935,81.6316095781,90,4,>1K
1951,dream,1968,25330903,81.6379521664,90,5,>1K
1952,1968,1968,25332871,81.6442947548,90,4,>1K
1953,policies,1967,25334838,81.6506341203,90,8,>1K
1954,1967,1967,25336805,81.6569734857,90,4,>1K
1955,covered,1967,25338772,81.6633128512,90,7,>1K
1956,1966,1966,25340738,81.6696489938,90,4,>1K
1957,1965,1965,25342703,81.6759819136,90,4,>1K
1958,closing,1965,25344668,81.6823148333,90,7,>1K
1959,1964,1964,25346632,81.6886445302,90,4,>1K
1960,1963,1963,25348595,81.6949710043,90,4,>1K
1961,entertainment,1962,25350557,81.7012942554,90,13,>1K
1962,1962,1962,25352519,81.7076175066,90,4,>1K
1963,seventh,1961,25354480,81.7139375349,90,7,>1K
1964,comfortable,1961,25356441,81.7202575632,90,11,>1K
1965,1961,1961,25358402,81.7265775915,90,4,>1K
1966,alleged,1960,25360362,81.732894397,90,7,>1K
1967,surprised,1960,25362322,81.7392112025,90,9,>1K
1968,1960s,1960,25364282,81.7455280079,90,5,>1K
1969,1960,1960,25366242,81.7518448134,90,4,>1K
1970,1959,1959,25368201,81.758158396,90,4,>1K
1971,minute,1958,25370159,81.7644687557,90,6,>1K
1972,fully,1958,25372117,81.7707791154,90,5,>1K
1973,1958,1958,25374075,81.7770894752,90,4,>1K
1974,1957,1957,25376032,81.783396612,90,4,>1K
1975,1956,1956,25377988,81.7897005261,90,4,>1K
1976,nor,1956,25379944,81.7960044401,90,3,>1K
1977,catholic,1956,25381900,81.8023083541,90,8,>1K
1978,1955,1955,25383855,81.8086090452,90,4,>1K
1979,twitter,1955,25385810,81.8149097364,90,7,>1K
1980,1954,1954,25387764,81.8212072047,90,4,>1K
1981,1953,1953,25389717,81.8275014501,90,4,>1K
1982,jose,1953,25391670,81.8337956956,90,4,>1K
1983,remained,1952,25393622,81.8400867181,90,8,>1K
1984,franchise,1952,25395574,81.8463777407,90,9,>1K
1985,album,1952,25397526,81.8526687633,90,5,>1K
1986,1952,1952,25399478,81.8589597859,90,4,>1K
1987,completely,1951,25401429,81.8652475856,90,10,>1K
1988,1951,1951,25403380,81.8715353853,90,4,>1K
1989,1950s,1950,25405330,81.8778199621,90,5,>1K
1990,1950,1950,25407280,81.884104539,90,4,>1K
1991,1949,1949,25409229,81.890385893,90,4,>1K
1992,1948,1948,25411177,81.8966640241,90,4,>1K
1993,minor,1948,25413125,81.9029421553,90,5,>1K
1994,1947,1947,25415072,81.9092170635,90,4,>1K
1995,1946,1946,25417018,81.915488749,90,4,>1K
1996,1945,1945,25418963,81.9217572115,90,4,>1K
1997,democrat,1945,25420908,81.9280256741,90,8,>1K
1998,1944,1944,25422852,81.9342909138,90,4,>1K
1999,1942,1942,25424794,81.9405497077,90,4,>1K
2000,1941,1941,25426735,81.9468052789,90,4,>1K
2001,1940s,1940,25428675,81.9530576271,90,5,>1K
2002,afghanistan,1940,25430615,81.9593099754,90,11,>1K
2003,indiana,1940,25432555,81.9655623236,90,7,>1K
2004,1940,1940,25434495,81.9718146719,90,4,>1K
2005,cuyahoga,1939,25436434,81.9780637973,90,8,>1K
2006,develop,1939,25438373,81.9843129227,90,7,>1K
2007,1939,1939,25440312,81.9905620481,90,4,>1K
2008,1938,1938,25442250,81.9968079506,90,4,>1K
2009,feature,1938,25444188,82.0030538532,90,7,>1K
2010,1937,1937,25446125,82.0092965328,90,4,>1K
2011,1936,1936,25448061,82.0155359896,90,4,>1K
2012,particular,1936,25449997,82.0217754465,90,10,>1K
2013,1935,1935,25451932,82.0280116804,90,4,>1K
2014,leads,1934,25453866,82.0342446915,90,5,>1K
2015,1933,1933,25455799,82.0404744798,90,4,>1K
2016,drove,1933,25457732,82.046704268,90,5,>1K
2017,border,1931,25459663,82.0529276105,90,6,>1K
2018,stood,1930,25461593,82.0591477302,90,5,>1K
2019,opponents,1930,25463523,82.0653678498,90,9,>1K
2020,1930s,1930,25465453,82.0715879695,90,5,>1K
2021,seek,1930,25467383,82.0778080891,90,4,>1K
2022,virginia,1930,25469313,82.0840282088,90,8,>1K
2023,pro,1929,25471242,82.0902451056,90,3,>1K
2024,pushed,1929,25473171,82.0964620024,90,6,>1K
2025,touch,1929,25475100,82.1026788992,90,5,>1K
2026,1929,1929,25477029,82.108895796,90,4,>1K
2027,pop,1929,25478958,82.1151126928,90,3,>1K
2028,buying,1928,25480886,82.1213263667,90,6,>1K
2029,secret,1928,25482814,82.1275400407,90,6,>1K
2030,license,1928,25484742,82.1337537146,90,7,>1K
2031,forces,1927,25486669,82.1399641657,90,6,>1K
2032,entered,1926,25488595,82.1461713939,90,7,>1K
2033,animal,1924,25490519,82.1523721764,90,6,>1K
2034,write,1924,25492443,82.1585729589,90,5,>1K
2035,turning,1924,25494367,82.1647737414,90,7,>1K
2036,ends,1923,25496290,82.170971301,90,4,>1K
2037,lawyers,1923,25498213,82.1771688607,90,7,>1K
2038,writer,1923,25500136,82.1833664203,90,6,>1K
2039,sites,1923,25502059,82.1895639799,90,5,>1K
2040,jason,1922,25503981,82.1957583167,90,5,>1K
2041,receiver,1920,25505901,82.2019462078,90,8,>1K
2042,1920s,1920,25507821,82.2081340988,90,5,>1K
2043,salary,1919,25509740,82.214318767,90,6,>1K
2044,thinks,1918,25511658,82.2205002124,90,6,>1K
2045,draw,1918,25513576,82.2266816577,90,4,>1K
2046,watched,1917,25515493,82.2328598802,90,7,>1K
2047,limit,1916,25517409,82.2390348798,90,5,>1K
2048,guests,1916,25519325,82.2452098794,90,6,>1K
2049,located,1916,25521241,82.251384879,90,7,>1K
2050,shopping,1915,25523156,82.2575566558,90,8,>1K
2051,arena,1914,25525070,82.2637252097,90,5,>1K
2052,facilities,1913,25526983,82.2698905407,90,10,>1K
2053,1912,1912,25528895,82.2760526489,90,4,>1K
2054,auto,1911,25530806,82.2822115342,90,4,>1K
2055,1910,1910,25532716,82.2883671967,90,4,>1K
2056,deputy,1907,25534623,82.2945131906,90,6,>1K
2057,rooms,1906,25536529,82.3006559616,90,5,>1K
2058,1906,1906,25538435,82.3067987326,90,4,>1K
2059,retail,1903,25540338,82.312931835,90,6,>1K
2060,concert,1903,25542241,82.3190649375,90,7,>1K
2061,1900,1900,25544141,82.3251883713,90,4,>1K
2062,measures,1899,25546040,82.3313085823,90,8,>1K
2063,positions,1899,25547939,82.3374287933,90,9,>1K
2064,replace,1898,25549837,82.3435457815,90,7,>1K
2065,thompson,1896,25551733,82.3496563239,90,8,>1K
2066,ultimately,1896,25553629,82.3557668663,90,10,>1K
2067,elections,1894,25555523,82.361870963,90,9,>1K
2068,faith,1893,25557416,82.3679718368,90,5,>1K
2069,yourself,1892,25559308,82.3740694878,90,8,>1K
2070,agents,1891,25561199,82.3801639159,90,6,>1K
2071,artist,1889,25563088,82.3862518983,90,6,>1K
2072,british,1889,25564977,82.3923398807,90,7,>1K
2073,fear,1889,25566866,82.3984278631,90,4,>1K
2074,marijuana,1888,25568754,82.4045126227,90,9,>1K
2075,drivers,1888,25570642,82.4105973822,90,7,>1K
2076,speaking,1886,25572528,82.416675696,90,8,>1K
2077,newspaper,1885,25574413,82.422750787,90,9,>1K
2078,tells,1884,25576297,82.4288226551,90,5,>1K
2079,respect,1883,25578180,82.4348913003,90,7,>1K
2080,dining,1882,25580062,82.4409567227,90,6,>1K
2081,rutgers,1879,25581941,82.4470124765,90,7,>1K
2082,accident,1879,25583820,82.4530682303,90,8,>1K
2083,effective,1878,25585698,82.4591207613,90,9,>1K
2084,master,1878,25587576,82.4651732922,90,6,>1K
2085,package,1876,25589452,82.4712193774,90,7,>1K
2086,uses,1874,25591326,82.4772590169,90,4,>1K
2087,prime,1874,25593200,82.4832986564,90,5,>1K
2088,rain,1873,25595073,82.4893350731,90,4,>1K
2089,foot,1871,25596944,82.495365044,90,4,>1K
2090,deficit,1870,25598814,82.5013917921,90,7,>1K
2091,appearance,1869,25600683,82.5074153173,90,10,>1K
2092,roughly,1867,25602550,82.5134323967,90,7,>1K
2093,soccer,1866,25604416,82.5194462534,90,6,>1K
2094,favor,1863,25606279,82.5254504414,90,5,>1K
2095,veterans,1862,25608141,82.5314514066,90,8,>1K
2096,crash,1862,25610003,82.5374523718,90,5,>1K
2097,aug,1861,25611864,82.5434501141,90,3,>1K
2098,pace,1861,25613725,82.5494478564,90,4,>1K
2099,providing,1860,25615585,82.5554423759,90,9,>1K
2100,rams,1859,25617444,82.5614336725,90,4,>1K
2101,generally,1859,25619303,82.5674249691,90,9,>1K
2102,smart,1858,25621161,82.5734130428,90,5,>1K
2103,jack,1857,25623018,82.5793978937,90,4,>1K
2104,gift,1856,25624874,82.5853795217,90,4,>1K
2105,cooking,1856,25626730,82.5913611498,90,7,>1K
2106,headed,1854,25628584,82.5973363321,90,6,>1K
2107,purchase,1850,25630434,82.6032986229,90,8,>1K
2108,occurred,1849,25632283,82.6092576909,90,8,>1K
2109,grade,1848,25634131,82.6152135361,90,5,>1K
2110,seattle,1847,25635978,82.6211661583,90,7,>1K
2111,gain,1847,25637825,82.6271187806,90,4,>1K
2112,attorneys,1846,25639671,82.6330681801,90,9,>1K
2113,talks,1846,25641517,82.6390175795,90,5,>1K
2114,produced,1844,25643361,82.6449605332,90,8,>1K
2115,lewis,1844,25645205,82.6509034869,90,5,>1K
2116,patrick,1844,25647049,82.6568464406,90,7,>1K
2117,strike,1843,25648892,82.6627861714,90,6,>1K
2118,domestic,1842,25650734,82.6687226794,90,8,>1K
2119,bringing,1841,25652575,82.6746559645,90,8,>1K
2120,dimora,1841,25654416,82.6805892497,90,6,>1K
2121,solid,1841,25656257,82.6865225348,90,5,>1K
2122,proud,1841,25658098,82.6924558199,90,5,>1K
2123,counts,1839,25659937,82.6983826593,90,6,>1K
2124,ages,1839,25661776,82.7043094987,90,4,>1K
2125,legislative,1838,25663614,82.7102331153,90,11,>1K
2126,japan,1838,25665452,82.7161567318,90,5,>1K
2127,compete,1838,25667290,82.7220803483,90,7,>1K
2128,path,1838,25669128,82.7280039649,90,4,>1K
2129,drink,1837,25670965,82.7339243586,90,5,>1K
2130,strategy,1832,25672797,82.739828638,90,8,>1K
2131,failure,1830,25674627,82.7457264716,90,7,>1K
2132,nobody,1830,25676457,82.7516243053,90,6,>1K
2133,cutting,1829,25678286,82.7575189161,90,7,>1K
2134,direction,1829,25680115,82.7634135269,90,9,>1K
2135,harris,1828,25681943,82.7693049148,90,6,>1K
2136,raising,1828,25683771,82.7751963028,90,7,>1K
2137,poll,1827,25685598,82.7810844679,90,4,>1K
2138,hey,1826,25687424,82.7869694101,90,3,>1K
2139,tests,1825,25689249,82.7928511295,90,5,>1K
2140,deals,1824,25691073,82.798729626,90,5,>1K
2141,movies,1823,25692896,82.8046048996,90,6,>1K
2142,stands,1822,25694718,82.8104769504,90,6,>1K
2143,ensure,1821,25696539,82.8163457783,90,6,>1K
2144,hollywood,1820,25698359,82.8222113834,90,9,>1K
2145,doubt,1820,25700179,82.8280769885,90,5,>1K
2146,anderson,1820,25701999,82.8339425935,90,8,>1K
2147,knee,1815,25703814,82.8397920843,90,4,>1K
2148,admitted,1815,25705629,82.845641575,90,8,>1K
2149,casino,1813,25707442,82.8514846201,90,6,>1K
2150,port,1813,25709255,82.8573276651,90,4,>1K
2151,brand,1812,25711067,82.8631674873,90,5,>1K
2152,developed,1812,25712879,82.8690073095,90,9,>1K
2153,published,1811,25714690,82.8748439088,90,9,>1K
2154,nuclear,1810,25716500,82.8806772853,90,7,>1K
2155,fashion,1808,25718308,82.886504216,90,7,>1K
2156,tea,1807,25720115,82.8923279239,90,3,>1K
2157,degrees,1806,25721921,82.898148409,90,7,>1K
2158,brings,1805,25723726,82.9039656711,90,6,>1K
2159,scores,1805,25725531,82.9097829333,90,6,>1K
2160,columbia,1803,25727334,82.9155937497,90,8,>1K
2161,alcohol,1803,25729137,82.9214045662,90,7,>1K
2162,powerful,1802,25730939,82.9272121598,90,8,>1K
2163,electric,1802,25732741,82.9330197534,90,8,>1K
2164,presented,1800,25734541,82.9388209012,90,9,>1K
2165,1800s,1800,25736341,82.9446220491,90,5,>1K
2166,struggling,1800,25738141,82.950423197,90,10,>1K
2167,challenges,1799,25739940,82.956221122,90,10,>1K
2168,hair,1797,25741737,82.9620126013,90,4,>1K
2169,penalty,1796,25743533,82.9678008577,90,7,>1K
2170,grown,1796,25745329,82.9735891141,90,5,>1K
2171,nonprofit,1796,25747125,82.9793773705,90,9,>1K
2172,trenton,1794,25748919,82.9851591812,90,7,>1K
2173,threat,1794,25750713,82.9909409919,90,6,>1K
2174,taxpayers,1793,25752506,82.9967195798,90,9,>1K
2175,reserve,1793,25754299,83.0024981676,90,7,>1K
2176,highly,1791,25756090,83.0082703098,90,6,>1K
2177,pull,1788,25757878,83.0140327833,90,4,>1K
2178,france,1787,25759665,83.019792034,90,6,>1K
2179,dry,1786,25761451,83.0255480618,90,3,>1K
2180,organizations,1784,25763235,83.0312976439,90,13,>1K
2181,except,1784,25765019,83.037047226,90,6,>1K
2182,crew,1783,25766802,83.0427935853,90,4,>1K
2183,presence,1783,25768585,83.0485399445,90,8,>1K
2184,tigers,1782,25770367,83.0542830809,90,6,>1K
2185,somebody,1780,25772147,83.0600197716,90,8,>1K
2186,hiring,1779,25773926,83.0657532394,90,6,>1K
2187,dishes,1779,25775705,83.0714867072,90,6,>1K
2188,metro,1779,25777484,83.077220175,90,5,>1K
2189,rare,1778,25779262,83.08295042,90,4,>1K
2190,iowa,1778,25781040,83.0886806649,90,4,>1K
2191,famous,1777,25782817,83.094407687,90,6,>1K
2192,screen,1773,25784590,83.1001218177,90,6,>1K
2193,brothers,1772,25786362,83.1058327254,90,8,>1K
2194,rookie,1771,25788133,83.1115404104,90,6,>1K
2195,photo,1771,25789904,83.1172480953,90,5,>1K
2196,dealer,1770,25791674,83.1229525574,90,6,>1K
2197,unique,1769,25793443,83.1286537966,90,6,>1K
2198,firefighters,1767,25795210,83.1343485901,90,12,>1K
2199,herself,1767,25796977,83.1400433836,90,7,>1K
2200,fbi,1767,25798744,83.1457381771,90,3,>1K
2201,connection,1767,25800511,83.1514329705,90,10,>1K
2202,peace,1767,25802278,83.157127764,90,5,>1K
2203,actions,1767,25804045,83.1628225575,90,7,>1K
2204,shared,1763,25805808,83.1685044596,90,6,>1K
2205,introduced,1763,25807571,83.1741863616,90,10,>1K
2206,adult,1763,25809334,83.1798682637,90,5,>1K
2207,mortgage,1762,25811096,83.1855469429,90,8,>1K
2208,kill,1760,25812856,83.1912191763,90,4,>1K
2209,window,1760,25814616,83.1968914098,90,6,>1K
2210,pleaded,1760,25816376,83.2025636433,90,7,>1K
2211,fruit,1759,25818135,83.2082326539,90,5,>1K
2212,active,1759,25819894,83.2139016645,90,6,>1K
2213,contest,1758,25821652,83.2195674522,90,7,>1K
2214,conversation,1758,25823410,83.22523324,90,12,>1K
2215,dad,1758,25825168,83.2308990277,90,3,>1K
2216,hudson,1757,25826925,83.2365615926,90,6,>1K
2217,critics,1757,25828682,83.2422241575,90,7,>1K
2218,sought,1756,25830438,83.2478834995,90,6,>1K
2219,removed,1756,25832194,83.2535428416,90,7,>1K
2220,author,1754,25833948,83.2591957379,90,6,>1K
2221,moves,1754,25835702,83.2648486342,90,5,>1K
2222,ducks,1753,25837455,83.2704983076,90,5,>1K
2223,tackle,1752,25839207,83.2761447582,90,6,>1K
2224,individuals,1751,25840958,83.281787986,90,11,>1K
2225,strength,1749,25842707,83.287424768,90,8,>1K
2226,discovered,1748,25844455,83.2930583271,90,10,>1K
2227,bears,1748,25846203,83.2986918863,90,5,>1K
2228,moments,1746,25847949,83.3043189997,90,7,>1K
2229,dozens,1745,25849694,83.3099428903,90,6,>1K
2230,tight,1741,25851435,83.3155538894,90,5,>1K
2231,otherwise,1741,25853176,83.3211648885,90,9,>1K
2232,lakers,1740,25854916,83.3267726648,90,6,>1K
2233,sources,1738,25856654,83.3323739954,90,7,>1K
2234,worried,1738,25858392,83.3379753259,90,7,>1K
2235,sport,1738,25860130,83.3435766565,90,5,>1K
2236,confirmed,1738,25861868,83.349177987,90,9,>1K
2237,operation,1736,25863604,83.3547728718,90,9,>1K
2238,suspended,1735,25865339,83.3603645338,90,9,>1K
2239,african,1734,25867073,83.3659529729,90,7,>1K
2240,becomes,1734,25868807,83.371541412,90,7,>1K
2241,amazing,1733,25870540,83.3771266283,90,7,>1K
2242,mental,1731,25872271,83.3827053988,90,6,>1K
2243,dangerous,1730,25874001,83.3882809465,90,9,>1K
2244,normal,1730,25875731,83.3938564942,90,6,>1K
2245,partners,1730,25877461,83.3994320418,90,8,>1K
2246,launched,1730,25879191,83.4050075895,90,8,>1K
2247,magic,1729,25880920,83.4105799143,90,5,>1K
2248,gotten,1729,25882649,83.4161522391,90,6,>1K
2249,offices,1729,25884378,83.4217245639,90,7,>1K
2250,houses,1728,25886106,83.4272936659,90,6,>1K
2251,imagine,1725,25887831,83.4328530993,90,7,>1K
2252,giant,1724,25889555,83.4384093098,90,5,>1K
2253,perform,1724,25891279,83.4439655203,90,7,>1K
2254,religious,1724,25893003,83.4495217308,90,9,>1K
2255,shortly,1723,25894726,83.4550747185,90,7,>1K
2256,existing,1721,25896447,83.4606212604,90,8,>1K
2257,responsibility,1720,25898167,83.4661645795,90,14,>1K
2258,beef,1719,25899886,83.4717046757,90,4,>1K
2259,shut,1717,25901603,83.4772383262,90,4,>1K
2260,columbus,1717,25903320,83.4827719767,90,8,>1K
2261,allegations,1715,25905035,83.4882991814,90,11,>1K
2262,clinic,1714,25906749,83.4938231634,90,6,>1K
2263,shown,1713,25908462,83.4993439224,90,5,>1K
2264,speaker,1712,25910174,83.5048614586,90,7,>1K
2265,savings,1706,25911880,83.5103596576,90,7,>1K
2266,pepper,1706,25913586,83.5158578567,90,6,>1K
2267,behavior,1704,25915290,83.52134961,90,8,>1K
2268,chocolate,1704,25916994,83.5268413633,90,9,>1K
2269,treated,1702,25918696,83.5323266709,90,7,>1K
2270,starter,1700,25920396,83.5378055328,90,7,>1K
2271,wonder,1700,25922096,83.5432843946,90,6,>1K
2272,folks,1700,25923796,83.5487632565,90,5,>1K
2273,handle,1695,25925491,83.5542260041,90,6,>1K
2274,manufacturing,1695,25927186,83.5596887517,90,13,>1K
2275,ocean,1695,25928881,83.5651514992,90,5,>1K
2276,england,1694,25930575,83.5706110239,90,7,>1K
2277,principal,1694,25932269,83.5760705487,90,9,>1K
2278,ok,1693,25933962,83.5815268505,90,2,>1K
2279,bag,1692,25935654,83.5869799295,90,3,>1K
2280,nick,1691,25937345,83.5924297856,90,4,>1K
2281,respond,1689,25939034,83.5978731961,90,7,>1K
2282,denied,1689,25940723,83.6033166065,90,6,>1K
2283,graduate,1688,25942411,83.608756794,90,8,>1K
2284,unions,1688,25944099,83.6141969816,90,6,>1K
2285,wines,1687,25945786,83.6196339463,90,5,>1K
2286,windows,1686,25947472,83.6250676881,90,7,>1K
2287,alex,1686,25949158,83.63050143,90,4,>1K
2288,index,1686,25950844,83.6359351718,90,5,>1K
2289,bush,1686,25952530,83.6413689136,90,4,>1K
2290,bankruptcy,1685,25954215,83.6467994326,90,10,>1K
2291,initial,1682,25955897,83.652220283,90,7,>1K
2292,immigrants,1680,25957577,83.6576346877,90,10,>1K
2293,commitment,1679,25959256,83.6630458695,90,10,>1K
2294,transit,1679,25960935,83.6684570513,90,7,>1K
2295,pacific,1679,25962614,83.6738682331,90,7,>1K
2296,bid,1678,25964292,83.6792761921,90,3,>1K
2297,voting,1677,25965969,83.6846809282,90,6,>1K
2298,magazine,1677,25967646,83.6900856643,90,8,>1K
2299,yesterday,1675,25969321,83.6954839546,90,9,>1K
2300,snow,1674,25970995,83.7008790222,90,4,>1K
2301,dave,1671,25972666,83.7062644211,90,4,>1K
2302,row,1670,25974336,83.7116465972,90,3,>1K
2303,racing,1667,25976003,83.7170191047,90,6,>1K
2304,allegedly,1667,25977670,83.7223916122,90,9,>1K
2305,possibly,1665,25979335,83.7277576739,90,8,>1K
2306,storm,1664,25980999,83.7331205129,90,5,>1K
2307,faced,1664,25982663,83.7384833518,90,5,>1K
2308,practices,1664,25984327,83.7438461907,90,9,>1K
2309,greatest,1663,25985990,83.7492058067,90,8,>1K
2310,ii,1662,25987652,83.7545621999,90,2,>1K
2311,argued,1662,25989314,83.7599185931,90,6,>1K
2312,northwest,1660,25990974,83.7652685406,90,9,>1K
2313,returns,1660,25992634,83.7706184881,90,7,>1K
2314,opposition,1659,25994293,83.7759652127,90,10,>1K
2315,clark,1658,25995951,83.7813087145,90,5,>1K
2316,arm,1658,25997609,83.7866522162,90,3,>1K
2317,listed,1657,25999266,83.7919924951,90,6,>1K
2318,gingrich,1657,26000923,83.797332774,90,8,>1K
2319,selection,1656,26002579,83.8026698301,90,9,>1K
2320,improved,1656,26004235,83.8080068861,90,8,>1K
2321,inches,1656,26005891,83.8133439421,90,6,>1K
2322,animals,1655,26007546,83.8186777753,90,7,>1K
2323,pointed,1654,26009200,83.8240083856,90,7,>1K
2324,doors,1653,26010853,83.8293357731,90,5,>1K
2325,horse,1651,26012504,83.8346567148,90,5,>1K
2326,fox,1649,26014153,83.8399712108,90,3,>1K
2327,aware,1648,26015801,83.845282484,90,5,>1K
2328,wear,1648,26017449,83.8505937572,90,4,>1K
2329,earnings,1647,26019096,83.8559018075,90,8,>1K
2330,fame,1646,26020742,83.8612066349,90,4,>1K
2331,brain,1645,26022387,83.8665082395,90,5,>1K
2332,sleep,1644,26024031,83.8718066212,90,5,>1K
2333,woods,1644,26025675,83.8771050029,90,5,>1K
2334,boost,1644,26027319,83.8824033846,90,5,>1K
2335,serves,1641,26028960,83.8876920978,90,6,>1K
2336,prior,1640,26030600,83.892977588,90,5,>1K
2337,edwards,1639,26032239,83.8982598555,90,7,>1K
2338,acknowledged,1637,26033876,83.9035356772,90,12,>1K
2339,italian,1636,26035512,83.908808276,90,7,>1K
2340,sounds,1636,26037148,83.9140808748,90,6,>1K
2341,owns,1634,26038782,83.919347028,90,4,>1K
2342,refused,1634,26040416,83.9246131811,90,7,>1K
2343,acting,1633,26042049,83.9298761113,90,6,>1K
2344,welcome,1631,26043680,83.9351325959,90,7,>1K
2345,fly,1630,26045310,83.9403858575,90,3,>1K
2346,oh,1630,26046940,83.9456391192,90,2,>1K
2347,worry,1629,26048569,83.950889158,90,5,>1K
2348,industrial,1625,26050194,83.9561263054,90,10,>1K
2349,characters,1625,26051819,83.9613634528,90,10,>1K
2350,claimed,1624,26053443,83.9665973773,90,7,>1K
2351,female,1624,26055067,83.9718313018,90,6,>1K
2352,superintendent,1623,26056690,83.9770620035,90,14,>1K
2353,clients,1623,26058313,83.9822927052,90,7,>1K
2354,possession,1623,26059936,83.9875234068,90,10,>1K
2355,involving,1622,26061558,83.9927508856,90,9,>1K
2356,jordan,1622,26063180,83.9979783644,90,6,>1K
2357,opinion,1621,26064801,84.0032026204,90,7,>1K
2358,bed,1620,26066421,84.0084236534,90,3,>1K
2359,thank,1619,26068040,84.0136414637,90,5,>1K
2360,influence,1619,26069659,84.0188592739,90,9,>1K
2361,hospitals,1618,26071277,84.0240738612,90,9,>1K
2362,robinson,1615,26072892,84.02927878,90,8,>1K
2363,atlantic,1614,26074506,84.0344804759,90,8,>1K
2364,heads,1610,26076116,84.0396692804,90,5,>1K
2365,neighbors,1609,26077725,84.044854862,90,9,>1K
2366,discussion,1608,26079333,84.0500372208,90,10,>1K
2367,prove,1607,26080940,84.0552163567,90,5,>1K
2368,represents,1607,26082547,84.0603954926,90,10,>1K
2369,medicine,1607,26084154,84.0655746285,90,8,>1K
2370,receiving,1606,26085760,84.0707505416,90,9,>1K
2371,cap,1606,26087366,84.0759264546,90,3,>1K
2372,bright,1606,26088972,84.0811023676,90,6,>1K
2373,broncos,1606,26090578,84.0862782807,90,7,>1K
2374,films,1604,26092182,84.091447748,90,5,>1K
2375,chances,1602,26093784,84.0966107696,90,7,>1K
2376,brandon,1602,26095386,84.1017737912,90,7,>1K
2377,performed,1602,26096988,84.1069368128,90,9,>1K
2378,realize,1599,26098587,84.1120901658,90,7,>1K
2379,accounts,1599,26100186,84.1172435188,90,8,>1K
2380,theatre,1599,26101785,84.1223968719,90,7,>1K
2381,web,1598,26103383,84.127547002,90,3,>1K
2382,file,1598,26104981,84.1326971322,90,4,>1K
2383,bench,1597,26106578,84.1378440395,90,5,>1K
2384,announcement,1595,26108173,84.1429845011,90,12,>1K
2385,falls,1595,26109768,84.1481249627,90,5,>1K
2386,profit,1592,26111360,84.1532557557,90,6,>1K
2387,shouldn,1592,26112952,84.1583865487,90,7,>1K
2388,hole,1592,26114544,84.1635173417,90,4,>1K
2389,coaching,1589,26116133,84.1686384661,90,8,>1K
2390,ninth,1588,26117721,84.1737563676,90,5,>1K
2391,testified,1588,26119309,84.1788742692,90,9,>1K
2392,shift,1587,26120896,84.1839889479,90,5,>1K
2393,please,1587,26122483,84.1891036266,90,6,>1K
2394,register,1586,26124069,84.1942150825,90,8,>1K
2395,managed,1583,26125652,84.1993168697,90,7,>1K
2396,bear,1583,26127235,84.204418657,90,4,>1K
2397,reporter,1582,26128817,84.2095172214,90,8,>1K
2398,stocks,1582,26130399,84.2146157858,90,6,>1K
2399,eighth,1581,26131980,84.2197111273,90,6,>1K
2400,roster,1581,26133561,84.2248064689,90,6,>1K
2401,kasich,1576,26135137,84.2298856961,90,6,>1K
2402,nationwide,1575,26136712,84.2349617005,90,10,>1K
2403,supply,1574,26138286,84.240034482,90,6,>1K
2404,judges,1574,26139860,84.2451072635,90,6,>1K
2405,breakfast,1573,26141433,84.2501768222,90,9,>1K
2406,stolen,1570,26143003,84.2552367123,90,6,>1K
2407,airlines,1570,26144573,84.2602966024,90,8,>1K
2408,directed,1570,26146143,84.2653564925,90,8,>1K
2409,daniel,1568,26147711,84.2704099368,90,6,>1K
2410,stayed,1567,26149278,84.2754601583,90,6,>1K
2411,mile,1563,26150841,84.2804974884,90,4,>1K
2412,generation,1563,26152404,84.2855348185,90,10,>1K
2413,mexican,1562,26153966,84.2905689257,90,7,>1K
2414,stephen,1562,26155528,84.2956030329,90,7,>1K
2415,wish,1559,26157087,84.3006274715,90,4,>1K
2416,executives,1559,26158646,84.3056519101,90,10,>1K
2417,possibility,1559,26160205,84.3106763487,90,11,>1K
2418,walls,1558,26161763,84.3156975645,90,5,>1K
2419,sophomore,1557,26163320,84.3207155574,90,9,>1K
2420,singer,1555,26164875,84.3257271046,90,6,>1K
2421,confident,1554,26166429,84.3307354289,90,9,>1K
2422,direct,1554,26167983,84.3357437532,90,6,>1K
2423,teammates,1554,26169537,84.3407520776,90,9,>1K
2424,views,1553,26171090,84.345757179,90,5,>1K
2425,pushing,1552,26172642,84.3507590576,90,7,>1K
2426,display,1552,26174194,84.3557609362,90,7,>1K
2427,advice,1551,26175745,84.360759592,90,6,>1K
2428,dish,1551,26177296,84.3657582477,90,4,>1K
2429,alternative,1551,26178847,84.3707569035,90,11,>1K
2430,keeps,1551,26180398,84.3757555592,90,5,>1K
2431,accepted,1550,26181948,84.3807509921,90,8,>1K
2432,luck,1550,26183498,84.385746425,90,4,>1K
2433,notice,1549,26185047,84.390738635,90,6,>1K
2434,freedom,1548,26186595,84.3957276222,90,7,>1K
2435,summit,1548,26188143,84.4007166094,90,6,>1K
2436,material,1547,26189690,84.4057023737,90,8,>1K
2437,choices,1547,26191237,84.410688138,90,7,>1K
2438,decline,1547,26192784,84.4156739023,90,7,>1K
2439,studio,1546,26194330,84.4206564437,90,6,>1K
2440,afford,1546,26195876,84.4256389852,90,6,>1K
2441,picks,1546,26197422,84.4306215266,90,5,>1K
2442,selected,1545,26198967,84.4356008452,90,8,>1K
2443,academic,1539,26200506,84.4405608266,90,8,>1K
2444,changing,1538,26202044,84.4455175852,90,8,>1K
2445,spots,1537,26203581,84.4504711209,90,5,>1K
2446,kings,1537,26205118,84.4554246566,90,5,>1K
2447,jazz,1536,26206654,84.4603749694,90,4,>1K
2448,salad,1536,26208190,84.4653252823,90,5,>1K
2449,returning,1536,26209726,84.4702755951,90,9,>1K
2450,via,1535,26211261,84.4752226851,90,3,>1K
2451,employers,1532,26212793,84.4801601065,90,9,>1K
2452,rating,1531,26214324,84.4850943051,90,6,>1K
2453,expand,1530,26215854,84.4900252808,90,6,>1K
2454,actor,1529,26217383,84.4949530336,90,5,>1K
2455,kennedy,1528,26218911,84.4998775636,90,7,>1K
2456,employment,1527,26220438,84.5047988707,90,10,>1K
2457,truth,1527,26221965,84.5097201778,90,5,>1K
2458,creative,1527,26223492,84.5146414849,90,8,>1K
2459,streak,1526,26225018,84.5195595691,90,6,>1K
2460,cell,1526,26226544,84.5244776534,90,4,>1K
2461,chose,1524,26228068,84.5293892919,90,5,>1K
2462,dallas,1524,26229592,84.5343009304,90,6,>1K
2463,truly,1522,26231114,84.5392061232,90,5,>1K
2464,bruce,1522,26232636,84.544111316,90,5,>1K
2465,southwest,1522,26234158,84.5490165088,90,9,>1K
2466,wonderful,1521,26235679,84.5539184788,90,9,>1K
2467,outdoor,1520,26237199,84.5588172259,90,7,>1K
2468,earth,1519,26238718,84.5637127501,90,5,>1K
2469,initially,1519,26240237,84.5686082743,90,9,>1K
2470,teaching,1518,26241755,84.5735005757,90,8,>1K
2471,accept,1518,26243273,84.5783928771,90,6,>1K
2472,noon,1517,26244790,84.5832819556,90,4,>1K
2473,greg,1516,26246306,84.5881678112,90,4,>1K
2474,indianapolis,1515,26247821,84.593050444,90,12,>1K
2475,conduct,1515,26249336,84.5979330768,90,7,>1K
2476,hadn,1514,26250850,84.6028124867,90,4,>1K
2477,gary,1514,26252364,84.6076918967,90,4,>1K
2478,camera,1512,26253876,84.6125648609,90,6,>1K
2479,testing,1512,26255388,84.6174378251,90,7,>1K
2480,basic,1511,26256899,84.6223075664,90,5,>1K
2481,ban,1511,26258410,84.6271773078,90,3,>1K
2482,olympic,1510,26259920,84.6320438263,90,7,>1K
2483,publicly,1509,26261429,84.6369071219,90,8,>1K
2484,foods,1509,26262938,84.6417704175,90,5,>1K
2485,featured,1509,26264447,84.6466337131,90,8,>1K
2486,superior,1509,26265956,84.6514970088,90,8,>1K
2487,comedy,1508,26267464,84.6563570815,90,6,>1K
2488,properties,1506,26268970,84.6612107086,90,10,>1K
2489,relief,1505,26270475,84.6660611128,90,6,>1K
2490,deadline,1505,26271980,84.670911517,90,8,>1K
2491,timbers,1503,26273483,84.6757554754,90,7,>1K
2492,adam,1503,26274986,84.6805994339,90,4,>1K
2493,unlike,1502,26276488,84.6854401695,90,6,>1K
2494,joint,1501,26277989,84.6902776823,90,5,>1K
2495,1500,1500,26279489,84.6951119721,90,4,>1K
2496,established,1498,26280987,84.6999398163,90,11,>1K
2497,enter,1497,26282484,84.7047644376,90,5,>1K
2498,calif,1497,26283981,84.7095890589,90,5,>1K
2499,exercise,1496,26285477,84.7144104574,90,8,>1K
2500,parent,1496,26286973,84.7192318558,90,6,>1K
2501,flavor,1495,26288468,84.7240500314,90,6,>1K
2502,shape,1494,26289962,84.7288649841,90,5,>1K
2503,visited,1493,26291455,84.733676714,90,7,>1K
2504,pizza,1492,26292947,84.738485221,90,5,>1K
2505,earn,1492,26294439,84.743293728,90,4,>1K
2506,likes,1489,26295928,84.7480925665,90,5,>1K
2507,clinton,1488,26297416,84.752888182,90,7,>1K
2508,volunteer,1488,26298904,84.7576837976,90,9,>1K
2509,recalled,1488,26300392,84.7624794132,90,8,>1K
2510,reduced,1487,26301879,84.7672718059,90,7,>1K
2511,extended,1484,26303363,84.77205453,90,8,>1K
2512,pennsylvania,1483,26304846,84.7768340313,90,12,>1K
2513,jumped,1482,26306328,84.7816103097,90,6,>1K
2514,yankees,1480,26307808,84.7863801424,90,7,>1K
2515,amendment,1480,26309288,84.7911499751,90,9,>1K
2516,customer,1479,26310767,84.7959165849,90,8,>1K
2517,resort,1479,26312246,84.8006831947,90,6,>1K
2518,explained,1478,26313724,84.8054465817,90,9,>1K
2519,convention,1478,26315202,84.8102099687,90,10,>1K
2520,sentence,1477,26316679,84.8149701328,90,8,>1K
2521,explain,1476,26318155,84.819727074,90,7,>1K
2522,acres,1475,26319630,84.8244807924,90,5,>1K
2523,jerry,1474,26321104,84.829231288,90,5,>1K
2524,maintain,1474,26322578,84.8339817835,90,8,>1K
2525,boulevard,1473,26324051,84.8387290562,90,9,>1K
2526,perry,1472,26325523,84.843473106,90,5,>1K
2527,donations,1471,26326994,84.8482139329,90,9,>1K
2528,holds,1471,26328465,84.8529547599,90,5,>1K
2529,locations,1471,26329936,84.8576955868,90,9,>1K
2530,dollar,1470,26331406,84.8624331909,90,6,>1K
2531,birth,1470,26332876,84.867170795,90,5,>1K
2532,estimates,1470,26334346,84.8719083991,90,9,>1K
2533,split,1469,26335815,84.8766427803,90,5,>1K
2534,protesters,1467,26337282,84.8813707158,90,10,>1K
2535,fraud,1467,26338749,84.8860986514,90,5,>1K
2536,eating,1466,26340215,84.890823364,90,6,>1K
2537,testimony,1465,26341680,84.8955448538,90,9,>1K
2538,captain,1465,26343145,84.9002663436,90,7,>1K
2539,increasing,1464,26344609,84.9049846105,90,10,>1K
2540,ms,1464,26346073,84.9097028775,90,2,>1K
2541,knowing,1464,26347537,84.9144211444,90,7,>1K
2542,k,1462,26348999,84.9191329656,90,1,>1K
2543,effects,1462,26350461,84.9238447868,90,7,>1K
2544,adds,1462,26351923,84.928556608,90,4,>1K
2545,crimes,1462,26353385,84.9332684292,90,6,>1K
2546,replaced,1461,26354846,84.9379770276,90,8,>1K
2547,falling,1460,26356306,84.9426824031,90,7,>1K
2548,fort,1460,26357766,84.9473877786,90,4,>1K
2549,affected,1459,26359225,84.9520899312,90,8,>1K
2550,extremely,1459,26360684,84.9567920838,90,9,>1K
2551,hopefully,1459,26362143,84.9614942365,90,9,>1K
2552,stone,1458,26363601,84.9661931662,90,5,>1K
2553,kentucky,1458,26365059,84.970892096,90,8,>1K
2554,ongoing,1458,26366517,84.9755910258,90,7,>1K
2555,bread,1457,26367974,84.9802867327,90,5,>1K
2556,sam,1457,26369431,84.9849824396,90,3,>1K
2557,guess,1455,26370886,84.9896717008,90,5,>1K
2558,apply,1454,26372340,84.9943577391,90,5,>1K
2559,originally,1453,26373793,84.9990405546,90,10,>1K
2560,stanford,1452,26375245,85.0037201472,90,8,>1K
2561,unusual,1451,26376696,85.008396517,90,7,>1K
2562,cited,1450,26378146,85.0130696639,90,5,>1K
2563,roy,1450,26379596,85.0177428108,90,3,>1K
2564,opposed,1447,26381043,85.0224062891,90,7,>1K
2565,chrysler,1446,26382489,85.0270665445,90,8,>1K
2566,bonds,1446,26383935,85.0317268,90,5,>1K
2567,affect,1446,26385381,85.0363870554,90,6,>1K
2568,tiny,1446,26386827,85.0410473109,90,4,>1K
2569,meal,1446,26388273,85.0457075663,90,4,>1K
2570,basis,1445,26389718,85.0503645989,90,5,>1K
2571,pitcher,1445,26391163,85.0550216315,90,7,>1K
2572,plane,1445,26392608,85.0596786641,90,5,>1K
2573,featuring,1444,26394052,85.0643324738,90,9,>1K
2574,readers,1444,26395496,85.0689862836,90,7,>1K
2575,busy,1444,26396940,85.0736400933,90,4,>1K
2576,lights,1442,26398382,85.0782874573,90,6,>1K
2577,forget,1442,26399824,85.0829348213,90,6,>1K
2578,hire,1442,26401266,85.0875821853,90,4,>1K
2579,carried,1441,26402707,85.0922263265,90,7,>1K
2580,headquarters,1440,26404147,85.0968672448,90,12,>1K
2581,ruled,1440,26405587,85.1015081631,90,5,>1K
2582,researchers,1438,26407025,85.1061426357,90,11,>1K
2583,ceremony,1437,26408462,85.1107738854,90,8,>1K
2584,internal,1436,26409898,85.1154019122,90,8,>1K
2585,seriously,1432,26411330,85.1200170476,90,9,>1K
2586,ingredients,1432,26412762,85.1246321831,90,11,>1K
2587,ten,1432,26414194,85.1292473185,90,3,>1K
2588,tie,1432,26415626,85.1338624539,90,3,>1K
2589,puts,1432,26417058,85.1384775893,90,4,>1K
2590,expectations,1431,26418489,85.1430895018,90,12,>1K
2591,ship,1430,26419919,85.1476981915,90,4,>1K
2592,drama,1429,26421348,85.1523036584,90,5,>1K
2593,sees,1429,26422777,85.1569091252,90,4,>1K
2594,absolutely,1429,26424206,85.161514592,90,10,>1K
2595,rail,1428,26425634,85.166116836,90,4,>1K
2596,germany,1426,26427060,85.1707126343,90,7,>1K
2597,code,1425,26428485,85.1753052097,90,4,>1K
2598,walker,1425,26429910,85.1798977851,90,6,>1K
2599,debut,1423,26431333,85.1844839147,90,5,>1K
2600,image,1422,26432755,85.1890668216,90,5,>1K
2601,vikings,1421,26434176,85.1936465055,90,7,>1K
2602,rally,1421,26435597,85.1982261895,90,5,>1K
2603,factor,1420,26437017,85.2028026506,90,6,>1K
2604,sets,1420,26438437,85.2073791117,90,4,>1K
2605,rush,1419,26439856,85.2119523499,90,4,>1K
2606,milk,1419,26441275,85.2165255881,90,4,>1K
2607,core,1417,26442692,85.2210923806,90,4,>1K
2608,liked,1417,26444109,85.2256591732,90,5,>1K
2609,funeral,1417,26445526,85.2302259657,90,7,>1K
2610,mixed,1416,26446942,85.2347895353,90,5,>1K
2611,complaint,1411,26448353,85.2393369907,90,9,>1K
2612,jon,1410,26449763,85.2438812232,90,3,>1K
2613,delivered,1409,26451172,85.2484222328,90,9,>1K
2614,impressive,1407,26452579,85.2529567967,90,10,>1K
2615,seed,1407,26453986,85.2574913606,90,4,>1K
2616,oklahoma,1406,26455392,85.2620227017,90,8,>1K
2617,expenses,1406,26456798,85.2665540428,90,8,>1K
2618,relatively,1406,26458204,85.2710853838,90,10,>1K
2619,recorded,1406,26459610,85.2756167249,90,8,>1K
2620,mention,1404,26461014,85.2801416202,90,7,>1K
2621,editor,1403,26462417,85.2846632927,90,6,>1K
2622,seniors,1403,26463820,85.2891849652,90,7,>1K
2623,intended,1402,26465222,85.2937034148,90,8,>1K
2624,politicians,1402,26466624,85.2982218644,90,11,>1K
2625,anybody,1401,26468025,85.3027370911,90,7,>1K
2626,ben,1401,26469426,85.3072523179,90,3,>1K
2627,jay,1400,26470826,85.3117643218,90,3,>1K
2628,aggressive,1400,26472226,85.3162763257,90,10,>1K
2629,josh,1400,26473626,85.3207883296,90,4,>1K
2630,amid,1396,26475022,85.325287442,90,4,>1K
2631,contributions,1395,26476417,85.3297833316,90,13,>1K
2632,coordinator,1395,26477812,85.3342792212,90,11,>1K
2633,plastic,1395,26479207,85.3387751108,90,7,>1K
2634,suggests,1395,26480602,85.3432710004,90,8,>1K
2635,promised,1393,26481995,85.3477604443,90,8,>1K
2636,foster,1393,26483388,85.3522498882,90,6,>1K
2637,experienced,1393,26484781,85.3567393321,90,11,>1K
2638,championships,1393,26486174,85.3612287759,90,13,>1K
2639,spirit,1393,26487567,85.3657182198,90,6,>1K
2640,shoulder,1392,26488959,85.3702044408,90,8,>1K
2641,minister,1391,26490350,85.374687439,90,8,>1K
2642,solution,1391,26491741,85.3791704371,90,8,>1K
2643,client,1391,26493132,85.3836534353,90,6,>1K
2644,ron,1390,26494522,85.3881332106,90,3,>1K
2645,ranked,1389,26495911,85.392609763,90,6,>1K
2646,circle,1389,26497300,85.3970863155,90,6,>1K
2647,wallace,1388,26498688,85.401559645,90,7,>1K
2648,leg,1388,26500076,85.4060329746,90,3,>1K
2649,vegas,1386,26501462,85.4104998585,90,5,>1K
2650,increasingly,1386,26502848,85.4149667423,90,12,>1K
2651,complaints,1385,26504233,85.4194304033,90,10,>1K
2652,representatives,1384,26505617,85.4238908415,90,15,>1K
2653,values,1384,26507001,85.4283512796,90,6,>1K
2654,expressed,1384,26508385,85.4328117178,90,9,>1K
2655,chapter,1384,26509769,85.4372721559,90,7,>1K
2656,broadway,1383,26511152,85.4417293712,90,8,>1K
2657,moore,1383,26512535,85.4461865864,90,5,>1K
2658,solar,1381,26513916,85.450637356,90,5,>1K
2659,memory,1380,26515296,85.4550849027,90,6,>1K
2660,f,1380,26516676,85.4595324494,90,1,>1K
2661,emotional,1380,26518056,85.4639799961,90,9,>1K
2662,waste,1378,26519434,85.4684210971,90,5,>1K
2663,struggled,1377,26520811,85.4728589752,90,9,>1K
2664,portion,1377,26522188,85.4772968533,90,7,>1K
2665,sentenced,1377,26523565,85.4817347314,90,9,>1K
2666,affairs,1377,26524942,85.4861726095,90,7,>1K
2667,egg,1376,26526318,85.4906072648,90,3,>1K
2668,matters,1374,26527692,85.4950354743,90,7,>1K
2669,fed,1373,26529065,85.499460461,90,3,>1K
2670,cultural,1373,26530438,85.5038854477,90,8,>1K
2671,georgia,1373,26531811,85.5083104344,90,7,>1K
2672,knowledge,1373,26533184,85.5127354211,90,9,>1K
2673,mobile,1372,26534556,85.5171571849,90,6,>1K
2674,courts,1371,26535927,85.5215757258,90,6,>1K
2675,morris,1370,26537297,85.5259910439,90,6,>1K
2676,chase,1368,26538665,85.5303999163,90,5,>1K
2677,bike,1368,26540033,85.5348087887,90,4,>1K
2678,elizabeth,1366,26541399,85.5392112153,90,9,>1K
2679,supported,1365,26542764,85.5436104191,90,9,>1K
2680,visiting,1365,26544129,85.5480096229,90,8,>1K
2681,expansion,1364,26545493,85.5524056039,90,9,>1K
2682,japanese,1364,26546857,85.5568015848,90,8,>1K
2683,commerce,1363,26548220,85.5611943429,90,8,>1K
2684,suggest,1363,26549583,85.565587101,90,7,>1K
2685,instance,1363,26550946,85.5699798591,90,8,>1K
2686,throwing,1363,26552309,85.5743726171,90,8,>1K
2687,structure,1362,26553671,85.5787621524,90,9,>1K
2688,journal,1361,26555032,85.5831484647,90,7,>1K
2689,indeed,1361,26556393,85.5875347771,90,6,>1K
2690,roads,1360,26557753,85.5919178666,90,5,>1K
2691,silver,1359,26559112,85.5962977332,90,6,>1K
2692,combination,1359,26560471,85.6006775999,90,11,>1K
2693,interests,1359,26561830,85.6050574665,90,9,>1K
2694,regulations,1359,26563189,85.6094373331,90,11,>1K
2695,personnel,1359,26564548,85.6138171998,90,9,>1K
2696,harder,1358,26565906,85.6181938436,90,6,>1K
2697,rescue,1358,26567264,85.6225704873,90,6,>1K
2698,treat,1358,26568622,85.6269471311,90,5,>1K
2699,blocks,1358,26569980,85.6313237749,90,6,>1K
2700,advocates,1356,26571336,85.6356939729,90,9,>1K
2701,tend,1356,26572692,85.640064171,90,4,>1K
2702,heading,1356,26574048,85.6444343691,90,7,>1K
2703,meaning,1355,26575403,85.6488013443,90,7,>1K
2704,kick,1353,26576756,85.6531618737,90,4,>1K
2705,chamber,1353,26578109,85.6575224032,90,7,>1K
2706,vision,1352,26579461,85.6618797098,90,6,>1K
2707,prepare,1352,26580813,85.6662370165,90,7,>1K
2708,medicare,1352,26582165,85.6705943231,90,8,>1K
2709,improvement,1351,26583516,85.6749484068,90,11,>1K
2710,pat,1351,26584867,85.6793024906,90,3,>1K
2711,settlement,1351,26586218,85.6836565744,90,10,>1K
2712,conducted,1351,26587569,85.6880106581,90,9,>1K
2713,digital,1350,26588919,85.692361519,90,7,>1K
2714,advanced,1350,26590269,85.6967123799,90,8,>1K
2715,spanish,1350,26591619,85.7010632408,90,7,>1K
2716,justin,1350,26592969,85.7054141017,90,6,>1K
2717,circuit,1347,26594316,85.709755294,90,7,>1K
2718,farmers,1347,26595663,85.7140964864,90,7,>1K
2719,continuing,1347,26597010,85.7184376787,90,10,>1K
2720,argument,1346,26598356,85.7227756481,90,8,>1K
2721,pitched,1345,26599701,85.7271103947,90,7,>1K
2722,payment,1344,26601045,85.7314419185,90,7,>1K
2723,anywhere,1344,26602389,85.7357734422,90,8,>1K
2724,partnership,1343,26603732,85.7401017431,90,11,>1K
2725,crazy,1343,26605075,85.744430044,90,5,>1K
2726,pork,1341,26606416,85.7487518992,90,4,>1K
2727,participate,1340,26607756,85.7530705315,90,11,>1K
2728,lady,1340,26609096,85.7573891638,90,4,>1K
2729,chair,1338,26610434,85.7617013503,90,5,>1K
2730,mitt,1337,26611771,85.7660103141,90,4,>1K
2731,founded,1335,26613106,85.7703128321,90,7,>1K
2732,tech,1334,26614440,85.7746121272,90,4,>1K
2733,legislators,1333,26615773,85.7789081995,90,11,>1K
2734,filing,1332,26617105,85.7832010489,90,6,>1K
2735,purchased,1332,26618437,85.7874938983,90,9,>1K
2736,ill,1332,26619769,85.7917867477,90,3,>1K
2737,governments,1332,26621101,85.7960795972,90,11,>1K
2738,ending,1332,26622433,85.8003724466,90,6,>1K
2739,laid,1331,26623764,85.8046620731,90,4,>1K
2740,theft,1331,26625095,85.8089516997,90,5,>1K
2741,elsewhere,1330,26626425,85.8132381034,90,9,>1K
2742,quiet,1328,26627753,85.8175180614,90,5,>1K
2743,immediate,1328,26629081,85.8217980194,90,9,>1K
2744,anniversary,1327,26630408,85.8260747545,90,11,>1K
2745,excellent,1325,26631733,85.8303450439,90,9,>1K
2746,devices,1325,26633058,85.8346153333,90,7,>1K
2747,eggs,1324,26634382,85.8388823998,90,4,>1K
2748,monthly,1323,26635705,85.8431462435,90,7,>1K
2749,apart,1323,26637028,85.8474100872,90,5,>1K
2750,ann,1322,26638350,85.851670708,90,3,>1K
2751,pictures,1321,26639671,85.855928106,90,8,>1K
2752,wells,1320,26640991,85.8601822811,90,5,>1K
2753,combine,1320,26642311,85.8644364562,90,7,>1K
2754,inspired,1320,26643631,85.8686906313,90,8,>1K
2755,launch,1320,26644951,85.8729448064,90,6,>1K
2756,usual,1320,26646271,85.8771989815,90,5,>1K
2757,skin,1319,26647590,85.8814499337,90,4,>1K
2758,celebration,1318,26648908,85.8856976631,90,11,>1K
2759,reputation,1318,26650226,85.8899453925,90,10,>1K
2760,pitching,1318,26651544,85.8941931219,90,8,>1K
2761,orleans,1317,26652861,85.8984376284,90,7,>1K
2762,athletes,1317,26654178,85.9026821349,90,8,>1K
2763,heavily,1317,26655495,85.9069266415,90,7,>1K
2764,postseason,1315,26656810,85.9111647023,90,10,>1K
2765,wayne,1314,26658124,85.9153995402,90,5,>1K
2766,h,1314,26659438,85.9196343781,90,1,>1K
2767,brief,1314,26660752,85.9238692161,90,5,>1K
2768,appeals,1313,26662065,85.9281008312,90,7,>1K
2769,revealed,1313,26663378,85.9323324463,90,8,>1K
2770,arms,1313,26664691,85.9365640613,90,4,>1K
2771,ed,1312,26666003,85.9407924536,90,2,>1K
2772,chen,1312,26667315,85.9450208458,90,4,>1K
2773,theme,1311,26668626,85.9492460151,90,5,>1K
2774,touchdown,1310,26669936,85.9534679616,90,9,>1K
2775,bin,1310,26671246,85.9576899081,90,3,>1K
2776,breast,1310,26672556,85.9619118547,90,6,>1K
2777,fix,1310,26673866,85.9661338012,90,3,>1K
2778,happening,1309,26675175,85.9703525248,90,9,>1K
2779,hamilton,1309,26676484,85.9745712484,90,8,>1K
2780,limits,1308,26677792,85.9787867492,90,6,>1K
2781,fishing,1307,26679099,85.9829990271,90,7,>1K
2782,represent,1307,26680406,85.9872113051,90,9,>1K
2783,trend,1307,26681713,85.991423583,90,5,>1K
2784,surrounding,1305,26683018,85.9956294152,90,11,>1K
2785,municipal,1304,26684322,85.9998320245,90,9,>1K
2786,coalition,1304,26685626,86.0040346339,90,9,>1K
2787,races,1304,26686930,86.0082372432,90,5,>1K
2788,performing,1303,26688233,86.0124366297,90,10,>1K
2789,unable,1301,26689534,86.0166295705,90,6,>1K
2790,communications,1300,26690834,86.0208192884,90,14,>1K
2791,1300,1300,26692134,86.0250090063,90,4,>1K
2792,boat,1298,26693432,86.0291922785,90,4,>1K
2793,sharp,1297,26694729,86.0333723278,90,5,>1K
2794,larry,1296,26696025,86.0375491543,90,5,>1K
2795,units,1296,26697321,86.0417259807,90,5,>1K
2796,strategic,1296,26698617,86.0459028072,90,9,>1K
2797,canada,1296,26699913,86.0500796336,90,6,>1K
2798,winners,1296,26701209,86.0542564601,90,7,>1K
2799,obvious,1296,26702505,86.0584332866,90,7,>1K
2800,madison,1295,26703800,86.0626068902,90,7,>1K
2801,witness,1294,26705094,86.0667772709,90,7,>1K
2802,iran,1294,26706388,86.0709476517,90,4,>1K
2803,admission,1294,26707682,86.0751180324,90,9,>1K
2804,negotiations,1293,26708975,86.0792851903,90,12,>1K
2805,chain,1293,26710268,86.0834523482,90,5,>1K
2806,troops,1291,26711559,86.0876130603,90,6,>1K
2807,users,1289,26712848,86.0917673268,90,5,>1K
2808,warning,1288,26714136,86.0959183704,90,7,>1K
2809,witnesses,1288,26715424,86.100069414,90,9,>1K
2810,materials,1288,26716712,86.1042204575,90,9,>1K
2811,enjoyed,1288,26718000,86.1083715011,90,7,>1K
2812,shoes,1287,26719287,86.1125193219,90,5,>1K
2813,usa,1285,26720572,86.1166606969,90,3,>1K
2814,ray,1285,26721857,86.1208020719,90,3,>1K
2815,iraq,1285,26723142,86.1249434469,90,4,>1K
2816,regarding,1284,26724426,86.129081599,90,9,>1K
2817,kim,1284,26725710,86.1332197512,90,3,>1K
2818,supporting,1283,26726993,86.1373546804,90,10,>1K
2819,linebacker,1281,26728274,86.141483164,90,10,>1K
2820,mall,1280,26729554,86.1456084247,90,4,>1K
2821,typical,1280,26730834,86.1497336854,90,7,>1K
2822,images,1280,26732114,86.1538589461,90,6,>1K
2823,realized,1278,26733392,86.1579777611,90,8,>1K
2824,expert,1278,26734670,86.1620965761,90,6,>1K
2825,motion,1277,26735947,86.1662121682,90,6,>1K
2826,pan,1276,26737223,86.1703245375,90,3,>1K
2827,background,1276,26738499,86.1744369067,90,10,>1K
2828,software,1276,26739775,86.178549276,90,8,>1K
2829,mistake,1276,26741051,86.1826616453,90,7,>1K
2830,yellow,1275,26742326,86.1867707917,90,6,>1K
2831,bars,1274,26743600,86.1908767152,90,4,>1K
2832,recall,1272,26744872,86.1949761931,90,6,>1K
2833,content,1271,26746143,86.199072448,90,7,>1K
2834,engine,1271,26747414,86.203168703,90,6,>1K
2835,upset,1271,26748685,86.207264958,90,5,>1K
2836,letters,1270,26749955,86.2113579901,90,7,>1K
2837,express,1269,26751224,86.2154477993,90,7,>1K
2838,initiative,1269,26752493,86.2195376086,90,10,>1K
2839,guide,1268,26753761,86.2236241949,90,5,>1K
2840,el,1268,26755029,86.2277107813,90,2,>1K
2841,machine,1268,26756297,86.2317973677,90,7,>1K
2842,vegetables,1267,26757564,86.2358807312,90,10,>1K
2843,sending,1266,26758830,86.2399608719,90,7,>1K
2844,performances,1266,26760096,86.2440410126,90,12,>1K
2845,bags,1266,26761362,86.2481211532,90,4,>1K
2846,steven,1265,26762627,86.252198071,90,6,>1K
2847,las,1265,26763892,86.2562749888,90,3,>1K
2848,triple,1265,26765157,86.2603519067,90,6,>1K
2849,rbi,1264,26766421,86.2644256016,90,3,>1K
2850,calories,1264,26767685,86.2684992965,90,8,>1K
2851,broad,1264,26768949,86.2725729915,90,5,>1K
2852,stepped,1263,26770212,86.2766434636,90,7,>1K
2853,device,1263,26771475,86.2807139357,90,6,>1K
2854,utility,1262,26772737,86.2847811849,90,7,>1K
2855,outstanding,1262,26773999,86.2888484341,90,11,>1K
2856,orders,1261,26775260,86.2929124605,90,6,>1K
2857,improvements,1261,26776521,86.2969764869,90,12,>1K
2858,participants,1260,26777781,86.3010372904,90,12,>1K
2859,appropriate,1259,26779040,86.305094871,90,11,>1K
2860,gains,1259,26780299,86.3091524517,90,5,>1K
2861,potentially,1258,26781557,86.3132068094,90,11,>1K
2862,deaths,1258,26782815,86.3172611672,90,6,>1K
2863,affordable,1256,26784071,86.3213090793,90,10,>1K
2864,neighborhoods,1255,26785326,86.3253537685,90,13,>1K
2865,stick,1255,26786581,86.3293984577,90,5,>1K
2866,bell,1254,26787835,86.3334399241,90,4,>1K
2867,recommended,1254,26789089,86.3374813904,90,11,>1K
2868,trips,1254,26790343,86.3415228567,90,5,>1K
2869,boards,1254,26791597,86.3455643231,90,6,>1K
2870,marine,1254,26792851,86.3496057894,90,6,>1K
2871,lincoln,1253,26794104,86.3536440329,90,7,>1K
2872,craft,1252,26795356,86.3576790536,90,5,>1K
2873,application,1252,26796608,86.3617140742,90,11,>1K
2874,jefferson,1252,26797860,86.3657490948,90,9,>1K
2875,franklin,1251,26799111,86.3697808926,90,8,>1K
2876,worker,1251,26800362,86.3738126903,90,6,>1K
2877,corruption,1250,26801612,86.3778412653,90,10,>1K
2878,ward,1250,26802862,86.3818698402,90,4,>1K
2879,henry,1248,26804110,86.3858919693,90,5,>1K
2880,sector,1248,26805358,86.3899140985,90,6,>1K
2881,occupy,1247,26806605,86.3939330049,90,6,>1K
2882,metal,1247,26807852,86.3979519112,90,5,>1K
2883,writes,1246,26809098,86.4019675947,90,6,>1K
2884,hotels,1245,26810343,86.4059800553,90,6,>1K
2885,hockey,1244,26811587,86.409989293,90,6,>1K
2886,blame,1244,26812831,86.4139985308,90,5,>1K
2887,channel,1242,26814073,86.4180013228,90,7,>1K
2888,smoke,1242,26815315,86.4220041148,90,5,>1K
2889,wedding,1242,26816557,86.4260069068,90,7,>1K
2890,relations,1241,26817798,86.430006476,90,9,>1K
2891,dress,1241,26819039,86.4340060452,90,5,>1K
2892,soft,1241,26820280,86.4380056144,90,4,>1K
2893,fields,1240,26821520,86.4420019607,90,6,>1K
2894,funny,1240,26822760,86.445998307,90,5,>1K
2895,reporting,1239,26823999,86.4499914304,90,9,>1K
2896,weapons,1239,26825238,86.4539845539,90,7,>1K
2897,ad,1238,26826476,86.4579744545,90,2,>1K
2898,firms,1238,26827714,86.461964355,90,5,>1K
2899,invited,1238,26828952,86.4659542556,90,7,>1K
2900,alive,1237,26830189,86.4699409334,90,5,>1K
2901,identify,1235,26831424,86.4739211654,90,8,>1K
2902,interstate,1234,26832658,86.4778981745,90,10,>1K
2903,rejected,1233,26833891,86.4818719608,90,8,>1K
2904,developing,1232,26835123,86.4858425242,90,10,>1K
2905,actual,1232,26836355,86.4898130877,90,6,>1K
2906,flat,1232,26837587,86.4937836511,90,4,>1K
2907,map,1231,26838818,86.4977509917,90,3,>1K
2908,bail,1231,26840049,86.5017183322,90,4,>1K
2909,pending,1231,26841280,86.5056856728,90,7,>1K
2910,dealing,1230,26842510,86.5096497905,90,7,>1K
2911,types,1229,26843739,86.5136106854,90,5,>1K
2912,attempted,1229,26844968,86.5175715802,90,9,>1K
2913,visits,1228,26846196,86.5215292522,90,6,>1K
2914,deliver,1228,26847424,86.5254869242,90,7,>1K
2915,jets,1227,26848651,86.5294413733,90,4,>1K
2916,organized,1227,26849878,86.5333958224,90,9,>1K
2917,distance,1226,26851104,86.5373470487,90,8,>1K
2918,suddenly,1226,26852330,86.541298275,90,8,>1K
2919,tower,1226,26853556,86.5452495012,90,5,>1K
2920,sox,1226,26854782,86.5492007275,90,3,>1K
2921,suicide,1224,26856006,86.5531455081,90,7,>1K
2922,sick,1224,26857230,86.5570902886,90,4,>1K
2923,drinking,1224,26858454,86.5610350692,90,8,>1K
2924,lucky,1223,26859677,86.5649766269,90,5,>1K
2925,taught,1223,26860900,86.5689181845,90,6,>1K
2926,dedicated,1222,26862122,86.5728565194,90,9,>1K
2927,y,1221,26863343,86.5767916313,90,1,>1K
2928,collected,1221,26864564,86.5807267433,90,9,>1K
2929,factors,1219,26865783,86.5846554096,90,7,>1K
2930,wright,1219,26867002,86.5885840758,90,6,>1K
2931,gray,1218,26868220,86.5925095192,90,4,>1K
2932,encourage,1218,26869438,86.5964349626,90,9,>1K
2933,represented,1218,26870656,86.600360406,90,11,>1K
2934,credits,1216,26871872,86.6042794036,90,7,>1K
2935,hoped,1216,26873088,86.6081984013,90,5,>1K
2936,medium,1215,26874303,86.6121141761,90,6,>1K
2937,dramatic,1215,26875518,86.6160299509,90,8,>1K
2938,interviews,1214,26876732,86.6199425029,90,10,>1K
2939,breaking,1214,26877946,86.6238550548,90,8,>1K
2940,flying,1213,26879159,86.6277643839,90,6,>1K
2941,empty,1213,26880372,86.631673713,90,5,>1K
2942,desert,1212,26881584,86.6355798193,90,6,>1K
2943,article,1210,26882794,86.6394794798,90,7,>1K
2944,negative,1210,26884004,86.6433791403,90,8,>1K
2945,warren,1209,26885213,86.6472755779,90,6,>1K
2946,male,1209,26886422,86.6511720156,90,4,>1K
2947,founder,1208,26887630,86.6550652304,90,7,>1K
2948,transition,1208,26888838,86.6589584452,90,10,>1K
2949,patrol,1206,26890044,86.6628452142,90,6,>1K
2950,statements,1205,26891249,86.6667287604,90,10,>1K
2951,signing,1205,26892454,86.6706123066,90,7,>1K
2952,nights,1203,26893657,86.6744894071,90,6,>1K
2953,unfortunately,1202,26894859,86.6783632848,90,13,>1K
2954,repeatedly,1201,26896060,86.6822339395,90,10,>1K
2955,1200,1200,26897260,86.6861013714,90,4,>1K
2956,math,1200,26898460,86.6899688034,90,4,>1K
2957,closely,1199,26899659,86.6938330124,90,7,>1K
2958,traveling,1198,26900857,86.6976939986,90,9,>1K
2959,paint,1198,26902055,86.7015549848,90,5,>1K
2960,warned,1198,26903253,86.705415971,90,6,>1K
2961,beating,1197,26904450,86.7092737343,90,7,>1K
2962,tired,1197,26905647,86.7131314976,90,5,>1K
2963,stronger,1197,26906844,86.716989261,90,8,>1K
2964,struggle,1196,26908040,86.7208438015,90,8,>1K
2965,extension,1195,26909235,86.7246951191,90,9,>1K
2966,faster,1195,26910430,86.7285464367,90,6,>1K
2967,argue,1194,26911624,86.7323945314,90,5,>1K
2968,manhattan,1194,26912818,86.7362426262,90,9,>1K
2969,collins,1194,26914012,86.7400907209,90,7,>1K
2970,stewart,1194,26915206,86.7439388157,90,7,>1K
2971,die,1193,26916399,86.7477836876,90,3,>1K
2972,orchestra,1193,26917592,86.7516285595,90,9,>1K
2973,tampa,1192,26918784,86.7554702085,90,5,>1K
2974,ourselves,1192,26919976,86.7593118575,90,9,>1K
2975,impossible,1192,26921168,86.7631535066,90,10,>1K
2976,cameras,1189,26922357,86.766985487,90,7,>1K
2977,ring,1188,26923545,86.7708142446,90,4,>1K
2978,mount,1187,26924732,86.7746397793,90,5,>1K
2979,failing,1187,26925919,86.7784653141,90,7,>1K
2980,weekly,1187,26927106,86.7822908488,90,6,>1K
2981,purpose,1186,26928292,86.7861131607,90,7,>1K
2982,pages,1186,26929478,86.7899354725,90,5,>1K
2983,gathered,1186,26930664,86.7937577844,90,8,>1K
2984,goods,1184,26931848,86.7975736506,90,5,>1K
2985,questioned,1184,26933032,86.8013895167,90,10,>1K
2986,temporary,1184,26934216,86.8052053829,90,9,>1K
2987,handful,1184,26935400,86.809021249,90,7,>1K
2988,angels,1183,26936583,86.8128338923,90,6,>1K
2989,italy,1182,26937765,86.8166433127,90,5,>1K
2990,wisconsin,1181,26938946,86.8204495103,90,9,>1K
2991,ads,1181,26940127,86.8242557079,90,3,>1K
2992,mentioned,1178,26941305,86.8280522369,90,9,>1K
2993,pitches,1178,26942483,86.8318487659,90,7,>1K
2994,attempts,1178,26943661,86.8356452949,90,8,>1K
2995,concept,1178,26944839,86.8394418239,90,7,>1K
2996,criticism,1176,26946015,86.8432319071,90,9,>1K
2997,morgan,1175,26947190,86.8470187676,90,6,>1K
2998,drawn,1175,26948365,86.850805628,90,5,>1K
2999,investigating,1175,26949540,86.8545924884,90,13,>1K
3000,understanding,1175,26950715,86.8583793488,90,13,>1K
3001,capacity,1174,26951889,86.8621629863,90,8,>1K
3002,susan,1174,26953063,86.8659466239,90,5,>1K
3003,penn,1173,26954236,86.8697270386,90,4,>1K
3004,grill,1173,26955409,86.8735074533,90,5,>1K
3005,gained,1172,26956581,86.8772846451,90,6,>1K
3006,touchdowns,1172,26957753,86.8810618369,90,10,>1K
3007,secure,1171,26958924,86.8848358059,90,6,>1K
3008,noticed,1171,26960095,86.8886097749,90,7,>1K
3009,barely,1171,26961266,86.8923837439,90,6,>1K
3010,exciting,1170,26962436,86.89615449,90,8,>1K
3011,steel,1170,26963606,86.8999252361,90,5,>1K
3012,parker,1169,26964775,86.9036927593,90,6,>1K
3013,flavors,1168,26965943,86.9074570597,90,7,>1K
3014,celebrate,1168,26967111,86.9112213601,90,9,>1K
3015,bodies,1168,26968279,86.9149856605,90,6,>1K
3016,nomination,1167,26969446,86.9187467381,90,10,>1K
3017,plaza,1167,26970613,86.9225078156,90,5,>1K
3018,pittsburgh,1166,26971779,86.9262656703,90,10,>1K
3019,jennifer,1165,26972944,86.9300203021,90,8,>1K
3020,staying,1165,26974109,86.9337749339,90,7,>1K
3021,tradition,1164,26975273,86.9375263429,90,9,>1K
3022,unlikely,1163,26976436,86.9412745289,90,8,>1K
3023,drawing,1162,26977598,86.9450194922,90,7,>1K
3024,approve,1162,26978760,86.9487644554,90,7,>1K
3025,zimmerman,1162,26979922,86.9525094186,90,9,>1K
3026,compensation,1161,26981083,86.956251159,90,12,>1K
3027,christopher,1161,26982244,86.9599928994,90,11,>1K
3028,appointed,1161,26983405,86.9637346398,90,9,>1K
3029,tables,1160,26984565,86.9674731573,90,6,>1K
3030,venture,1160,26985725,86.9712116748,90,7,>1K
3031,signature,1160,26986885,86.9749501923,90,9,>1K
3032,shoot,1159,26988044,86.978685487,90,5,>1K
3033,birthday,1159,26989203,86.9824207816,90,8,>1K
3034,garlic,1159,26990362,86.9861560763,90,6,>1K
3035,del,1158,26991520,86.9898881481,90,3,>1K
3036,anyway,1157,26992677,86.993616997,90,6,>1K
3037,rival,1155,26993832,86.9973394002,90,5,>1K
3038,settled,1155,26994987,87.0010618034,90,7,>1K
3039,knicks,1154,26996141,87.0047809838,90,6,>1K
3040,dow,1154,26997295,87.0085001641,90,3,>1K
3041,operate,1153,26998448,87.0122161216,90,7,>1K
3042,prospect,1152,26999600,87.0159288563,90,8,>1K
3043,turkey,1152,27000752,87.0196415909,90,6,>1K
3044,stuck,1152,27001904,87.0233543255,90,5,>1K
3045,andy,1151,27003055,87.0270638373,90,4,>1K
3046,opens,1151,27004206,87.0307733491,90,5,>1K
3047,checks,1150,27005356,87.034479638,90,6,>1K
3048,consultant,1149,27006505,87.0381827041,90,10,>1K
3049,surface,1149,27007654,87.0418857701,90,7,>1K
3050,eligible,1149,27008803,87.0455888362,90,8,>1K
3051,tomorrow,1149,27009952,87.0492919022,90,8,>1K
3052,russell,1148,27011100,87.0529917454,90,7,>1K
3053,trucks,1147,27012247,87.0566883658,90,6,>1K
3054,priority,1147,27013394,87.0603849861,90,8,>1K
3055,carrying,1147,27014541,87.0640816064,90,8,>1K
3056,advertising,1147,27015688,87.0677782268,90,11,>1K
3057,parkway,1145,27016833,87.0714684014,90,7,>1K
3058,minimum,1144,27017977,87.0751553531,90,7,>1K
3059,israel,1144,27019121,87.0788423049,90,6,>1K
3060,bottle,1143,27020264,87.0825260338,90,6,>1K
3061,specifically,1143,27021407,87.0862097627,90,12,>1K
3062,laden,1143,27022550,87.0898934916,90,5,>1K
3063,slowly,1143,27023693,87.0935772205,90,6,>1K
3064,polls,1142,27024835,87.0972577265,90,5,>1K
3065,disney,1141,27025976,87.1009350097,90,6,>1K
3066,listen,1141,27027117,87.1046122929,90,6,>1K
3067,hunt,1141,27028258,87.108289576,90,4,>1K
3068,reaction,1141,27029399,87.1119668592,90,8,>1K
3069,engineering,1141,27030540,87.1156441424,90,11,>1K
3070,contemporary,1141,27031681,87.1193214256,90,12,>1K
3071,olive,1140,27032821,87.1229954859,90,5,>1K
3072,registered,1139,27033960,87.1266663233,90,10,>1K
3073,fla,1139,27035099,87.1303371608,90,3,>1K
3074,driven,1138,27036237,87.1340047754,90,6,>1K
3075,buyers,1138,27037375,87.13767239,90,6,>1K
3076,mitchell,1138,27038513,87.1413400046,90,8,>1K
3077,legs,1137,27039650,87.1450043963,90,4,>1K
3078,marked,1137,27040787,87.148668788,90,6,>1K
3079,tracks,1137,27041924,87.1523331798,90,6,>1K
3080,representing,1136,27043060,87.1559943487,90,12,>1K
3081,garage,1136,27044196,87.1596555175,90,6,>1K
3082,drinks,1134,27045330,87.1633102407,90,6,>1K
3083,armed,1134,27046464,87.1669649638,90,5,>1K
3084,bulls,1133,27047597,87.1706164641,90,5,>1K
3085,threatened,1133,27048730,87.1742679644,90,10,>1K
3086,ridge,1132,27049862,87.1779162419,90,5,>1K
3087,ranch,1131,27050993,87.1815612964,90,5,>1K
3088,custody,1131,27052124,87.185206351,90,7,>1K
3089,commissioners,1130,27053254,87.1888481827,90,13,>1K
3090,ken,1129,27054383,87.1924867916,90,3,>1K
3091,teach,1129,27055512,87.1961254004,90,5,>1K
3092,wildlife,1128,27056640,87.1997607864,90,8,>1K
3093,prize,1128,27057768,87.2033961724,90,5,>1K
3094,widely,1128,27058896,87.2070315584,90,6,>1K
3095,subsidiary,1128,27060024,87.2106669444,90,10,>1K
3096,suburban,1127,27061151,87.2142991076,90,8,>1K
3097,violent,1127,27062278,87.2179312707,90,7,>1K
3098,category,1126,27063404,87.221560211,90,8,>1K
3099,interior,1126,27064530,87.2251891513,90,8,>1K
3100,cincinnati,1126,27065656,87.2288180915,90,10,>1K
3101,declared,1125,27066781,87.232443809,90,8,>1K
3102,stress,1125,27067906,87.2360695264,90,6,>1K
3103,southeast,1125,27069031,87.2396952438,90,9,>1K
3104,requirements,1124,27070155,87.2433177383,90,12,>1K
3105,greece,1123,27071278,87.24693701,90,6,>1K
3106,profits,1123,27072401,87.2505562817,90,7,>1K
3107,finds,1123,27073524,87.2541755534,90,5,>1K
3108,applications,1123,27074647,87.2577948251,90,12,>1K
3109,recipe,1122,27075769,87.261410874,90,6,>1K
3110,annually,1122,27076891,87.2650269228,90,8,>1K
3111,historical,1121,27078012,87.2686397488,90,10,>1K
3112,reservations,1121,27079133,87.2722525748,90,12,>1K
3113,fallen,1120,27080253,87.2758621779,90,6,>1K
3114,turner,1119,27081372,87.2794685581,90,6,>1K
3115,saved,1119,27082491,87.2830749384,90,5,>1K
3116,topped,1119,27083610,87.2866813186,90,6,>1K
3117,permanent,1118,27084728,87.290284476,90,9,>1K
3118,bryant,1118,27085846,87.2938876334,90,6,>1K
3119,entirely,1117,27086963,87.297487568,90,8,>1K
3120,navy,1117,27088080,87.3010875025,90,4,>1K
3121,spain,1116,27089196,87.3046842142,90,5,>1K
3122,juice,1116,27090312,87.3082809259,90,5,>1K
3123,hunter,1115,27091427,87.3118744147,90,6,>1K
3124,answers,1115,27092542,87.3154679035,90,7,>1K
3125,lowest,1115,27093657,87.3190613923,90,6,>1K
3126,directors,1115,27094772,87.3226548811,90,9,>1K
3127,violations,1114,27095886,87.3262451471,90,10,>1K
3128,peak,1114,27097000,87.3298354131,90,4,>1K
3129,swing,1113,27098113,87.3334224562,90,5,>1K
3130,chosen,1113,27099226,87.3370094993,90,6,>1K
3131,craig,1113,27100339,87.3405965423,90,5,>1K
3132,self,1113,27101452,87.3441835854,90,4,>1K
3133,flowers,1112,27102564,87.3477674057,90,7,>1K
3134,connected,1112,27103676,87.3513512259,90,9,>1K
3135,traded,1112,27104788,87.3549350462,90,6,>1K
3136,rolling,1111,27105899,87.3585156435,90,7,>1K
3137,investments,1111,27107010,87.3620962409,90,11,>1K
3138,bird,1110,27108120,87.3656736154,90,4,>1K
3139,locker,1109,27109229,87.3692477671,90,6,>1K
3140,capitol,1109,27110338,87.3728219187,90,7,>1K
3141,behalf,1109,27111447,87.3763960704,90,6,>1K
3142,protest,1109,27112556,87.3799702221,90,7,>1K
3143,regulators,1108,27113664,87.3835411509,90,10,>1K
3144,manage,1107,27114771,87.3871088568,90,6,>1K
3145,india,1107,27115878,87.3906765627,90,5,>1K
3146,recognize,1106,27116984,87.3942410458,90,9,>1K
3147,recognized,1105,27118089,87.397802306,90,10,>1K
3148,shore,1105,27119194,87.4013635663,90,5,>1K
3149,carter,1104,27120298,87.4049216036,90,6,>1K
3150,sharing,1104,27121402,87.408479641,90,7,>1K
3151,proposals,1104,27122506,87.4120376783,90,9,>1K
3152,toyota,1103,27123609,87.4155924928,90,6,>1K
3153,clothing,1103,27124712,87.4191473073,90,8,>1K
3154,yard,1103,27125815,87.4227021218,90,4,>1K
3155,error,1103,27126918,87.4262569363,90,5,>1K
3156,getting,1102,27128020,87.429808528,90,7,>1K
3157,challenging,1102,27129122,87.4333601196,90,11,>1K
3158,councilman,1102,27130224,87.4369117112,90,10,>1K
3159,loves,1102,27131326,87.4404633029,90,5,>1K
3160,toll,1102,27132428,87.4440148945,90,4,>1K
3161,proved,1101,27133529,87.4475632633,90,6,>1K
3162,sons,1101,27134630,87.4511116321,90,4,>1K
3163,espn,1101,27135731,87.4546600008,90,4,>1K
3164,guest,1101,27136832,87.4582083696,90,5,>1K
3165,courses,1100,27137932,87.4617535155,90,7,>1K
3166,roof,1100,27139032,87.4652986615,90,4,>1K
3167,requests,1100,27140132,87.4688438074,90,8,>1K
3168,breaks,1100,27141232,87.4723889533,90,6,>1K
3169,akron,1100,27142332,87.4759340992,90,5,>1K
3170,upper,1100,27143432,87.4794792451,90,5,>1K
3171,harry,1100,27144532,87.4830243911,90,5,>1K
3172,raises,1099,27145631,87.4865663141,90,6,>1K
3173,vacation,1098,27146729,87.4901050143,90,8,>1K
3174,severe,1098,27147827,87.4936437145,90,6,>1K
3175,novel,1097,27148924,87.4971791918,90,5,>1K
3176,cable,1097,27150021,87.5007146692,90,5,>1K
3177,collective,1096,27151117,87.5042469237,90,10,>1K
3178,tyler,1094,27152211,87.5077727324,90,5,>1K
3179,frequently,1094,27153305,87.5112985412,90,10,>1K
3180,colleagues,1094,27154399,87.5148243499,90,10,>1K
3181,wake,1093,27155492,87.5183469358,90,4,>1K
3182,reasonable,1093,27156585,87.5218695217,90,10,>1K
3183,springs,1093,27157678,87.5253921076,90,7,>1K
3184,models,1092,27158770,87.5289114707,90,6,>1K
3185,motor,1091,27159861,87.5324276109,90,5,>1K
3186,improving,1091,27160952,87.535943751,90,9,>1K
3187,gordon,1091,27162043,87.5394598912,90,6,>1K
3188,minneapolis,1090,27163133,87.5429728085,90,11,>1K
3189,necessarily,1090,27164223,87.5464857259,90,11,>1K
3190,soldiers,1089,27165312,87.5499954203,90,8,>1K
3191,stations,1089,27166401,87.5535051148,90,8,>1K
3192,entering,1089,27167490,87.5570148092,90,8,>1K
3193,homeowners,1089,27168579,87.5605245037,90,10,>1K
3194,lemon,1088,27169667,87.5640309753,90,5,>1K
3195,finals,1088,27170755,87.5675374469,90,6,>1K
3196,birds,1088,27171843,87.5710439185,90,5,>1K
3197,educational,1088,27172931,87.5745503901,90,11,>1K
3198,suffering,1088,27174019,87.5780568617,90,9,>1K
3199,depending,1087,27175106,87.5815601104,90,9,>1K
3200,runners,1087,27176193,87.5850633592,90,7,>1K
3201,statewide,1086,27177279,87.588563385,90,9,>1K
3202,nelson,1086,27178365,87.5920634109,90,6,>1K
3203,awarded,1086,27179451,87.5955634368,90,7,>1K
3204,homeless,1086,27180537,87.5990634627,90,8,>1K
3205,messages,1085,27181622,87.6025602657,90,8,>1K
3206,german,1084,27182706,87.6060538459,90,6,>1K
3207,ross,1084,27183790,87.609547426,90,4,>1K
3208,gang,1084,27184874,87.6130410062,90,4,>1K
3209,asian,1083,27185957,87.6165313635,90,5,>1K
3210,managing,1082,27187039,87.6200184979,90,8,>1K
3211,consistent,1082,27188121,87.6235056324,90,10,>1K
3212,tribute,1082,27189203,87.6269927668,90,7,>1K
3213,russo,1081,27190284,87.6304766784,90,5,>1K
3214,gardens,1081,27191365,87.63396059,90,7,>1K
3215,regardless,1081,27192446,87.6374445015,90,10,>1K
3216,weak,1080,27193526,87.6409251903,90,4,>1K
3217,indian,1079,27194605,87.6444026561,90,6,>1K
3218,blvd,1079,27195684,87.647880122,90,4,>1K
3219,roberts,1079,27196763,87.6513575878,90,7,>1K
3220,competing,1079,27197842,87.6548350537,90,9,>1K
3221,unclear,1079,27198921,87.6583125196,90,7,>1K
3222,grants,1079,27200000,87.6617899854,90,6,>1K
3223,administrator,1078,27201078,87.6652642284,90,13,>1K
3224,pot,1078,27202156,87.6687384714,90,3,>1K
3225,homer,1077,27203233,87.6722094916,90,5,>1K
3226,wings,1076,27204309,87.6756772888,90,5,>1K
3227,dennis,1076,27205385,87.6791450861,90,6,>1K
3228,expanded,1075,27206460,87.6826096605,90,8,>1K
3229,scandal,1074,27207534,87.6860710121,90,7,>1K
3230,terry,1073,27208607,87.6895291408,90,5,>1K
3231,upcoming,1073,27209680,87.6929872695,90,8,>1K
3232,sessions,1073,27210753,87.6964453982,90,8,>1K
3233,recreation,1072,27211825,87.6999003041,90,10,>1K
3234,boss,1072,27212897,87.7033552099,90,4,>1K
3235,revenues,1071,27213968,87.7068068929,90,8,>1K
3236,supplies,1071,27215039,87.7102585759,90,8,>1K
3237,av,1071,27216110,87.7137102588,90,2,>1K
3238,clothes,1070,27217180,87.717158719,90,7,>1K
3239,1070,1070,27218250,87.7206071791,90,4,>1K
3240,ravens,1070,27219320,87.7240556392,90,6,>1K
3241,throws,1069,27220389,87.7275008765,90,6,>1K
3242,crews,1069,27221458,87.7309461137,90,5,>1K
3243,regularly,1068,27222526,87.7343881281,90,9,>1K
3244,gilbert,1068,27223594,87.7378301425,90,7,>1K
3245,findings,1065,27224659,87.7412624883,90,8,>1K
3246,joining,1065,27225724,87.7446948342,90,7,>1K
3247,scenes,1064,27226788,87.7481239571,90,6,>1K
3248,jimmy,1064,27227852,87.7515530801,90,5,>1K
3249,towns,1063,27228915,87.7549789802,90,5,>1K
3250,repair,1062,27229977,87.7584016574,90,6,>1K
3251,projected,1062,27231039,87.7618243347,90,9,>1K
3252,brooklyn,1061,27232100,87.765243789,90,8,>1K
3253,adopted,1060,27233160,87.7686600206,90,7,>1K
3254,minority,1059,27234219,87.7720730292,90,8,>1K
3255,disaster,1059,27235278,87.7754860379,90,8,>1K
3256,promote,1059,27236337,87.7788990466,90,7,>1K
3257,flights,1059,27237396,87.7823120552,90,7,>1K
3258,gallery,1058,27238454,87.785721841,90,7,>1K
3259,nhl,1057,27239511,87.789128404,90,3,>1K
3260,anymore,1057,27240568,87.7925349669,90,7,>1K
3261,pink,1056,27241624,87.795938307,90,4,>1K
3262,disappointed,1056,27242680,87.7993416471,90,12,>1K
3263,kyle,1055,27243735,87.8027417643,90,4,>1K
3264,alabama,1054,27244789,87.8061386586,90,7,>1K
3265,mixture,1054,27245843,87.809535553,90,7,>1K
3266,oven,1054,27246897,87.8129324474,90,4,>1K
3267,fisher,1054,27247951,87.8163293417,90,6,>1K
3268,controversial,1053,27249004,87.8197230132,90,13,>1K
3269,utah,1053,27250057,87.8231166847,90,4,>1K
3270,thick,1052,27251109,87.8265071334,90,5,>1K
3271,marks,1052,27252161,87.829897582,90,5,>1K
3272,gate,1051,27253212,87.8332848078,90,4,>1K
3273,childhood,1051,27254263,87.8366720336,90,9,>1K
3274,administrative,1051,27255314,87.8400592594,90,14,>1K
3275,backed,1050,27256364,87.8434432623,90,6,>1K
3276,criticized,1050,27257414,87.8468272652,90,10,>1K
3277,noting,1050,27258464,87.8502112681,90,6,>1K
3278,formed,1050,27259514,87.8535952711,90,6,>1K
3279,tall,1050,27260564,87.856979274,90,4,>1K
3280,mississippi,1048,27261612,87.8603568312,90,11,>1K
3281,parade,1048,27262660,87.8637343884,90,6,>1K
3282,ipad,1048,27263708,87.8671119456,90,4,>1K
3283,granted,1048,27264756,87.8704895028,90,7,>1K
3284,thrown,1048,27265804,87.87386706,90,6,>1K
3285,citing,1046,27266850,87.8772381715,90,6,>1K
3286,suspects,1045,27267895,87.8806060601,90,8,>1K
3287,sad,1045,27268940,87.8839739487,90,3,>1K
3288,desire,1045,27269985,87.8873418373,90,6,>1K
3289,encouraged,1044,27271029,87.8907065031,90,10,>1K
3290,text,1044,27272073,87.8940711689,90,4,>1K
3291,dean,1043,27273116,87.8974326118,90,4,>1K
3292,ties,1043,27274159,87.9007940547,90,4,>1K
3293,collect,1043,27275202,87.9041554976,90,7,>1K
3294,tested,1042,27276244,87.9075137176,90,6,>1K
3295,disabled,1042,27277286,87.9108719377,90,8,>1K
3296,memories,1041,27278327,87.9142269348,90,8,>1K
3297,survived,1041,27279368,87.917581932,90,8,>1K
3298,producer,1041,27280409,87.9209369292,90,8,>1K
3299,depth,1041,27281450,87.9242919264,90,5,>1K
3300,singing,1041,27282491,87.9276469236,90,7,>1K
3301,basically,1040,27283531,87.9309986979,90,9,>1K
3302,turnover,1040,27284571,87.9343504722,90,8,>1K
3303,besides,1040,27285611,87.9377022465,90,7,>1K
3304,mine,1039,27286650,87.941050798,90,4,>1K
3305,preparing,1038,27287688,87.9443961266,90,9,>1K
3306,lions,1038,27288726,87.9477414552,90,5,>1K
3307,mcdonald,1038,27289764,87.9510867838,90,8,>1K
3308,opponent,1037,27290801,87.9544288896,90,8,>1K
3309,meals,1036,27291837,87.9577677724,90,5,>1K
3310,detectives,1035,27292872,87.9611034325,90,10,>1K
3311,packed,1035,27293907,87.9644390925,90,6,>1K
3312,legacy,1034,27294941,87.9677715297,90,6,>1K
3313,teens,1034,27295975,87.9711039668,90,5,>1K
3314,grove,1034,27297009,87.974436404,90,5,>1K
3315,beauty,1034,27298043,87.9777688411,90,6,>1K
3316,rob,1033,27299076,87.9810980554,90,3,>1K
3317,averaged,1033,27300109,87.9844272698,90,8,>1K
3318,luxury,1033,27301142,87.9877564841,90,6,>1K
3319,newly,1032,27302174,87.9910824755,90,5,>1K
3320,walks,1030,27303204,87.9944020212,90,5,>1K
3321,treasury,1030,27304234,87.9977215669,90,8,>1K
3322,lease,1029,27305263,88.0010378898,90,5,>1K
3323,cafe,1029,27306292,88.0043542127,90,4,>1K
3324,tours,1028,27307320,88.0076673127,90,5,>1K
3325,supports,1028,27308348,88.0109804127,90,8,>1K
3326,deeply,1028,27309376,88.0142935127,90,6,>1K
3327,intelligence,1028,27310404,88.0176066127,90,12,>1K
3328,corps,1027,27311431,88.0209164898,90,5,>1K
3329,senator,1025,27312456,88.0242199213,90,7,>1K
3330,residential,1025,27313481,88.0275233527,90,11,>1K
3331,aimed,1024,27314505,88.0308235612,90,5,>1K
3332,canyon,1024,27315529,88.0341237698,90,6,>1K
3333,vowed,1023,27316552,88.0374207555,90,5,>1K
3334,thus,1021,27317573,88.0407112955,90,4,>1K
3335,extend,1019,27318592,88.0439953898,90,6,>1K
3336,hip,1019,27319611,88.047279484,90,3,>1K
3337,scientists,1018,27320629,88.0505603554,90,10,>1K
3338,sarah,1018,27321647,88.0538412268,90,5,>1K
3339,soup,1018,27322665,88.0571220982,90,4,>1K
3340,barbara,1017,27323682,88.0603997468,90,7,>1K
3341,lanes,1016,27324698,88.0636741725,90,5,>1K
3342,causes,1016,27325714,88.0669485982,90,6,>1K
3343,approached,1016,27326730,88.0702230238,90,10,>1K
3344,rarely,1016,27327746,88.0734974495,90,6,>1K
3345,tips,1015,27328761,88.0767686524,90,4,>1K
3346,exit,1015,27329776,88.0800398552,90,4,>1K
3347,managers,1015,27330791,88.083311058,90,8,>1K
3348,intense,1015,27331806,88.0865822608,90,7,>1K
3349,sgt,1014,27332820,88.0898502408,90,3,>1K
3350,dates,1014,27333834,88.0931182208,90,5,>1K
3351,airline,1013,27334847,88.0963829779,90,7,>1K
3352,scholarship,1012,27335859,88.0996445121,90,11,>1K
3353,requested,1012,27336871,88.1029060463,90,9,>1K
3354,stops,1011,27337882,88.1061643577,90,5,>1K
3355,screens,1011,27338893,88.1094226691,90,7,>1K
3356,chairs,1010,27339903,88.1126777576,90,6,>1K
3357,scheme,1010,27340913,88.1159328462,90,6,>1K
3358,thin,1009,27341922,88.1191847118,90,4,>1K
3359,delay,1009,27342931,88.1224365775,90,5,>1K
3360,honest,1009,27343940,88.1256884432,90,6,>1K
3361,somewhat,1009,27344949,88.1289403088,90,8,>1K
3362,aaron,1008,27345957,88.1321889516,90,5,>1K
3363,flood,1008,27346965,88.1354375944,90,5,>1K
3364,atmosphere,1008,27347973,88.1386862372,90,10,>1K
3365,salmon,1008,27348981,88.1419348801,90,6,>1K
3366,fought,1008,27349989,88.1451835229,90,6,>1K
3367,wash,1007,27350996,88.1484289428,90,4,>1K
3368,escape,1007,27352003,88.1516743627,90,6,>1K
3369,scale,1007,27353010,88.1549197827,90,5,>1K
3370,suspension,1007,27354017,88.1581652026,90,10,>1K
3371,referring,1006,27355023,88.1614073997,90,9,>1K
3372,designer,1006,27356029,88.1646495968,90,8,>1K
3373,significantly,1004,27357033,88.1678853482,90,13,>1K
3374,rural,1003,27358036,88.1711178767,90,5,>1K
3375,austin,1003,27359039,88.1743504052,90,6,>1K
3376,relatives,1003,27360042,88.1775829337,90,9,>1K
3377,duty,1003,27361045,88.1808154622,90,4,>1K
3378,forms,1002,27362047,88.1840447678,90,5,>1K
3379,liberty,1000,27363047,88.1872676278,90,7,>100
3380,1000,1000,27364047,88.1904904877,90,4,>100
3381,attending,1000,27365047,88.1937133476,90,9,>100
3382,somewhere,1000,27366047,88.1969362075,90,9,>100
3383,mph,998,27367045,88.2001526218,90,3,>100
3384,dispute,997,27368042,88.2033658131,90,7,>100
3385,smile,997,27369039,88.2065790044,90,5,>100
3386,brunswick,997,27370036,88.2097921958,90,9,>100
3387,oak,997,27371033,88.2130053871,90,3,>100
3388,coal,997,27372030,88.2162185785,90,4,>100
3389,civic,996,27373026,88.219428547,90,5,>100
3390,creation,996,27374022,88.2226385155,90,8,>100
3391,acts,996,27375018,88.2258484839,90,4,>100
3392,compromise,996,27376014,88.2290584524,90,10,>100
3393,qualify,995,27377009,88.2322651981,90,7,>100
3394,stake,995,27378004,88.2354719437,90,5,>100
3395,electronic,995,27378999,88.2386786893,90,10,>100
3396,targeted,995,27379994,88.2418854349,90,8,>100
3397,episode,995,27380989,88.2450921806,90,7,>100
3398,derby,994,27381983,88.2482957033,90,5,>100
3399,mail,994,27382977,88.2514992261,90,4,>100
3400,finishing,994,27383971,88.2547027489,90,9,>100
3401,actress,994,27384965,88.2579062716,90,7,>100
3402,jurors,993,27385958,88.2611065715,90,6,>100
3403,attract,993,27386951,88.2643068714,90,7,>100
3404,actors,993,27387944,88.2675071713,90,6,>100
3405,rangers,992,27388936,88.2707042484,90,7,>100
3406,pleased,992,27389928,88.2739013254,90,7,>100
3407,solo,991,27390919,88.2770951796,90,4,>100
3408,emerged,991,27391910,88.2802890338,90,7,>100
3409,essentially,991,27392901,88.283482888,90,11,>100
3410,riding,991,27393892,88.2866767422,90,6,>100
3411,privacy,991,27394883,88.2898705964,90,7,>100
3412,sr,990,27395873,88.2930612277,90,2,>100
3413,representative,990,27396863,88.296251859,90,14,>100
3414,writers,990,27397853,88.2994424904,90,7,>100
3415,nations,989,27398842,88.3026298988,90,7,>100
3416,teen,989,27399831,88.3058173073,90,4,>100
3417,developer,989,27400820,88.3090047158,90,9,>100
3418,funded,988,27401808,88.3121889014,90,6,>100
3419,defending,988,27402796,88.315373087,90,9,>100
3420,phones,988,27403784,88.3185572726,90,6,>100
3421,shelter,988,27404772,88.3217414582,90,7,>100
3422,perspective,987,27405759,88.3249224209,90,11,>100
3423,handling,987,27406746,88.3281033837,90,8,>100
3424,whiskey,987,27407733,88.3312843464,90,7,>100
3425,vast,987,27408720,88.3344653092,90,4,>100
3426,angry,987,27409707,88.3376462719,90,5,>100
3427,bases,986,27410693,88.3408240118,90,5,>100
3428,protein,986,27411679,88.3440017517,90,7,>100
3429,pujols,986,27412665,88.3471794916,90,6,>100
3430,korea,985,27413650,88.3503540086,90,5,>100
3431,pack,985,27414635,88.3535285256,90,4,>100
3432,agenda,984,27415619,88.3566998198,90,6,>100
3433,mills,984,27416603,88.359871114,90,5,>100
3434,discussed,984,27417587,88.3630424081,90,9,>100
3435,prefer,983,27418570,88.3662104794,90,6,>100
3436,filling,983,27419553,88.3693785507,90,7,>100
3437,lottery,983,27420536,88.3725466221,90,7,>100
3438,elite,982,27421518,88.3757114705,90,5,>100
3439,sky,982,27422500,88.3788763189,90,3,>100
3440,contribute,981,27423481,88.3820379445,90,10,>100
3441,overnight,981,27424462,88.3851995701,90,9,>100
3442,ratings,981,27425443,88.3883611957,90,7,>100
3443,facts,981,27426424,88.3915228213,90,5,>100
3444,forecast,981,27427405,88.3946844469,90,8,>100
3445,tip,980,27428385,88.3978428496,90,3,>100
3446,jonathan,979,27429364,88.4009980295,90,8,>100
3447,detective,979,27430343,88.4041532093,90,9,>100
3448,wore,979,27431322,88.4073083892,90,4,>100
3449,tools,979,27432301,88.4104635691,90,5,>100
3450,potatoes,978,27433279,88.4136155261,90,8,>100
3451,ownership,978,27434257,88.4167674831,90,9,>100
3452,crucial,977,27435234,88.4199162172,90,7,>100
3453,pursue,976,27436210,88.4230617285,90,6,>100
3454,estimate,976,27437186,88.4262072398,90,8,>100
3455,phil,976,27438162,88.4293527511,90,4,>100
3456,contrast,976,27439138,88.4324982624,90,8,>100
3457,obtained,976,27440114,88.4356437737,90,8,>100
3458,scottsdale,975,27441089,88.4387860621,90,10,>100
3459,pdt,974,27442063,88.4419251277,90,3,>100
3460,irish,974,27443037,88.4450641932,90,5,>100
3461,trained,974,27444011,88.4482032588,90,7,>100
3462,factory,974,27444985,88.4513423244,90,7,>100
3463,odds,974,27445959,88.4544813899,90,4,>100
3464,resolution,973,27446932,88.4576172327,90,10,>100
3465,insisted,973,27447905,88.4607530754,90,8,>100
3466,smoking,973,27448878,88.4638889181,90,7,>100
3467,concluded,973,27449851,88.4670247608,90,9,>100
3468,soul,973,27450824,88.4701606035,90,4,>100
3469,suspected,973,27451797,88.4732964462,90,9,>100
3470,settle,973,27452770,88.4764322889,90,6,>100
3471,graduated,973,27453743,88.4795681316,90,9,>100
3472,statistics,972,27454715,88.4827007515,90,10,>100
3473,aldridge,972,27455687,88.4858333713,90,8,>100
3474,temperature,972,27456659,88.4889659912,90,11,>100
3475,harbor,971,27457630,88.4920953881,90,6,>100
3476,hardly,970,27458600,88.4952215623,90,6,>100
3477,sean,970,27459570,88.4983477364,90,4,>100
3478,recruiting,968,27460538,88.5014674648,90,10,>100
3479,false,968,27461506,88.5045871932,90,5,>100
3480,damaged,968,27462474,88.5077069216,90,7,>100
3481,weapon,968,27463442,88.51082665,90,6,>100
3482,technical,967,27464409,88.5139431556,90,9,>100
3483,mcmillan,966,27465375,88.5170564383,90,8,>100
3484,elements,966,27466341,88.520169721,90,8,>100
3485,complicated,965,27467306,88.5232797808,90,11,>100
3486,rodriguez,965,27468271,88.5263898406,90,9,>100
3487,replacement,965,27469236,88.5294999004,90,11,>100
3488,danger,964,27470200,88.5326067374,90,6,>100
3489,charity,964,27471164,88.5357135744,90,7,>100
3490,auction,963,27472127,88.5388171885,90,7,>100
3491,select,963,27473090,88.5419208026,90,6,>100
3492,activists,963,27474053,88.5450244167,90,9,>100
3493,journey,963,27475016,88.5481280308,90,7,>100
3494,griffin,963,27475979,88.5512316449,90,7,>100
3495,landscape,963,27476942,88.554335259,90,9,>100
3496,asks,963,27477905,88.5574388731,90,4,>100
3497,mg,963,27478868,88.5605424873,90,2,>100
3498,linda,962,27479830,88.5636428785,90,5,>100
3499,nationally,962,27480792,88.5667432697,90,10,>100
3500,doug,962,27481754,88.569843661,90,4,>100
3501,blocked,961,27482715,88.5729408294,90,7,>100
3502,picking,960,27483675,88.5760347749,90,7,>100
3503,mistakes,960,27484635,88.5791287204,90,8,>100
3504,delivery,960,27485595,88.582222666,90,8,>100
3505,indicated,960,27486555,88.5853166115,90,9,>100
3506,reed,960,27487515,88.588410557,90,4,>100
3507,russia,960,27488475,88.5915045026,90,6,>100
3508,neighbor,960,27489435,88.5945984481,90,8,>100
3509,raw,959,27490394,88.5976891708,90,3,>100
3510,maintenance,958,27491352,88.6007766706,90,11,>100
3511,payroll,958,27492310,88.6038641704,90,7,>100
3512,friendly,957,27493267,88.6069484473,90,8,>100
3513,equal,957,27494224,88.6100327243,90,5,>100
3514,batting,956,27495180,88.6131137784,90,7,>100
3515,saints,954,27496134,88.6161883867,90,6,>100
3516,couples,954,27497088,88.6192629951,90,7,>100
3517,donated,953,27498041,88.6223343806,90,7,>100
3518,daughters,952,27498993,88.6254025433,90,9,>100
3519,robbery,952,27499945,88.6284707059,90,7,>100
3520,follows,952,27500897,88.6315388686,90,7,>100
3521,pet,952,27501849,88.6346070312,90,3,>100
3522,recommendations,952,27502801,88.6376751939,90,15,>100
3523,950,950,27503751,88.6407369108,90,3,>100
3524,yeah,950,27504701,88.6437986277,90,4,>100
3525,blow,950,27505651,88.6468603446,90,4,>100
3526,afraid,950,27506601,88.6499220616,90,6,>100
3527,handed,949,27507550,88.6529805556,90,6,>100
3528,devils,949,27508499,88.6560390497,90,6,>100
3529,pride,949,27509448,88.6590975438,90,5,>100
3530,climate,948,27510396,88.662152815,90,7,>100
3531,risks,948,27511344,88.6652080862,90,5,>100
3532,reforms,947,27512291,88.6682601346,90,7,>100
3533,rounds,947,27513238,88.6713121829,90,6,>100
3534,nbc,946,27514184,88.6743610084,90,3,>100
3535,waters,946,27515130,88.6774098339,90,6,>100
3536,fairly,945,27516075,88.6804554365,90,6,>100
3537,baseman,945,27517020,88.6835010391,90,7,>100
3538,opener,945,27517965,88.6865466418,90,6,>100
3539,iphone,945,27518910,88.6895922444,90,6,>100
3540,osu,944,27519854,88.6926346242,90,3,>100
3541,striking,944,27520798,88.6956770039,90,8,>100
3542,campbell,944,27521742,88.6987193837,90,8,>100
3543,routine,943,27522685,88.7017585406,90,7,>100
3544,tebow,943,27523628,88.7047976975,90,5,>100
3545,lakes,943,27524571,88.7078368544,90,5,>100
3546,proper,943,27525514,88.7108760114,90,6,>100
3547,opposite,943,27526457,88.7139151683,90,8,>100
3548,comfort,943,27527400,88.7169543252,90,7,>100
3549,conflict,942,27528342,88.7199902592,90,8,>100
3550,gathering,942,27529284,88.7230261933,90,9,>100
3551,applied,942,27530226,88.7260621273,90,7,>100
3552,foreclosure,942,27531168,88.7290980614,90,11,>100
3553,exhibit,942,27532110,88.7321339954,90,7,>100
3554,appreciate,942,27533052,88.7351699295,90,10,>100
3555,jewish,942,27533994,88.7382058635,90,6,>100
3556,advisory,942,27534936,88.7412417976,90,8,>100
3557,francis,941,27535877,88.7442745088,90,7,>100
3558,economists,941,27536818,88.74730722,90,10,>100
3559,flow,941,27537759,88.7503399312,90,4,>100
3560,heritage,940,27538699,88.7533694195,90,8,>100
3561,landed,940,27539639,88.7563989078,90,6,>100
3562,edward,940,27540579,88.7594283961,90,6,>100
3563,financing,940,27541519,88.7624578845,90,9,>100
3564,grace,939,27542458,88.7654841499,90,5,>100
3565,meets,939,27543397,88.7685104154,90,5,>100
3566,cooked,939,27544336,88.7715366809,90,6,>100
3567,tuition,938,27545274,88.7745597235,90,7,>100
3568,species,938,27546212,88.7775827661,90,7,>100
3569,starters,938,27547150,88.7806058087,90,8,>100
3570,charlie,938,27548088,88.7836288513,90,7,>100
3571,outcome,938,27549026,88.7866518939,90,7,>100
3572,importance,937,27549963,88.7896717137,90,10,>100
3573,loaded,937,27550900,88.7926915334,90,6,>100
3574,engaged,937,27551837,88.7957113532,90,7,>100
3575,runner,937,27552774,88.7987311729,90,6,>100
3576,protests,936,27553710,88.8017477698,90,8,>100
3577,causing,935,27554645,88.8047611439,90,7,>100
3578,furniture,935,27555580,88.8077745179,90,9,>100
3579,dancing,935,27556515,88.8107878919,90,7,>100
3580,viewers,934,27557449,88.8137980431,90,7,>100
3581,departments,934,27558383,88.8168081943,90,11,>100
3582,rent,934,27559317,88.8198183454,90,4,>100
3583,normally,934,27560251,88.8228284966,90,8,>100
3584,paris,934,27561185,88.8258386478,90,5,>100
3585,gasoline,934,27562119,88.8288487989,90,8,>100
3586,talented,934,27563053,88.8318589501,90,8,>100
3587,dismissed,933,27563986,88.8348658784,90,9,>100
3588,formal,933,27564919,88.8378728067,90,6,>100
3589,computers,933,27565852,88.840879735,90,9,>100
3590,proceeds,933,27566785,88.8438866634,90,8,>100
3591,situations,932,27567717,88.8468903688,90,10,>100
3592,covers,931,27568648,88.8498908514,90,6,>100
3593,colors,931,27569579,88.852891334,90,6,>100
3594,grilled,929,27570508,88.8558853709,90,7,>100
3595,officially,928,27571436,88.8588761849,90,10,>100
3596,permit,928,27572364,88.8618669989,90,6,>100
3597,roles,928,27573292,88.8648578129,90,5,>100
3598,medicaid,927,27574219,88.8678454041,90,8,>100
3599,balls,927,27575146,88.8708329952,90,5,>100
3600,requiring,927,27576073,88.8738205864,90,9,>100
3601,tries,927,27577000,88.8768081775,90,5,>100
3602,begun,927,27577927,88.8797957687,90,5,>100
3603,pilot,927,27578854,88.8827833598,90,5,>100
3604,amounts,926,27579780,88.8857677281,90,7,>100
3605,correct,926,27580706,88.8887520964,90,7,>100
3606,iii,926,27581632,88.8917364647,90,3,>100
3607,nursing,926,27582558,88.894720833,90,7,>100
3608,recording,926,27583484,88.8977052013,90,9,>100
3609,lay,925,27584409,88.9006863467,90,3,>100
3610,handled,925,27585334,88.9036674921,90,7,>100
3611,olympics,924,27586258,88.9066454147,90,8,>100
3612,vancouver,923,27587181,88.9096201144,90,9,>100
3613,rocky,923,27588104,88.9125948141,90,5,>100
3614,universities,923,27589027,88.9155695138,90,12,>100
3615,detail,921,27589948,88.9185377678,90,6,>100
3616,matthew,920,27590868,88.921502799,90,7,>100
3617,royal,920,27591788,88.9244678301,90,5,>100
3618,reaching,920,27592708,88.9274328612,90,8,>100
3619,solutions,920,27593628,88.9303978924,90,9,>100
3620,cooper,920,27594548,88.9333629235,90,6,>100
3621,complained,919,27595467,88.9363247318,90,10,>100
3622,appearances,919,27596386,88.93928654,90,11,>100
3623,reducing,919,27597305,88.9422483483,90,8,>100
3624,fundraising,919,27598224,88.9452101566,90,11,>100
3625,salaries,918,27599142,88.948168742,90,8,>100
3626,squad,918,27600060,88.9511273274,90,5,>100
3627,rbis,917,27600977,88.9540826899,90,4,>100
3628,generate,917,27601894,88.9570380525,90,8,>100
3629,averaging,916,27602810,88.9599901922,90,9,>100
3630,fried,916,27603726,88.9629423319,90,5,>100
3631,worldwide,915,27604641,88.9658912487,90,9,>100
3632,todd,915,27605556,88.9688401655,90,4,>100
3633,pg,914,27606470,88.9717858595,90,2,>100
3634,linked,914,27607384,88.9747315535,90,6,>100
3635,momentum,913,27608297,88.9776740246,90,8,>100
3636,opera,913,27609210,88.9806164957,90,5,>100
3637,thoughts,912,27610122,88.983555744,90,8,>100
3638,infrastructure,912,27611034,88.9864949922,90,14,>100
3639,rental,912,27611946,88.9894342405,90,6,>100
3640,beans,911,27612857,88.9923702659,90,5,>100
3641,illness,911,27613768,88.9953062913,90,7,>100
3642,911,911,27614679,88.9982423167,90,3,>100
3643,campaigns,910,27615589,89.0011751192,90,9,>100
3644,alongside,910,27616499,89.0041079217,90,9,>100
3645,sponsored,910,27617409,89.0070407243,90,9,>100
3646,arrive,910,27618319,89.0099735268,90,6,>100
3647,entry,910,27619229,89.0129063293,90,5,>100
3648,retailers,909,27620138,89.015835909,90,9,>100
3649,electricity,909,27621047,89.0187654887,90,11,>100
3650,foul,909,27621956,89.0216950683,90,4,>100
3651,apparent,909,27622865,89.024624648,90,8,>100
3652,defeat,909,27623774,89.0275542277,90,6,>100
3653,discussions,909,27624683,89.0304838074,90,11,>100
3654,neck,909,27625592,89.033413387,90,4,>100
3655,eliminate,909,27626501,89.0363429667,90,9,>100
3656,reportedly,908,27627409,89.0392693235,90,10,>100
3657,capable,908,27628317,89.0421956803,90,7,>100
3658,prominent,908,27629225,89.0451220371,90,9,>100
3659,partly,907,27630132,89.0480451711,90,6,>100
3660,violation,906,27631038,89.0509650822,90,9,>100
3661,girlfriend,906,27631944,89.0538849933,90,10,>100
3662,entrance,906,27632850,89.0568049044,90,8,>100
3663,drafted,906,27633756,89.0597248155,90,7,>100
3664,attendance,906,27634662,89.0626447266,90,10,>100
3665,queen,905,27635567,89.0655614148,90,5,>100
3666,reflect,905,27636472,89.068478103,90,7,>100
3667,plot,904,27637376,89.0713915684,90,4,>100
3668,alliance,903,27638279,89.0743018109,90,8,>100
3669,survive,903,27639182,89.0772120534,90,7,>100
3670,shops,903,27640085,89.0801222959,90,5,>100
3671,probation,903,27640988,89.0830325384,90,9,>100
3672,somehow,902,27641890,89.0859395581,90,7,>100
3673,surprising,902,27642792,89.0888465778,90,10,>100
3674,glad,901,27643693,89.0917503745,90,4,>100
3675,controlled,901,27644594,89.0946541713,90,10,>100
3676,plates,900,27645494,89.0975547453,90,6,>100
3677,900,900,27646394,89.1004553192,90,3,>100
3678,oversight,900,27647294,89.1033558931,90,9,>100
3679,developers,900,27648194,89.1062564671,90,10,>100
3680,bunch,899,27649093,89.1091538181,90,5,>100
3681,midnight,899,27649992,89.1120511692,90,8,>100
3682,offseason,898,27650890,89.1149452974,90,9,>100
3683,properly,898,27651788,89.1178394256,90,8,>100
3684,colleges,898,27652686,89.1207335539,90,8,>100
3685,donald,897,27653583,89.1236244592,90,6,>100
3686,intent,897,27654480,89.1265153646,90,6,>100
3687,cruise,897,27655377,89.1294062699,90,6,>100
3688,independence,897,27656274,89.1322971753,90,12,>100
3689,felony,896,27657170,89.1351848578,90,6,>100
3690,relationships,896,27658066,89.1380725403,90,13,>100
3691,securities,896,27658962,89.1409602228,90,10,>100
3692,bottles,895,27659857,89.1438446824,90,7,>100
3693,nominee,894,27660751,89.1467259192,90,7,>100
3694,maximum,893,27661644,89.1496039331,90,7,>100
3695,submitted,893,27662537,89.152481947,90,9,>100
3696,tennessee,892,27663429,89.155356738,90,9,>100
3697,afterward,892,27664321,89.1582315291,90,9,>100
3698,plea,891,27665212,89.1611030973,90,4,>100
3699,steady,891,27666103,89.1639746655,90,6,>100
3700,defeated,891,27666994,89.1668462337,90,8,>100
3701,layoffs,890,27667884,89.169714579,90,7,>100
3702,hate,889,27668773,89.1725797015,90,4,>100
3703,hike,889,27669662,89.175444824,90,4,>100
3704,pays,889,27670551,89.1783099464,90,4,>100
3705,detailed,889,27671440,89.1811750689,90,8,>100
3706,meyer,888,27672328,89.1840369685,90,5,>100
3707,pipeline,887,27673215,89.1868956453,90,8,>100
3708,concrete,886,27674101,89.1897510992,90,8,>100
3709,indictment,886,27674987,89.1926065531,90,10,>100
3710,citizen,886,27675873,89.195462007,90,7,>100
3711,investigate,886,27676759,89.1983174609,90,11,>100
3712,tape,884,27677643,89.201166469,90,4,>100
3713,hang,884,27678527,89.2040154772,90,4,>100
3714,clubs,883,27679410,89.2068612625,90,5,>100
3715,blog,883,27680293,89.2097070478,90,4,>100
3716,hanging,883,27681176,89.2125528331,90,7,>100
3717,pie,883,27682059,89.2153986185,90,3,>100
3718,counter,882,27682941,89.2182411809,90,7,>100
3719,recovered,882,27683823,89.2210837434,90,9,>100
3720,answered,882,27684705,89.2239263058,90,8,>100
3721,tone,882,27685587,89.2267688683,90,4,>100
3722,gifts,882,27686469,89.2296114307,90,5,>100
3723,twin,882,27687351,89.2324539932,90,4,>100
3724,evans,881,27688232,89.2352933328,90,5,>100
3725,sits,881,27689113,89.2381326724,90,4,>100
3726,mouth,881,27689994,89.240972012,90,5,>100
3727,lt,881,27690875,89.2438113516,90,2,>100
3728,tribune,881,27691756,89.2466506912,90,7,>100
3729,resulted,881,27692637,89.2494900308,90,8,>100
3730,strip,881,27693518,89.2523293704,90,5,>100
3731,roots,880,27694398,89.2551654871,90,5,>100
3732,cheap,880,27695278,89.2580016038,90,5,>100
3733,prospects,880,27696158,89.2608377206,90,9,>100
3734,screening,880,27697038,89.2636738373,90,9,>100
3735,describe,880,27697918,89.266509954,90,8,>100
3736,lawrence,880,27698798,89.2693460708,90,8,>100
3737,cleared,880,27699678,89.2721821875,90,7,>100
3738,roger,880,27700558,89.2750183042,90,5,>100
3739,holes,879,27701437,89.2778511981,90,5,>100
3740,cavs,878,27702315,89.2806808691,90,4,>100
3741,dreams,877,27703192,89.2835073173,90,6,>100
3742,wave,877,27704069,89.2863337654,90,4,>100
3743,nancy,876,27704945,89.2891569907,90,5,>100
3744,fare,876,27705821,89.291980216,90,4,>100
3745,chest,876,27706697,89.2948034413,90,5,>100
3746,tender,876,27707573,89.2976266666,90,6,>100
3747,industries,876,27708449,89.3004498919,90,10,>100
3748,shrimp,876,27709325,89.3032731172,90,6,>100
3749,horses,875,27710200,89.3060931196,90,6,>100
3750,kicked,875,27711075,89.3089131221,90,6,>100
3751,everywhere,875,27711950,89.3117331245,90,10,>100
3752,organizers,873,27712823,89.3145466812,90,10,>100
3753,referred,873,27713696,89.3173602379,90,8,>100
3754,valuable,873,27714569,89.3201737947,90,8,>100
3755,wealthy,872,27715441,89.3229841285,90,7,>100
3756,cups,871,27716312,89.3257912395,90,4,>100
3757,treating,871,27717183,89.3285983505,90,8,>100
3758,feed,871,27718054,89.3314054615,90,4,>100
3759,contacted,870,27718924,89.3342093496,90,9,>100
3760,antonio,870,27719794,89.3370132378,90,7,>100
3761,garcia,870,27720664,89.3398171259,90,6,>100
3762,defendants,870,27721534,89.342621014,90,10,>100
3763,perfectly,869,27722403,89.3454216793,90,9,>100
3764,donors,869,27723272,89.3482223446,90,6,>100
3765,mesa,869,27724141,89.3510230099,90,4,>100
3766,dressed,868,27725009,89.3538204523,90,7,>100
3767,commit,868,27725877,89.3566178947,90,6,>100
3768,carlos,868,27726745,89.3594153371,90,6,>100
3769,interviewed,867,27727612,89.3622095567,90,11,>100
3770,clayton,866,27728478,89.3650005534,90,7,>100
3771,primarily,866,27729344,89.3677915501,90,9,>100
3772,consulting,866,27730210,89.3705825468,90,10,>100
3773,totally,866,27731076,89.3733735435,90,7,>100
3774,sisters,866,27731942,89.3761645401,90,7,>100
3775,lessons,866,27732808,89.3789555368,90,7,>100
3776,beijing,865,27733673,89.3817433107,90,7,>100
3777,ted,865,27734538,89.3845310845,90,3,>100
3778,defend,864,27735402,89.3873156355,90,6,>100
3779,iron,864,27736266,89.3901001865,90,4,>100
3780,fred,864,27737130,89.3928847374,90,4,>100
3781,checked,864,27737994,89.3956692884,90,7,>100
3782,rolled,864,27738858,89.3984538394,90,6,>100
3783,doubled,861,27739719,89.4012287218,90,7,>100
3784,abandoned,861,27740580,89.4040036042,90,9,>100
3785,constantly,860,27741440,89.4067752637,90,10,>100
3786,joy,859,27742299,89.4095437004,90,3,>100
3787,overseas,859,27743158,89.4123121371,90,8,>100
3788,telephone,859,27744017,89.4150805738,90,9,>100
3789,fiber,859,27744876,89.4178490104,90,5,>100
3790,afghan,859,27745735,89.4206174471,90,6,>100
3791,preserve,858,27746593,89.4233826609,90,8,>100
3792,grounds,857,27747450,89.4261446519,90,7,>100
3793,hosted,857,27748307,89.4289066428,90,6,>100
3794,sand,856,27749163,89.4316654109,90,4,>100
3795,dating,856,27750019,89.434424179,90,6,>100
3796,qualified,855,27750874,89.4371797243,90,9,>100
3797,promises,854,27751728,89.4399320466,90,8,>100
3798,traveled,854,27752582,89.442684369,90,8,>100
3799,backup,854,27753436,89.4454366914,90,6,>100
3800,athlete,854,27754290,89.4481890138,90,7,>100
3801,champions,853,27755143,89.4509381133,90,9,>100
3802,penalties,853,27755996,89.4536872128,90,9,>100
3803,corn,852,27756848,89.4564330895,90,4,>100
3804,spencer,852,27757700,89.4591789661,90,7,>100
3805,memphis,852,27758552,89.4619248428,90,7,>100
3806,maker,852,27759404,89.4646707194,90,5,>100
3807,counsel,852,27760256,89.4674165961,90,7,>100
3808,surrounded,851,27761107,89.4701592499,90,10,>100
3809,diagnosed,851,27761958,89.4729019037,90,9,>100
3810,briefly,851,27762809,89.4756445575,90,7,>100
3811,warrant,851,27763660,89.4783872113,90,7,>100
3812,trials,850,27764510,89.4811266422,90,6,>100
3813,baker,850,27765360,89.4838660732,90,5,>100
3814,850,850,27766210,89.4866055041,90,3,>100
3815,guns,850,27767060,89.489344935,90,4,>100
3816,marshall,849,27767909,89.4920811431,90,8,>100
3817,occasionally,849,27768758,89.4948173512,90,12,>100
3818,installed,849,27769607,89.4975535593,90,9,>100
3819,figured,849,27770456,89.5002897673,90,7,>100
3820,incidents,849,27771305,89.5030259754,90,9,>100
3821,requirement,848,27772153,89.5057589606,90,11,>100
3822,modest,848,27773001,89.5084919458,90,6,>100
3823,experiences,848,27773849,89.5112249311,90,11,>100
3824,sorry,848,27774697,89.5139579163,90,5,>100
3825,bands,848,27775545,89.5166909015,90,5,>100
3826,lisa,847,27776392,89.5194206639,90,4,>100
3827,arrests,847,27777239,89.5221504262,90,7,>100
3828,brad,847,27778086,89.5248801886,90,4,>100
3829,acquired,847,27778933,89.5276099509,90,8,>100
3830,poverty,846,27779779,89.5303364904,90,7,>100
3831,va,846,27780625,89.5330630299,90,2,>100
3832,achieve,846,27781471,89.5357895694,90,7,>100
3833,essential,846,27782317,89.5385161089,90,9,>100
3834,census,846,27783163,89.5412426484,90,6,>100
3835,cholesterol,845,27784008,89.5439659651,90,11,>100
3836,indoor,845,27784853,89.5466892817,90,6,>100
3837,bet,845,27785698,89.5494125983,90,3,>100
3838,grocery,844,27786542,89.5521326921,90,7,>100
3839,lift,844,27787386,89.5548527859,90,4,>100
3840,arguments,844,27788230,89.5575728797,90,9,>100
3841,britain,844,27789074,89.5602929734,90,7,>100
3842,appointment,842,27789916,89.5630066215,90,11,>100
3843,alexander,842,27790758,89.5657202696,90,9,>100
3844,rivals,842,27791600,89.5684339176,90,6,>100
3845,prescription,842,27792442,89.5711475657,90,12,>100
3846,chandler,842,27793284,89.5738612137,90,8,>100
3847,covering,841,27794125,89.5765716389,90,8,>100
3848,douglas,841,27794966,89.5792820641,90,7,>100
3849,soil,840,27795806,89.5819892665,90,4,>100
3850,involvement,840,27796646,89.5846964688,90,11,>100
3851,captured,840,27797486,89.5874036711,90,8,>100
3852,hawks,840,27798326,89.5901108735,90,5,>100
3853,link,839,27799165,89.5928148529,90,4,>100
3854,prep,839,27800004,89.5955188324,90,4,>100
3855,gambling,838,27800842,89.598219589,90,8,>100
3856,russian,837,27801679,89.6009171228,90,7,>100
3857,llc,837,27802516,89.6036146566,90,3,>100
3858,letting,836,27803352,89.6063089675,90,7,>100
3859,loud,836,27804188,89.6090032784,90,4,>100
3860,dessert,836,27805024,89.6116975893,90,7,>100
3861,reduction,835,27805859,89.6143886773,90,9,>100
3862,creates,835,27806694,89.6170797653,90,7,>100
3863,michelle,835,27807529,89.6197708534,90,8,>100
3864,storage,835,27808364,89.6224619414,90,7,>100
3865,riley,835,27809199,89.6251530294,90,5,>100
3866,destination,835,27810034,89.6278441175,90,11,>100
3867,ct,834,27810868,89.6305319827,90,2,>100
3868,fitzgerald,834,27811702,89.6332198478,90,10,>100
3869,wound,834,27812536,89.635907713,90,5,>100
3870,patriots,834,27813370,89.6385955782,90,8,>100
3871,oregonian,833,27814203,89.6412802205,90,9,>100
3872,prevention,833,27815036,89.6439648628,90,10,>100
3873,forever,832,27815868,89.6466462823,90,7,>100
3874,farms,832,27816700,89.6493277018,90,5,>100
3875,achievement,832,27817532,89.6520091212,90,11,>100
3876,procedures,831,27818363,89.6546873178,90,10,>100
3877,utilities,831,27819194,89.6573655144,90,9,>100
3878,carefully,830,27820024,89.6600404881,90,9,>100
3879,papers,829,27820853,89.662712239,90,6,>100
3880,deserve,829,27821682,89.6653839899,90,7,>100
3881,locked,828,27822510,89.6680525179,90,6,>100
3882,symptoms,828,27823338,89.6707210459,90,8,>100
3883,frame,828,27824166,89.673389574,90,5,>100
3884,engineers,828,27824994,89.676058102,90,9,>100
3885,bacon,828,27825822,89.67872663,90,5,>100
3886,guidelines,827,27826649,89.6813919352,90,10,>100
3887,teammate,825,27827474,89.6840507946,90,8,>100
3888,pakistan,825,27828299,89.686709654,90,8,>100
3889,predicted,825,27829124,89.6893685135,90,9,>100
3890,unknown,825,27829949,89.6920273729,90,7,>100
3891,keith,824,27830773,89.6946830095,90,5,>100
3892,mo,824,27831597,89.6973386461,90,2,>100
3893,stated,823,27832420,89.6999910598,90,6,>100
3894,greek,823,27833243,89.7026434735,90,5,>100
3895,establish,823,27834066,89.7052958872,90,9,>100
3896,zero,822,27834888,89.7079450781,90,4,>100
3897,informed,822,27835710,89.7105942689,90,8,>100
3898,broadcast,822,27836532,89.7132434598,90,9,>100
3899,margin,822,27837354,89.7158926507,90,6,>100
3900,conversations,821,27838175,89.7185386187,90,13,>100
3901,personality,820,27838995,89.7211813638,90,11,>100
3902,backs,820,27839815,89.7238241089,90,5,>100
3903,trash,819,27840634,89.7264636312,90,5,>100
3904,stir,819,27841453,89.7291031535,90,4,>100
3905,oscar,819,27842272,89.7317426758,90,5,>100
3906,activist,819,27843091,89.7343821981,90,8,>100
3907,convinced,819,27843910,89.7370217203,90,9,>100
3908,depression,818,27844728,89.7396580198,90,10,>100
3909,saving,818,27845546,89.7422943192,90,6,>100
3910,extensive,818,27846364,89.7449306186,90,9,>100
3911,courtroom,817,27847181,89.7475636952,90,9,>100
3912,cruz,817,27847998,89.7501967717,90,4,>100
3913,remarks,816,27848814,89.7528266254,90,7,>100
3914,sweeney,816,27849630,89.7554564791,90,7,>100
3915,guitar,816,27850446,89.7580863328,90,6,>100
3916,brady,816,27851262,89.7607161865,90,5,>100
3917,euro,815,27852077,89.7633428174,90,4,>100
3918,app,814,27852891,89.7659662253,90,3,>100
3919,ankle,814,27853705,89.7685896333,90,5,>100
3920,vintage,814,27854519,89.7712130413,90,7,>100
3921,organic,814,27855333,89.7738364493,90,7,>100
3922,murphy,813,27856146,89.7764566344,90,6,>100
3923,ethics,813,27856959,89.7790768195,90,6,>100
3924,noise,812,27857771,89.7816937818,90,5,>100
3925,incentives,812,27858583,89.784310744,90,10,>100
3926,onion,811,27859394,89.7869244834,90,5,>100
3927,invest,811,27860205,89.7895382228,90,6,>100
3928,clock,811,27861016,89.7921519622,90,5,>100
3929,administrators,810,27861826,89.7947624788,90,14,>100
3930,earthquake,810,27862636,89.7973729953,90,10,>100
3931,hearings,809,27863445,89.799980289,90,8,>100
3932,timing,809,27864254,89.8025875827,90,6,>100
3933,divorce,809,27865063,89.8051948763,90,7,>100
3934,mad,809,27865872,89.80780217,90,3,>100
3935,lists,809,27866681,89.8104094637,90,5,>100
3936,republic,808,27867489,89.8130135345,90,8,>100
3937,lined,808,27868297,89.8156176053,90,5,>100
3938,steak,807,27869104,89.8182184533,90,5,>100
3939,aircraft,807,27869911,89.8208193013,90,8,>100
3940,rivers,806,27870717,89.8234169264,90,6,>100
3941,communication,806,27871523,89.8260145515,90,13,>100
3942,wrapped,805,27872328,89.8286089537,90,7,>100
3943,engineer,805,27873133,89.831203356,90,8,>100
3944,banking,805,27873938,89.8337977582,90,7,>100
3945,virtually,805,27874743,89.8363921604,90,9,>100
3946,butler,805,27875548,89.8389865627,90,6,>100
3947,chopped,805,27876353,89.8415809649,90,7,>100
3948,pulling,805,27877158,89.8441753672,90,7,>100
3949,nervous,805,27877963,89.8467697694,90,7,>100
3950,departure,804,27878767,89.8493609488,90,9,>100
3951,command,804,27879571,89.8519521282,90,7,>100
3952,rely,804,27880375,89.8545433075,90,4,>100
3953,wing,803,27881178,89.8571312641,90,4,>100
3954,jake,802,27881980,89.8597159977,90,4,>100
3955,deputies,802,27882782,89.8623007314,90,8,>100
3956,landing,802,27883584,89.864885465,90,7,>100
3957,cats,802,27884386,89.8674701987,90,4,>100
3958,sporting,802,27885188,89.8700549324,90,8,>100
3959,literally,801,27885989,89.8726364432,90,9,>100
3960,800,800,27886789,89.8752147311,90,3,>100
3961,puck,800,27887589,89.877793019,90,4,>100
3962,exposure,800,27888389,89.880371307,90,8,>100
3963,tasting,800,27889189,89.8829495949,90,7,>100
3964,temperatures,800,27889989,89.8855278829,90,12,>100
3965,divided,799,27890788,89.8881029479,90,7,>100
3966,supervisor,799,27891587,89.890678013,90,10,>100
3967,rotation,799,27892386,89.8932530781,90,8,>100
3968,therapy,799,27893185,89.8958281432,90,7,>100
3969,tomatoes,799,27893984,89.8984032083,90,8,>100
3970,eagles,799,27894783,89.9009782733,90,6,>100
3971,narrow,799,27895582,89.9035533384,90,6,>100
3972,dodgers,798,27896380,89.9061251806,90,7,>100
3973,consequences,798,27897178,89.9086970229,90,12,>100
3974,highlights,798,27897976,89.9112688651,90,10,>100
3975,aging,798,27898774,89.9138407073,90,5,>100
3976,ordinance,798,27899572,89.9164125495,90,9,>100
3977,quit,798,27900370,89.9189843918,90,4,>100
3978,pasta,797,27901167,89.9215530111,90,5,>100
3979,careful,796,27901963,89.9241184076,90,7,>100
3980,usc,796,27902759,89.9266838041,90,3,>100
3981,tears,796,27903555,89.9292492006,90,5,>100
3982,gallon,796,27904351,89.9318145971,90,6,>100
3983,personally,796,27905147,89.9343799936,90,10,>100
3984,laugh,796,27905943,89.9369453901,90,5,>100
3985,cubs,796,27906739,89.9395107866,90,4,>100
3986,africa,795,27907534,89.9420729603,90,6,>100
3987,lab,795,27908329,89.9446351339,90,3,>100
3988,harrison,795,27909124,89.9471973075,90,8,>100
3989,addressed,795,27909919,89.9497594812,90,9,>100
3990,involves,794,27910713,89.952318432,90,8,>100
3991,basket,794,27911507,89.9548773827,90,6,>100
3992,jessica,793,27912300,89.9574331107,90,7,>100
3993,string,793,27913093,89.9599888386,90,6,>100
3994,equally,793,27913886,89.9625445665,90,7,>100
3995,baking,793,27914679,89.9651002944,90,6,>100
3996,pickup,792,27915471,89.9676527995,90,6,>100
3997,investigations,791,27916262,89.9702020817,90,14,>100
3998,musicians,791,27917053,89.9727513639,90,9,>100
3999,economist,791,27917844,89.9753006461,90,9,>100
4000,residence,791,27918635,89.9778499283,90,9,>100
4001,differences,791,27919426,89.9803992105,90,11,>100
4002,tool,791,27920217,89.9829484927,90,4,>100
4003,blake,790,27921007,89.985494552,90,5,>100
4004,tunnel,790,27921797,89.9880406114,90,6,>100
4005,expense,789,27922586,89.9905834479,_100,7,>100
4006,cat,789,27923375,89.9931262843,_100,3,>100
4007,bomb,788,27924163,89.995665898,_100,4,>100
4008,sued,788,27924951,89.9982055116,_100,4,>100
4009,demands,788,27925739,90.0007451252,_100,7,>100
4010,mess,787,27926526,90.003281516,_100,4,>100
4011,sanchez,786,27927312,90.0058146839,_100,7,>100
4012,nose,786,27928098,90.0083478518,_100,4,>100
4013,conviction,786,27928884,90.0108810197,_100,10,>100
4014,expanding,786,27929670,90.0134141876,_100,9,>100
4015,anne,785,27930455,90.0159441326,_100,4,>100
4016,ceiling,785,27931240,90.0184740777,_100,7,>100
4017,brooks,785,27932025,90.0210040227,_100,6,>100
4018,household,785,27932810,90.0235339678,_100,9,>100
4019,liberal,784,27933594,90.0260606899,_100,7,>100
4020,approximately,784,27934378,90.0285874121,_100,13,>100
4021,phase,784,27935162,90.0311141343,_100,5,>100
4022,spotted,784,27935946,90.0336408565,_100,7,>100
4023,granite,784,27936730,90.0361675787,_100,7,>100
4024,drives,784,27937514,90.0386943008,_100,6,>100
4025,grandmother,784,27938298,90.041221023,_100,11,>100
4026,alan,784,27939082,90.0437477452,_100,4,>100
4027,ranging,783,27939865,90.0462712445,_100,7,>100
4028,tremendous,783,27940648,90.0487947439,_100,10,>100
4029,levy,783,27941431,90.0513182432,_100,4,>100
4030,sponsor,783,27942214,90.0538417425,_100,7,>100
4031,honored,782,27942996,90.056362019,_100,7,>100
4032,harm,782,27943778,90.0588822954,_100,4,>100
4033,presentation,782,27944560,90.0614025719,_100,12,>100
4034,mentor,781,27945341,90.0639196255,_100,6,>100
4035,resigned,781,27946122,90.0664366791,_100,8,>100
4036,waited,781,27946903,90.0689537327,_100,6,>100
4037,lawsuits,780,27947683,90.0714675634,_100,8,>100
4038,beavers,780,27948463,90.0739813942,_100,7,>100
4039,strikes,780,27949243,90.0764952249,_100,7,>100
4040,painting,780,27950023,90.0790090557,_100,8,>100
4041,ideal,780,27950803,90.0815228864,_100,5,>100
4042,machines,779,27951582,90.0840334943,_100,8,>100
4043,celebrity,779,27952361,90.0865441022,_100,9,>100
4044,controversy,779,27953140,90.08905471,_100,11,>100
4045,diabetes,779,27953919,90.0915653179,_100,8,>100
4046,repeat,779,27954698,90.0940759258,_100,6,>100
4047,fitness,778,27955476,90.0965833108,_100,7,>100
4048,laura,778,27956254,90.0990906959,_100,5,>100
4049,repeated,778,27957032,90.1015980809,_100,8,>100
4050,amy,778,27957810,90.1041054659,_100,3,>100
4051,regulation,777,27958587,90.1066096281,_100,10,>100
4052,absence,777,27959364,90.1091137902,_100,7,>100
4053,halftime,777,27960141,90.1116179524,_100,8,>100
4054,wording,777,27960918,90.1141221145,_100,7,>100
4055,matches,777,27961695,90.1166262767,_100,7,>100
4056,recommend,777,27962472,90.1191304389,_100,9,>100
4057,bedroom,776,27963248,90.1216313782,_100,7,>100
4058,operates,776,27964024,90.1241323175,_100,8,>100
4059,impressed,776,27964800,90.1266332568,_100,9,>100
4060,nurse,775,27965575,90.1291309732,_100,5,>100
4061,shareholders,775,27966350,90.1316286897,_100,12,>100
4062,forcing,775,27967125,90.1341264061,_100,7,>100
4063,cameron,775,27967900,90.1366241226,_100,7,>100
4064,announce,774,27968674,90.1391186161,_100,8,>100
4065,bat,774,27969448,90.1416131097,_100,3,>100
4066,effectively,773,27970221,90.1441043804,_100,11,>100
4067,burden,773,27970994,90.1465956512,_100,6,>100
4068,contain,773,27971767,90.1490869219,_100,7,>100
4069,humor,773,27972540,90.1515781926,_100,5,>100
4070,oldest,773,27973313,90.1540694633,_100,6,>100
4071,onions,773,27974086,90.1565607341,_100,6,>100
4072,lamb,773,27974859,90.1590520048,_100,4,>100
4073,enrollment,773,27975632,90.1615432755,_100,10,>100
4074,cuisine,772,27976404,90.1640313234,_100,7,>100
4075,voter,772,27977176,90.1665193712,_100,5,>100
4076,feelings,772,27977948,90.1690074191,_100,8,>100
4077,succeed,772,27978720,90.171495467,_100,7,>100
4078,combat,772,27979492,90.1739835148,_100,6,>100
4079,victories,771,27980263,90.1764683398,_100,9,>100
4080,exist,771,27981034,90.1789531648,_100,5,>100
4081,ease,770,27981804,90.181434767,_100,4,>100
4082,religion,770,27982574,90.1839163691,_100,8,>100
4083,bone,770,27983344,90.1863979712,_100,4,>100
4084,judgment,770,27984114,90.1888795734,_100,8,>100
4085,advocate,769,27984883,90.1913579527,_100,8,>100
4086,saves,769,27985652,90.193836332,_100,5,>100
4087,budgets,769,27986421,90.1963147112,_100,7,>100
4088,monitor,769,27987190,90.1987930905,_100,7,>100
4089,grab,768,27987958,90.2012682469,_100,4,>100
4090,operated,768,27988726,90.2037434034,_100,8,>100
4091,label,768,27989494,90.2062185598,_100,5,>100
4092,explore,768,27990262,90.2086937162,_100,7,>100
4093,twins,767,27991029,90.2111656498,_100,5,>100
4094,restrictions,767,27991796,90.2136375833,_100,12,>100
4095,faculty,767,27992563,90.2161095169,_100,7,>100
4096,interim,767,27993330,90.2185814505,_100,7,>100
4097,senators,766,27994096,90.2210501612,_100,8,>100
4098,sells,766,27994862,90.2235188719,_100,5,>100
4099,nashville,766,27995628,90.2259875826,_100,9,>100
4100,troubled,766,27996394,90.2284562933,_100,8,>100
4101,notre,766,27997160,90.230925004,_100,5,>100
4102,powers,765,27997925,90.2333904918,_100,6,>100
4103,def,765,27998690,90.2358559797,_100,3,>100
4104,searching,765,27999455,90.2383214675,_100,9,>100
4105,focusing,765,28000220,90.2407869554,_100,8,>100
4106,attacked,765,28000985,90.2432524432,_100,8,>100
4107,occur,765,28001750,90.245717931,_100,5,>100
4108,rushing,764,28002514,90.248180196,_100,7,>100
4109,barnes,764,28003278,90.250642461,_100,6,>100
4110,bargaining,764,28004042,90.253104726,_100,10,>100
4111,eliminated,764,28004806,90.255566991,_100,10,>100
4112,exposed,764,28005570,90.258029256,_100,7,>100
4113,grabbed,764,28006334,90.2604915209,_100,7,>100
4114,trillion,763,28007097,90.2629505631,_100,8,>100
4115,symphony,763,28007860,90.2654096052,_100,8,>100
4116,smooth,763,28008623,90.2678686473,_100,6,>100
4117,expecting,763,28009386,90.2703276894,_100,9,>100
4118,resume,763,28010149,90.2727867316,_100,6,>100
4119,cherry,763,28010912,90.2752457737,_100,6,>100
4120,conspiracy,763,28011675,90.2777048158,_100,10,>100
4121,homers,763,28012438,90.2801638579,_100,6,>100
4122,connect,762,28013200,90.2826196772,_100,7,>100
4123,winds,762,28013962,90.2850754965,_100,5,>100
4124,trustees,762,28014724,90.2875313157,_100,8,>100
4125,dna,762,28015486,90.289987135,_100,3,>100
4126,fielder,761,28016247,90.2924397314,_100,7,>100
4127,backing,761,28017008,90.2948923278,_100,7,>100
4128,uniform,761,28017769,90.2973449242,_100,7,>100
4129,flag,761,28018530,90.2997975206,_100,4,>100
4130,buckeyes,761,28019291,90.302250117,_100,8,>100
4131,switch,761,28020052,90.3047027134,_100,6,>100
4132,gym,761,28020813,90.3071553098,_100,3,>100
4133,rev,759,28021572,90.3096014605,_100,3,>100
4134,toronto,759,28022331,90.3120476112,_100,7,>100
4135,thanksgiving,759,28023090,90.3144937619,_100,12,>100
4136,simon,759,28023849,90.3169399125,_100,5,>100
4137,gear,759,28024608,90.3193860632,_100,4,>100
4138,stanley,758,28025366,90.3218289911,_100,7,>100
4139,contains,758,28026124,90.3242719189,_100,8,>100
4140,exception,757,28026881,90.3267116238,_100,9,>100
4141,recover,757,28027638,90.3291513288,_100,7,>100
4142,videos,756,28028394,90.3315878109,_100,6,>100
4143,inflation,756,28029150,90.334024293,_100,9,>100
4144,recipes,756,28029906,90.3364607751,_100,7,>100
4145,barry,756,28030662,90.3388972572,_100,5,>100
4146,consistently,756,28031418,90.3413337393,_100,12,>100
4147,eager,756,28032174,90.3437702214,_100,5,>100
4148,bryan,755,28032929,90.3462034807,_100,5,>100
4149,burger,755,28033684,90.3486367399,_100,6,>100
4150,blend,754,28034438,90.3510667763,_100,5,>100
4151,bobby,754,28035192,90.3534968127,_100,5,>100
4152,provision,754,28035946,90.3559268491,_100,9,>100
4153,jane,754,28036700,90.3583568855,_100,4,>100
4154,trains,754,28037454,90.3607869218,_100,6,>100
4155,muslim,753,28038207,90.3632137354,_100,6,>100
4156,loose,753,28038960,90.3656405489,_100,5,>100
4157,lifetime,753,28039713,90.3680673624,_100,8,>100
4158,hawaii,753,28040466,90.3704941759,_100,6,>100
4159,jeremy,753,28041219,90.3729209895,_100,6,>100
4160,slices,753,28041972,90.375347803,_100,6,>100
4161,anger,753,28042725,90.3777746165,_100,5,>100
4162,finances,752,28043477,90.3801982072,_100,8,>100
4163,rushed,752,28044229,90.3826217978,_100,6,>100
4164,tackles,752,28044981,90.3850453885,_100,7,>100
4165,hundred,751,28045732,90.3874657563,_100,7,>100
4166,whenever,751,28046483,90.3898861241,_100,8,>100
4167,shock,751,28047234,90.3923064919,_100,5,>100
4168,watson,751,28047985,90.3947268597,_100,6,>100
4169,seafood,751,28048736,90.3971472275,_100,7,>100
4170,claiming,751,28049487,90.3995675953,_100,8,>100
4171,explains,750,28050237,90.4019847403,_100,8,>100
4172,750,750,28050987,90.4044018852,_100,3,>100
4173,celebrated,750,28051737,90.4068190302,_100,10,>100
4174,preliminary,750,28052487,90.4092361751,_100,11,>100
4175,randy,749,28053236,90.4116500972,_100,5,>100
4176,dropping,749,28053985,90.4140640193,_100,8,>100
4177,highlight,749,28054734,90.4164779414,_100,9,>100
4178,canceled,749,28055483,90.4188918634,_100,8,>100
4179,swimming,748,28056231,90.4213025627,_100,8,>100
4180,restore,748,28056979,90.4237132619,_100,7,>100
4181,participating,747,28057726,90.4261207383,_100,13,>100
4182,producing,746,28058472,90.4285249918,_100,9,>100
4183,camden,746,28059218,90.4309292453,_100,6,>100
4184,lawn,746,28059964,90.4333334988,_100,4,>100
4185,intersection,746,28060710,90.4357377523,_100,12,>100
4186,deeper,746,28061456,90.4381420058,_100,6,>100
4187,diet,746,28062202,90.4405462593,_100,4,>100
4188,desk,746,28062948,90.4429505128,_100,4,>100
4189,providers,745,28063693,90.4453515434,_100,9,>100
4190,murray,745,28064438,90.4477525741,_100,6,>100
4191,efficient,745,28065183,90.4501536047,_100,9,>100
4192,lopez,744,28065927,90.4525514125,_100,5,>100
4193,drilling,744,28066671,90.4549492203,_100,8,>100
4194,vacant,744,28067415,90.4573470281,_100,6,>100
4195,fears,744,28068159,90.4597448359,_100,5,>100
4196,generous,743,28068902,90.4621394208,_100,8,>100
4197,fence,743,28069645,90.4645340057,_100,5,>100
4198,guards,743,28070388,90.4669285906,_100,6,>100
4199,encouraging,743,28071131,90.4693231756,_100,11,>100
4200,sing,743,28071874,90.4717177605,_100,4,>100
4201,protecting,743,28072617,90.4741123454,_100,10,>100
4202,sheet,743,28073360,90.4765069303,_100,5,>100
4203,vendors,743,28074103,90.4789015153,_100,7,>100
4204,generated,743,28074846,90.4812961002,_100,9,>100
4205,ap,742,28075588,90.4836874623,_100,2,>100
4206,strongly,742,28076330,90.4860788243,_100,8,>100
4207,tenure,742,28077072,90.4884701864,_100,6,>100
4208,vulnerable,742,28077814,90.4908615485,_100,10,>100
4209,balanced,742,28078556,90.4932529105,_100,8,>100
4210,distribution,742,28079298,90.4956442726,_100,12,>100
4211,mill,742,28080040,90.4980356346,_100,4,>100
4212,sight,741,28080781,90.5004237739,_100,5,>100
4213,inn,741,28081522,90.5028119131,_100,3,>100
4214,crack,741,28082263,90.5052000523,_100,5,>100
4215,threats,741,28083004,90.5075881915,_100,7,>100
4216,conservation,740,28083744,90.5099731078,_100,12,>100
4217,lesson,740,28084484,90.5123580242,_100,6,>100
4218,praised,739,28085223,90.5147397176,_100,7,>100
4219,manufacturers,739,28085962,90.5171214111,_100,13,>100
4220,challenged,739,28086701,90.5195031046,_100,10,>100
4221,broader,739,28087440,90.5218847981,_100,7,>100
4222,proven,739,28088179,90.5242664916,_100,6,>100
4223,beers,739,28088918,90.5266481851,_100,5,>100
4224,crawford,738,28089656,90.5290266557,_100,8,>100
4225,phillips,738,28090394,90.5314051263,_100,8,>100
4226,climb,738,28091132,90.5337835969,_100,5,>100
4227,elderly,737,28091869,90.5361588447,_100,7,>100
4228,carl,737,28092606,90.5385340925,_100,4,>100
4229,healthcare,737,28093343,90.5409093402,_100,10,>100
4230,mason,736,28094079,90.5432813651,_100,5,>100
4231,juvenile,736,28094815,90.5456533901,_100,8,>100
4232,belt,736,28095551,90.548025415,_100,4,>100
4233,professionals,736,28096287,90.5503974399,_100,13,>100
4234,dame,736,28097023,90.5527694648,_100,4,>100
4235,platform,736,28097759,90.5551414897,_100,8,>100
4236,topic,736,28098495,90.5575135146,_100,5,>100
4237,viewed,735,28099230,90.5598823166,_100,6,>100
4238,sacrifice,735,28099965,90.5622511187,_100,9,>100
4239,retire,735,28100700,90.5646199207,_100,6,>100
4240,uc,735,28101435,90.5669887228,_100,2,>100
4241,delayed,734,28102169,90.5693543019,_100,7,>100
4242,optimistic,734,28102903,90.5717198811,_100,10,>100
4243,enterprise,734,28103637,90.5740854603,_100,10,>100
4244,stable,734,28104371,90.5764510395,_100,6,>100
4245,earning,733,28105104,90.5788133958,_100,7,>100
4246,hometown,733,28105837,90.5811757522,_100,8,>100
4247,scouts,733,28106570,90.5835381085,_100,6,>100
4248,arguing,733,28107303,90.5859004648,_100,7,>100
4249,karen,733,28108036,90.5882628211,_100,5,>100
4250,canadian,732,28108768,90.5906219546,_100,8,>100
4251,fail,732,28109500,90.5929810881,_100,4,>100
4252,collecting,732,28110232,90.5953402215,_100,10,>100
4253,duties,732,28110964,90.597699355,_100,6,>100
4254,frequent,732,28111696,90.6000584885,_100,8,>100
4255,suffer,732,28112428,90.6024176219,_100,6,>100
4256,trophy,731,28113159,90.6047735325,_100,6,>100
4257,piano,731,28113890,90.6071294431,_100,5,>100
4258,length,730,28114620,90.6094821309,_100,6,>100
4259,seeds,730,28115350,90.6118348186,_100,5,>100
4260,reviewed,730,28116080,90.6141875064,_100,8,>100
4261,delays,730,28116810,90.6165401941,_100,6,>100
4262,graham,730,28117540,90.6188928819,_100,6,>100
4263,rough,729,28118269,90.6212423468,_100,5,>100
4264,violated,729,28118998,90.6235918116,_100,8,>100
4265,forth,729,28119727,90.6259412765,_100,5,>100
4266,regulatory,728,28120455,90.6282875186,_100,10,>100
4267,hughes,728,28121183,90.6306337606,_100,6,>100
4268,threatening,728,28121911,90.6329800026,_100,11,>100
4269,singles,728,28122639,90.6353262446,_100,7,>100
4270,medina,728,28123367,90.6376724867,_100,6,>100
4271,repairs,728,28124095,90.6400187287,_100,7,>100
4272,charlotte,727,28124822,90.6423617478,_100,9,>100
4273,attractive,727,28125549,90.644704767,_100,10,>100
4274,survivors,727,28126276,90.6470477862,_100,9,>100
4275,fled,726,28127002,90.6493875825,_100,4,>100
4276,crossing,725,28127727,90.6517241559,_100,8,>100
4277,sodium,725,28128452,90.6540607294,_100,6,>100
4278,suite,724,28129176,90.65639408,_100,5,>100
4279,bathroom,724,28129900,90.6587274306,_100,8,>100
4280,hat,724,28130624,90.6610607811,_100,3,>100
4281,indicate,723,28131347,90.6633909089,_100,8,>100
4282,bennett,723,28132070,90.6657210366,_100,7,>100
4283,albert,723,28132793,90.6680511643,_100,6,>100
4284,listening,723,28133516,90.670381292,_100,9,>100
4285,remarkable,723,28134239,90.6727114198,_100,10,>100
4286,fixed,723,28134962,90.6750415475,_100,5,>100
4287,spaces,722,28135684,90.6773684524,_100,6,>100
4288,destroyed,722,28136406,90.6796953572,_100,9,>100
4289,describes,722,28137128,90.6820222621,_100,9,>100
4290,seemingly,722,28137850,90.684349167,_100,9,>100
4291,chips,721,28138571,90.686672849,_100,5,>100
4292,extreme,721,28139292,90.688996531,_100,7,>100
4293,nike,721,28140013,90.691320213,_100,4,>100
4294,kent,721,28140734,90.693643895,_100,4,>100
4295,cells,721,28141455,90.695967577,_100,5,>100
4296,booker,721,28142176,90.698291259,_100,6,>100
4297,underneath,720,28142896,90.7006117182,_100,10,>100
4298,rogers,720,28143616,90.7029321773,_100,6,>100
4299,territory,720,28144336,90.7052526364,_100,9,>100
4300,roasted,720,28145056,90.7075730956,_100,7,>100
4301,720,720,28145776,90.7098935547,_100,3,>100
4302,maintained,720,28146496,90.7122140139,_100,10,>100
4303,gates,720,28147216,90.714534473,_100,5,>100
4304,pleasant,720,28147936,90.7168549322,_100,8,>100
4305,corporations,719,28148655,90.7191721685,_100,12,>100
4306,comprehensive,719,28149374,90.7214894048,_100,13,>100
4307,lounge,719,28150093,90.723806641,_100,6,>100
4308,protected,719,28150812,90.7261238773,_100,9,>100
4309,gross,718,28151530,90.7284378908,_100,5,>100
4310,hoboken,718,28152248,90.7307519042,_100,7,>100
4311,promising,718,28152966,90.7330659176,_100,9,>100
4312,calm,718,28153684,90.735379931,_100,4,>100
4313,overcome,718,28154402,90.7376939445,_100,8,>100
4314,bullpen,718,28155120,90.7400079579,_100,7,>100
4315,dominated,717,28155837,90.7423187485,_100,9,>100
4316,tale,717,28156554,90.744629539,_100,4,>100
4317,affair,717,28157271,90.7469403296,_100,6,>100
4318,lighting,717,28157988,90.7492511202,_100,8,>100
4319,brick,717,28158705,90.7515619107,_100,5,>100
4320,firing,717,28159422,90.7538727013,_100,6,>100
4321,reveal,716,28160138,90.756180269,_100,6,>100
4322,asia,716,28160854,90.7584878367,_100,4,>100
4323,rockies,716,28161570,90.7607954044,_100,7,>100
4324,collapse,715,28162285,90.7630997493,_100,8,>100
4325,burned,715,28163000,90.7654040941,_100,6,>100
4326,producers,715,28163715,90.7677084389,_100,9,>100
4327,beaten,714,28164429,90.7700095609,_100,6,>100
4328,merely,714,28165143,90.7723106829,_100,6,>100
4329,awareness,714,28165857,90.7746118049,_100,9,>100
4330,print,714,28166571,90.7769129269,_100,5,>100
4331,lakewood,713,28167284,90.779210826,_100,8,>100
4332,unemployed,713,28167997,90.7815087252,_100,10,>100
4333,reviews,713,28168710,90.7838066243,_100,7,>100
4334,mandate,713,28169423,90.7861045234,_100,7,>100
4335,prosecution,712,28170135,90.7883991997,_100,11,>100
4336,richmond,712,28170847,90.7906938759,_100,8,>100
4337,signal,712,28171559,90.7929885522,_100,6,>100
4338,tennis,712,28172271,90.7952832285,_100,6,>100
4339,crowds,712,28172983,90.7975779047,_100,6,>100
4340,turnovers,711,28173694,90.7998693582,_100,9,>100
4341,discovery,711,28174405,90.8021608116,_100,9,>100
4342,mood,711,28175116,90.804452265,_100,4,>100
4343,recognition,710,28175826,90.8067404955,_100,11,>100
4344,graduation,710,28176536,90.8090287261,_100,10,>100
4345,ucla,710,28177246,90.8113169566,_100,4,>100
4346,nevada,710,28177956,90.8136051872,_100,6,>100
4347,midwest,710,28178666,90.8158934177,_100,7,>100
4348,consideration,710,28179376,90.8181816482,_100,13,>100
4349,pregnant,709,28180085,90.8204666559,_100,8,>100
4350,unexpected,709,28180794,90.8227516636,_100,10,>100
4351,honors,709,28181503,90.8250366713,_100,6,>100
4352,riders,709,28182212,90.827321679,_100,6,>100
4353,matthews,709,28182921,90.8296066867,_100,8,>100
4354,marcus,708,28183629,90.8318884715,_100,6,>100
4355,rank,708,28184337,90.8341702563,_100,4,>100
4356,tragedy,708,28185045,90.8364520412,_100,7,>100
4357,nj,708,28185753,90.838733826,_100,2,>100
4358,lying,708,28186461,90.8410156108,_100,5,>100
4359,guarantee,708,28187169,90.8432973957,_100,9,>100
4360,lynn,708,28187877,90.8455791805,_100,4,>100
4361,semifinals,708,28188585,90.8478609653,_100,10,>100
4362,specialist,707,28189292,90.8501395273,_100,10,>100
4363,accomplished,707,28189999,90.8524180892,_100,12,>100
4364,apartments,707,28190706,90.8546966512,_100,10,>100
4365,homicide,707,28191413,90.8569752132,_100,8,>100
4366,mccoy,707,28192120,90.8592537751,_100,5,>100
4367,racial,706,28192826,90.8615291143,_100,6,>100
4368,exhibition,706,28193532,90.8638044534,_100,10,>100
4369,substantial,706,28194238,90.8660797925,_100,11,>100
4370,colts,706,28194944,90.8683551316,_100,5,>100
4371,worries,706,28195650,90.8706304707,_100,7,>100
4372,relative,705,28196355,90.8729025869,_100,8,>100
4373,abortion,704,28197059,90.8751714803,_100,8,>100
4374,skill,704,28197763,90.8774403737,_100,5,>100
4375,tablespoons,704,28198467,90.8797092671,_100,11,>100
4376,ministry,704,28199171,90.8819781605,_100,8,>100
4377,solve,704,28199875,90.8842470539,_100,5,>100
4378,hosts,704,28200579,90.8865159473,_100,5,>100
4379,notion,703,28201282,90.8887816178,_100,6,>100
4380,defender,703,28201985,90.8910472883,_100,8,>100
4381,brands,703,28202688,90.8933129588,_100,6,>100
4382,moon,703,28203391,90.8955786294,_100,4,>100
4383,carroll,702,28204093,90.897841077,_100,7,>100
4384,versions,702,28204795,90.9001035247,_100,8,>100
4385,delaware,702,28205497,90.9023659724,_100,8,>100
4386,lies,702,28206199,90.90462842,_100,4,>100
4387,flour,702,28206901,90.9068908677,_100,5,>100
4388,blamed,702,28207603,90.9091533154,_100,6,>100
4389,crisp,702,28208305,90.911415763,_100,5,>100
4390,wade,702,28209007,90.9136782107,_100,4,>100
4391,demanding,701,28209708,90.9159374355,_100,9,>100
4392,grades,701,28210409,90.9181966603,_100,6,>100
4393,audit,701,28211110,90.9204558851,_100,5,>100
4394,premium,701,28211811,90.9227151099,_100,7,>100
4395,enormous,700,28212511,90.9249711119,_100,8,>100
4396,ronald,700,28213211,90.9272271138,_100,6,>100
4397,700,700,28213911,90.9294831158,_100,3,>100
4398,height,700,28214611,90.9317391177,_100,6,>100
4399,contractors,700,28215311,90.9339951197,_100,11,>100
4400,conservatives,699,28216010,90.9362478988,_100,13,>100
4401,prince,699,28216709,90.9385006779,_100,6,>100
4402,mainly,699,28217408,90.940753457,_100,6,>100
4403,painted,699,28218107,90.943006236,_100,7,>100
4404,buzz,698,28218805,90.9452557923,_100,4,>100
4405,doubles,698,28219503,90.9475053485,_100,7,>100
4406,terrific,697,28220200,90.9497516819,_100,8,>100
4407,stages,697,28220897,90.9519980152,_100,6,>100
4408,quarters,697,28221594,90.9542443486,_100,8,>100
4409,casual,697,28222291,90.956490682,_100,6,>100
4410,mls,697,28222988,90.9587370153,_100,3,>100
4411,devoted,697,28223685,90.9609833487,_100,7,>100
4412,manner,697,28224382,90.9632296821,_100,6,>100
4413,sec,697,28225079,90.9654760154,_100,3,>100
4414,terrible,696,28225775,90.967719126,_100,8,>100
4415,seau,696,28226471,90.9699622365,_100,4,>100
4416,dayton,695,28227166,90.9722021241,_100,6,>100
4417,chuck,695,28227861,90.9744420118,_100,5,>100
4418,fault,695,28228556,90.9766818994,_100,5,>100
4419,duck,695,28229251,90.9789217871,_100,4,>100
4420,merger,694,28229945,90.9811584518,_100,6,>100
4421,frustrated,694,28230639,90.9833951166,_100,10,>100
4422,delicious,694,28231333,90.9856317814,_100,9,>100
4423,tap,694,28232027,90.9878684462,_100,3,>100
4424,nets,694,28232721,90.990105111,_100,4,>100
4425,relay,694,28233415,90.9923417758,_100,5,>100
4426,peters,694,28234109,90.9945784406,_100,6,>100
4427,checking,693,28234802,90.9968118825,_100,8,>100
4428,chip,693,28235495,90.9990453244,_100,4,>100
4429,permits,693,28236188,91.0012787664,_100,7,>100
4430,preparation,693,28236881,91.0035122083,_100,11,>100
4431,metropolitan,693,28237574,91.0057456502,_100,12,>100
4432,deserves,693,28238267,91.0079790921,_100,8,>100
4433,kucinich,693,28238960,91.0102125341,_100,8,>100
4434,overhaul,693,28239653,91.012445976,_100,8,>100
4435,studied,693,28240346,91.0146794179,_100,7,>100
4436,tomato,692,28241038,91.016909637,_100,6,>100
4437,wounded,692,28241730,91.0191398561,_100,7,>100
4438,roman,692,28242422,91.0213700751,_100,5,>100
4439,dramatically,692,28243114,91.0236002942,_100,12,>100
4440,aggravated,691,28243805,91.0258272904,_100,10,>100
4441,proof,691,28244496,91.0280542866,_100,5,>100
4442,purchases,691,28245187,91.0302812828,_100,9,>100
4443,economics,691,28245878,91.032508279,_100,9,>100
4444,venue,691,28246569,91.0347352753,_100,5,>100
4445,physically,691,28247260,91.0369622715,_100,10,>100
4446,boyfriend,691,28247951,91.0391892677,_100,9,>100
4447,pastor,691,28248642,91.0414162639,_100,6,>100
4448,mccain,690,28249332,91.0436400372,_100,6,>100
4449,locally,690,28250022,91.0458638106,_100,7,>100
4450,hopkins,690,28250712,91.0480875839,_100,7,>100
4451,cbs,690,28251402,91.0503113573,_100,3,>100
4452,hero,689,28252091,91.0525319078,_100,4,>100
4453,culinary,689,28252780,91.0547524583,_100,8,>100
4454,weekends,689,28253469,91.0569730087,_100,8,>100
4455,milwaukee,689,28254158,91.0591935592,_100,9,>100
4456,receivers,688,28254846,91.0614108869,_100,9,>100
4457,rated,688,28255534,91.0636282145,_100,5,>100
4458,glenn,688,28256222,91.0658455421,_100,5,>100
4459,remembered,688,28256910,91.0680628697,_100,10,>100
4460,formula,688,28257598,91.0702801974,_100,7,>100
4461,categories,688,28258286,91.072497525,_100,10,>100
4462,hitters,688,28258974,91.0747148526,_100,7,>100
4463,wanting,687,28259661,91.0769289574,_100,7,>100
4464,nate,687,28260348,91.0791430622,_100,4,>100
4465,presents,687,28261035,91.0813571669,_100,8,>100
4466,muscle,687,28261722,91.0835712717,_100,6,>100
4467,billions,687,28262409,91.0857853765,_100,8,>100
4468,copy,687,28263096,91.0879994812,_100,4,>100
4469,masters,687,28263783,91.090213586,_100,7,>100
4470,diverse,687,28264470,91.0924276908,_100,7,>100
4471,resulting,686,28265156,91.0946385727,_100,9,>100
4472,welfare,686,28265842,91.0968494546,_100,7,>100
4473,contained,686,28266528,91.0990603365,_100,9,>100
4474,flyers,686,28267214,91.1012712184,_100,6,>100
4475,adviser,686,28267900,91.1034821003,_100,7,>100
4476,profile,686,28268586,91.1056929822,_100,7,>100
4477,danny,686,28269272,91.1079038642,_100,5,>100
4478,troy,686,28269958,91.1101147461,_100,4,>100
4479,berkeley,685,28270643,91.1123224051,_100,8,>100
4480,pa,685,28271328,91.1145300642,_100,2,>100
4481,wireless,685,28272013,91.1167377232,_100,8,>100
4482,elliott,684,28272697,91.1189421594,_100,7,>100
4483,sunny,684,28273381,91.1211465956,_100,5,>100
4484,gonzalez,683,28274064,91.1233478089,_100,8,>100
4485,mac,683,28274747,91.1255490222,_100,3,>100
4486,duke,683,28275430,91.1277502356,_100,4,>100
4487,brewer,683,28276113,91.1299514489,_100,6,>100
4488,constant,682,28276795,91.1321494394,_100,8,>100
4489,sudden,682,28277477,91.1343474298,_100,6,>100
4490,parked,682,28278159,91.1365454203,_100,6,>100
4491,salem,682,28278841,91.1387434108,_100,5,>100
4492,mountains,681,28279522,91.1409381784,_100,9,>100
4493,agriculture,681,28280203,91.143132946,_100,11,>100
4494,pour,681,28280884,91.1453277136,_100,4,>100
4495,eve,681,28281565,91.1475224812,_100,3,>100
4496,zoo,681,28282246,91.1497172488,_100,3,>100
4497,cal,681,28282927,91.1519120164,_100,3,>100
4498,latin,680,28283607,91.1541035612,_100,5,>100
4499,submit,680,28284287,91.1562951059,_100,6,>100
4500,inmates,679,28284966,91.1584834278,_100,7,>100
4501,snyder,679,28285645,91.1606717497,_100,6,>100
4502,networks,678,28286323,91.1628568487,_100,8,>100
4503,wondering,678,28287001,91.1650419478,_100,9,>100
4504,frozen,678,28287679,91.1672270468,_100,6,>100
4505,marathon,678,28288357,91.1694121458,_100,8,>100
4506,tourism,677,28289034,91.171594022,_100,7,>100
4507,nixon,677,28289711,91.1737758982,_100,5,>100
4508,prayer,677,28290388,91.1759577743,_100,6,>100
4509,physician,677,28291065,91.1781396505,_100,9,>100
4510,explosion,677,28291742,91.1803215267,_100,9,>100
4511,tank,677,28292419,91.1825034029,_100,4,>100
4512,princeton,676,28293095,91.1846820562,_100,9,>100
4513,signatures,676,28293771,91.1868607095,_100,10,>100
4514,trails,676,28294447,91.1890393628,_100,6,>100
4515,artistic,676,28295123,91.1912180161,_100,8,>100
4516,boxes,676,28295799,91.1933966694,_100,5,>100
4517,referendum,676,28296475,91.1955753227,_100,10,>100
4518,knife,676,28297151,91.197753976,_100,5,>100
4519,abc,676,28297827,91.1999326293,_100,3,>100
4520,struggles,676,28298503,91.2021112826,_100,9,>100
4521,root,675,28299178,91.2042867131,_100,4,>100
4522,bridges,675,28299853,91.2064621435,_100,7,>100
4523,accompanied,674,28300527,91.2086343511,_100,11,>100
4524,universal,674,28301201,91.2108065587,_100,9,>100
4525,easter,674,28301875,91.2129787663,_100,6,>100
4526,latino,674,28302549,91.2151509739,_100,6,>100
4527,scenario,673,28303222,91.2173199586,_100,8,>100
4528,backyard,673,28303895,91.2194889434,_100,8,>100
4529,touched,673,28304568,91.2216579281,_100,7,>100
4530,climbed,673,28305241,91.2238269128,_100,7,>100
4531,arrival,673,28305914,91.2259958976,_100,7,>100
4532,fate,673,28306587,91.2281648823,_100,4,>100
4533,fatal,673,28307260,91.230333867,_100,5,>100
4534,eugene,672,28307932,91.2324996289,_100,6,>100
4535,sue,672,28308604,91.2346653908,_100,3,>100
4536,railroad,671,28309275,91.2368279298,_100,8,>100
4537,mvp,671,28309946,91.2389904688,_100,3,>100
4538,updated,671,28310617,91.2411530078,_100,7,>100
4539,involve,670,28311287,91.2433123239,_100,7,>100
4540,dealers,669,28311956,91.2454684172,_100,7,>100
4541,cole,669,28312625,91.2476245105,_100,4,>100
4542,extraordinary,668,28313293,91.249777381,_100,13,>100
4543,spoken,668,28313961,91.2519302514,_100,6,>100
4544,warner,668,28314629,91.2540831218,_100,6,>100
4545,deck,668,28315297,91.2562359922,_100,4,>100
4546,casinos,668,28315965,91.2583888627,_100,7,>100
4547,frustration,668,28316633,91.2605417331,_100,11,>100
4548,shocked,667,28317300,91.2626913807,_100,7,>100
4549,accounting,667,28317967,91.2648410282,_100,10,>100
4550,moderate,667,28318634,91.2669906758,_100,8,>100
4551,ultimate,667,28319301,91.2691403234,_100,8,>100
4552,transferred,667,28319968,91.271289971,_100,11,>100
4553,legitimate,666,28320634,91.2734363957,_100,10,>100
4554,equity,666,28321300,91.2755828204,_100,6,>100
4555,oppose,666,28321966,91.2777292451,_100,6,>100
4556,probe,666,28322632,91.2798756698,_100,5,>100
4557,stole,665,28323297,91.2820188716,_100,5,>100
4558,belief,665,28323962,91.2841620735,_100,6,>100
4559,bold,665,28324627,91.2863052754,_100,4,>100
4560,bonus,665,28325292,91.2884484772,_100,5,>100
4561,floors,665,28325957,91.2905916791,_100,6,>100
4562,obtain,664,28326621,91.292731658,_100,6,>100
4563,adventure,664,28327285,91.294871637,_100,9,>100
4564,howell,664,28327949,91.297011616,_100,6,>100
4565,pine,664,28328613,91.299151595,_100,4,>100
4566,minds,664,28329277,91.301291574,_100,5,>100
4567,extent,664,28329941,91.303431553,_100,6,>100
4568,lie,664,28330605,91.305571532,_100,3,>100
4569,duncan,663,28331268,91.3077082881,_100,6,>100
4570,silent,663,28331931,91.3098450443,_100,6,>100
4571,lobby,663,28332594,91.3119818004,_100,5,>100
4572,politically,663,28333257,91.3141185565,_100,11,>100
4573,delta,663,28333920,91.3162553126,_100,5,>100
4574,maria,663,28334583,91.3183920688,_100,5,>100
4575,clippers,663,28335246,91.3205288249,_100,8,>100
4576,advocacy,663,28335909,91.322665581,_100,8,>100
4577,wages,663,28336572,91.3248023372,_100,5,>100
4578,colorful,663,28337235,91.3269390933,_100,8,>100
4579,crystal,663,28337898,91.3290758494,_100,7,>100
4580,terminal,662,28338560,91.3312093827,_100,8,>100
4581,deadly,662,28339222,91.333342916,_100,6,>100
4582,targets,662,28339884,91.3354764492,_100,7,>100
4583,workout,662,28340546,91.3376099825,_100,7,>100
4584,cycle,662,28341208,91.3397435158,_100,5,>100
4585,understood,662,28341870,91.3418770491,_100,10,>100
4586,killer,662,28342532,91.3440105823,_100,6,>100
4587,comeback,661,28343193,91.3461408927,_100,8,>100
4588,studying,661,28343854,91.3482712031,_100,8,>100
4589,favorites,661,28344515,91.3504015136,_100,9,>100
4590,comparison,661,28345176,91.352531824,_100,10,>100
4591,yahoo,661,28345837,91.3546621344,_100,5,>100
4592,participated,661,28346498,91.3567924448,_100,12,>100
4593,discipline,661,28347159,91.3589227552,_100,10,>100
4594,disappointing,661,28347820,91.3610530656,_100,13,>100
4595,contractor,660,28348480,91.3631801532,_100,10,>100
4596,honda,660,28349140,91.3653072407,_100,5,>100
4597,oliver,660,28349800,91.3674343283,_100,6,>100
4598,pattern,660,28350460,91.3695614158,_100,7,>100
4599,trainer,659,28351119,91.3716852805,_100,7,>100
4600,substance,659,28351778,91.3738091452,_100,9,>100
4601,inspiration,659,28352437,91.3759330099,_100,11,>100
4602,scout,659,28353096,91.3780568746,_100,5,>100
4603,lucas,658,28353754,91.3801775164,_100,5,>100
4604,hide,658,28354412,91.3822981582,_100,4,>100
4605,attached,658,28355070,91.3844188001,_100,8,>100
4606,steal,658,28355728,91.3865394419,_100,5,>100
4607,certified,658,28356386,91.3886600837,_100,9,>100
4608,clay,657,28357043,91.3907775027,_100,4,>100
4609,dear,657,28357700,91.3928949217,_100,4,>100
4610,buried,657,28358357,91.3950123407,_100,6,>100
4611,hidden,657,28359014,91.3971297596,_100,6,>100
4612,cornerback,656,28359670,91.3992439557,_100,10,>100
4613,forum,656,28360326,91.4013581518,_100,5,>100
4614,blind,656,28360982,91.403472348,_100,5,>100
4615,cleaning,656,28361638,91.4055865441,_100,8,>100
4616,quarterbacks,656,28362294,91.4077007402,_100,12,>100
4617,charging,655,28362949,91.4098117134,_100,8,>100
4618,johnny,655,28363604,91.4119226867,_100,6,>100
4619,capture,655,28364259,91.4140336599,_100,7,>100
4620,orioles,655,28364914,91.4161446332,_100,7,>100
4621,chefs,655,28365569,91.4182556064,_100,5,>100
4622,delegates,654,28366223,91.4203633568,_100,9,>100
4623,contribution,654,28366877,91.4224711072,_100,12,>100
4624,auditor,654,28367531,91.4245788576,_100,7,>100
4625,stuffed,653,28368184,91.4266833851,_100,7,>100
4626,x,653,28368837,91.4287879127,_100,1,>100
4627,hosting,653,28369490,91.4308924402,_100,7,>100
4628,palm,652,28370142,91.4329937449,_100,4,>100
4629,wealth,652,28370794,91.4350950496,_100,6,>100
4630,pirates,652,28371446,91.4371963542,_100,7,>100
4631,gulf,651,28372097,91.439294436,_100,4,>100
4632,connecticut,651,28372748,91.4413925178,_100,11,>100
4633,welcoming,651,28373399,91.4434905997,_100,9,>100
4634,gather,651,28374050,91.4455886815,_100,6,>100
4635,rebound,651,28374701,91.4476867633,_100,7,>100
4636,hunger,651,28375352,91.4497848451,_100,6,>100
4637,designated,651,28376003,91.4518829269,_100,10,>100
4638,peyton,651,28376654,91.4539810087,_100,6,>100
4639,recalls,651,28377305,91.4560790905,_100,7,>100
4640,anticipated,650,28377955,91.4581739495,_100,11,>100
4641,strange,650,28378605,91.4602688084,_100,7,>100
4642,busch,650,28379255,91.4623636674,_100,5,>100
4643,crashed,650,28379905,91.4644585263,_100,7,>100
4644,lifestyle,650,28380555,91.4665533853,_100,9,>100
4645,650,650,28381205,91.4686482442,_100,3,>100
4646,panels,649,28381854,91.4707398803,_100,6,>100
4647,item,649,28382503,91.4728315164,_100,4,>100
4648,terrorist,648,28383151,91.4749199297,_100,9,>100
4649,winery,648,28383799,91.4770083429,_100,6,>100
4650,jeffrey,648,28384447,91.4790967561,_100,7,>100
4651,torn,647,28385094,91.4811819465,_100,4,>100
4652,rocks,647,28385741,91.4832671369,_100,5,>100
4653,sunset,647,28386388,91.4853523272,_100,6,>100
4654,photographs,646,28387034,91.4874342947,_100,11,>100
4655,liquid,646,28387680,91.4895162623,_100,6,>100
4656,bruno,646,28388326,91.4915982298,_100,5,>100
4657,reference,646,28388972,91.4936801973,_100,9,>100
4658,pointing,646,28389618,91.4957621648,_100,8,>100
4659,tore,646,28390264,91.4978441323,_100,4,>100
4660,sandwich,646,28390910,91.4999260998,_100,8,>100
4661,tag,646,28391556,91.5020080673,_100,3,>100
4662,euclid,645,28392201,91.504086812,_100,6,>100
4663,visible,645,28392846,91.5061655566,_100,7,>100
4664,tustin,645,28393491,91.5082443013,_100,6,>100
4665,jewelry,644,28394135,91.5103198231,_100,7,>100
4666,makers,644,28394779,91.5123953449,_100,6,>100
4667,generations,644,28395423,91.5144708667,_100,11,>100
4668,mets,643,28396066,91.5165431656,_100,4,>100
4669,widespread,643,28396709,91.5186154645,_100,10,>100
4670,sullivan,643,28397352,91.5206877635,_100,8,>100
4671,theory,643,28397995,91.5227600624,_100,6,>100
4672,donation,643,28398638,91.5248323613,_100,8,>100
4673,flew,643,28399281,91.5269046603,_100,4,>100
4674,billy,643,28399924,91.5289769592,_100,5,>100
4675,agreements,643,28400567,91.5310492581,_100,10,>100
4676,wage,642,28401209,91.5331183342,_100,4,>100
4677,offerings,642,28401851,91.5351874103,_100,9,>100
4678,microsoft,641,28402492,91.5372532635,_100,9,>100
4679,monitoring,641,28403133,91.5393191167,_100,10,>100
4680,rides,641,28403774,91.5413849699,_100,5,>100
4681,cavaliers,641,28404415,91.5434508231,_100,9,>100
4682,burning,641,28405056,91.5455166763,_100,7,>100
4683,spotlight,640,28405696,91.5475793067,_100,9,>100
4684,reception,640,28406336,91.549641937,_100,9,>100
4685,kelley,640,28406976,91.5517045674,_100,6,>100
4686,meters,640,28407616,91.5537671977,_100,6,>100
4687,lone,639,28408255,91.5558266052,_100,4,>100
4688,controls,639,28408894,91.5578860127,_100,8,>100
4689,shy,639,28409533,91.5599454202,_100,3,>100
4690,http,639,28410172,91.5620048277,_100,4,>100
4691,battery,639,28410811,91.5640642352,_100,7,>100
4692,babies,639,28411450,91.5661236427,_100,6,>100
4693,rd,639,28412089,91.5681830502,_100,2,>100
4694,buffalo,638,28412727,91.5702392348,_100,7,>100
4695,treasurer,638,28413365,91.5722954195,_100,9,>100
4696,spends,638,28414003,91.5743516041,_100,6,>100
4697,pitchers,638,28414641,91.5764077887,_100,8,>100
4698,invested,638,28415279,91.5784639734,_100,8,>100
4699,guaranteed,637,28415916,91.5805169351,_100,10,>100
4700,romantic,637,28416553,91.5825698969,_100,8,>100
4701,blast,637,28417190,91.5846228587,_100,5,>100
4702,surely,637,28417827,91.5866758204,_100,6,>100
4703,closure,636,28418463,91.5887255594,_100,7,>100
4704,coached,636,28419099,91.5907752983,_100,7,>100
4705,reminded,636,28419735,91.5928250372,_100,8,>100
4706,attracted,636,28420371,91.5948747761,_100,9,>100
4707,catcher,636,28421007,91.596924515,_100,7,>100
4708,jesus,636,28421643,91.5989742539,_100,5,>100
4709,fires,635,28422278,91.60102077,_100,5,>100
4710,urging,635,28422913,91.603067286,_100,6,>100
4711,max,635,28423548,91.6051138021,_100,3,>100
4712,rachel,635,28424183,91.6071603181,_100,6,>100
4713,badly,635,28424818,91.6092068342,_100,5,>100
4714,dough,635,28425453,91.6112533502,_100,5,>100
4715,payne,633,28426086,91.6132934206,_100,5,>100
4716,investor,633,28426719,91.6153334909,_100,8,>100
4717,hopeful,633,28427352,91.6173735612,_100,7,>100
4718,legally,633,28427985,91.6194136316,_100,7,>100
4719,cellphone,633,28428618,91.6214537019,_100,9,>100
4720,fda,633,28429251,91.6234937722,_100,3,>100
4721,hispanic,633,28429884,91.6255338426,_100,8,>100
4722,wooden,632,28430516,91.62757069,_100,6,>100
4723,matched,632,28431148,91.6296075375,_100,7,>100
4724,bite,632,28431780,91.631644385,_100,4,>100
4725,temple,632,28432412,91.6336812325,_100,6,>100
4726,atop,632,28433044,91.6357180799,_100,4,>100
4727,bailout,632,28433676,91.6377549274,_100,7,>100
4728,seized,632,28434308,91.6397917749,_100,6,>100
4729,proposition,631,28434939,91.6418253995,_100,11,>100
4730,admit,631,28435570,91.6438590241,_100,5,>100
4731,harvard,631,28436201,91.6458926487,_100,7,>100
4732,seasonal,631,28436832,91.6479262733,_100,8,>100
4733,sounded,630,28437462,91.6499566751,_100,7,>100
4734,candy,630,28438092,91.6519870768,_100,5,>100
4735,speaks,630,28438722,91.6540174786,_100,6,>100
4736,update,630,28439352,91.6560478804,_100,6,>100
4737,stays,630,28439982,91.6580782821,_100,5,>100
4738,coleman,630,28440612,91.6601086839,_100,7,>100
4739,rolls,629,28441241,91.6621358628,_100,5,>100
4740,clemens,629,28441870,91.6641630416,_100,7,>100
4741,shirt,629,28442499,91.6661902205,_100,5,>100
4742,resolve,629,28443128,91.6682173994,_100,7,>100
4743,sleeping,628,28443756,91.6702413555,_100,8,>100
4744,luke,628,28444384,91.6722653115,_100,4,>100
4745,equivalent,628,28445012,91.6742892675,_100,10,>100
4746,websites,628,28445640,91.6763132236,_100,8,>100
4747,instructions,628,28446268,91.6783371796,_100,12,>100
4748,athletics,628,28446896,91.6803611356,_100,9,>100
4749,clackamas,628,28447524,91.6823850917,_100,9,>100
4750,promoted,627,28448151,91.6844058248,_100,8,>100
4751,successfully,627,28448778,91.686426558,_100,12,>100
4752,inner,627,28449405,91.6884472912,_100,5,>100
4753,hayes,626,28450031,91.6904648015,_100,5,>100
4754,hillsboro,626,28450657,91.6924823118,_100,9,>100
4755,priorities,626,28451283,91.6944998221,_100,10,>100
4756,teenager,626,28451909,91.6965173324,_100,8,>100
4757,vital,626,28452535,91.6985348428,_100,5,>100
4758,slice,626,28453161,91.7005523531,_100,5,>100
4759,webster,626,28453787,91.7025698634,_100,7,>100
4760,breath,625,28454412,91.7045841508,_100,6,>100
4761,korean,625,28455037,91.7065984383,_100,6,>100
4762,mrs,625,28455662,91.7086127257,_100,3,>100
4763,embrace,625,28456287,91.7106270132,_100,7,>100
4764,sample,625,28456912,91.7126413007,_100,6,>100
4765,keys,625,28457537,91.7146555881,_100,4,>100
4766,automatic,624,28458161,91.7166666527,_100,9,>100
4767,painful,623,28458784,91.7186744944,_100,7,>100
4768,costly,623,28459407,91.7206823362,_100,6,>100
4769,odd,623,28460030,91.7226901779,_100,3,>100
4770,honey,623,28460653,91.7246980196,_100,5,>100
4771,currency,622,28461275,91.7267026385,_100,8,>100
4772,deciding,622,28461897,91.7287072574,_100,8,>100
4773,employer,622,28462519,91.7307118763,_100,8,>100
4774,ignored,622,28463141,91.7327164951,_100,7,>100
4775,sentencing,621,28463762,91.7347178911,_100,10,>100
4776,opposing,621,28464383,91.7367192872,_100,8,>100
4777,sensitive,621,28465004,91.7387206832,_100,9,>100
4778,specialty,621,28465625,91.7407220792,_100,9,>100
4779,employed,621,28466246,91.7427234752,_100,8,>100
4780,permission,621,28466867,91.7447248712,_100,10,>100
4781,promoting,621,28467488,91.7467262672,_100,9,>100
4782,verdict,620,28468108,91.7487244404,_100,7,>100
4783,reward,620,28468728,91.7507226135,_100,6,>100
4784,accurate,620,28469348,91.7527207867,_100,8,>100
4785,grandchildren,620,28469968,91.7547189598,_100,13,>100
4786,spa,620,28470588,91.756717133,_100,3,>100
4787,medal,620,28471208,91.7587153062,_100,5,>100
4788,sweeping,619,28471827,91.7607102564,_100,8,>100
4789,fortune,619,28472446,91.7627052067,_100,7,>100
4790,burn,619,28473065,91.764700157,_100,4,>100
4791,files,618,28473683,91.7666918845,_100,5,>100
4792,autism,618,28474301,91.7686836119,_100,6,>100
4793,accommodate,618,28474919,91.7706753393,_100,11,>100
4794,tourists,618,28475537,91.7726670668,_100,8,>100
4795,script,618,28476155,91.7746587942,_100,6,>100
4796,introduce,618,28476773,91.7766505216,_100,9,>100
4797,span,618,28477391,91.7786422491,_100,4,>100
4798,defended,618,28478009,91.7806339765,_100,8,>100
4799,vocal,618,28478627,91.7826257039,_100,5,>100
4800,punch,618,28479245,91.7846174314,_100,5,>100
4801,diamond,617,28479862,91.786605936,_100,7,>100
4802,scrutiny,617,28480479,91.7885944405,_100,8,>100
4803,differently,617,28481096,91.7905829451,_100,11,>100
4804,crown,617,28481713,91.7925714497,_100,5,>100
4805,sliced,617,28482330,91.7945599543,_100,6,>100
4806,errors,617,28482947,91.7965484588,_100,6,>100
4807,pocket,616,28483563,91.7985337405,_100,6,>100
4808,holy,616,28484179,91.8005190223,_100,4,>100
4809,tens,616,28484795,91.802504304,_100,4,>100
4810,potato,616,28485411,91.8044895857,_100,6,>100
4811,teaspoon,615,28486026,91.8064716445,_100,8,>100
4812,sponsors,615,28486641,91.8084537034,_100,8,>100
4813,pants,615,28487256,91.8104357622,_100,5,>100
4814,operator,615,28487871,91.8124178211,_100,8,>100
4815,authorized,615,28488486,91.81439988,_100,10,>100
4816,slot,614,28489100,91.8163787159,_100,4,>100
4817,waves,614,28489714,91.8183575519,_100,5,>100
4818,attempting,614,28490328,91.8203363879,_100,10,>100
4819,paintings,614,28490942,91.8223152239,_100,9,>100
4820,finale,614,28491556,91.8242940599,_100,6,>100
4821,wars,613,28492169,91.8262696731,_100,4,>100
4822,democracy,613,28492782,91.8282452862,_100,9,>100
4823,pollution,613,28493395,91.8302208993,_100,9,>100
4824,latter,613,28494008,91.8321965125,_100,6,>100
4825,carpenter,613,28494621,91.8341721256,_100,9,>100
4826,churches,613,28495234,91.8361477387,_100,8,>100
4827,element,613,28495847,91.8381233519,_100,7,>100
4828,membership,612,28496459,91.8400957421,_100,10,>100
4829,stimulus,612,28497071,91.8420681324,_100,8,>100
4830,pronounced,612,28497683,91.8440405227,_100,10,>100
4831,peppers,612,28498295,91.846012913,_100,7,>100
4832,crowded,612,28498907,91.8479853032,_100,7,>100
4833,martinez,612,28499519,91.8499576935,_100,8,>100
4834,pete,612,28500131,91.8519300838,_100,4,>100
4835,sierra,612,28500743,91.8539024741,_100,6,>100
4836,sandwiches,612,28501355,91.8558748643,_100,10,>100
4837,sharply,612,28501967,91.8578472546,_100,7,>100
4838,mentally,612,28502579,91.8598196449,_100,8,>100
4839,dying,612,28503191,91.8617920352,_100,5,>100
4840,crab,611,28503802,91.8637612026,_100,4,>100
4841,reflects,611,28504413,91.86573037,_100,8,>100
4842,arkansas,611,28505024,91.8676995374,_100,8,>100
4843,intel,610,28505634,91.869665482,_100,5,>100
4844,emphasis,610,28506244,91.8716314265,_100,8,>100
4845,walter,609,28506853,91.8735941482,_100,6,>100
4846,cheaper,609,28507462,91.8755568699,_100,7,>100
4847,motorists,609,28508071,91.8775195916,_100,9,>100
4848,trio,609,28508680,91.8794823133,_100,4,>100
4849,hung,609,28509289,91.881445035,_100,4,>100
4850,joke,609,28509898,91.8834077567,_100,4,>100
4851,function,609,28510507,91.8853704784,_100,8,>100
4852,voices,609,28511116,91.8873332001,_100,6,>100
4853,mushrooms,609,28511725,91.8892959218,_100,9,>100
4854,uo,609,28512334,91.8912586435,_100,2,>100
4855,progressive,609,28512943,91.8932213652,_100,11,>100
4856,shoppers,609,28513552,91.8951840869,_100,8,>100
4857,acted,608,28514160,91.8971435857,_100,5,>100
4858,cunningham,608,28514768,91.8991030845,_100,10,>100
4859,heels,608,28515376,91.9010625834,_100,5,>100
4860,planet,608,28515984,91.9030220822,_100,6,>100
4861,sum,608,28516592,91.904981581,_100,3,>100
4862,procedure,608,28517200,91.9069410799,_100,9,>100
4863,slipped,607,28517807,91.9088973558,_100,7,>100
4864,champagne,607,28518414,91.9108536318,_100,9,>100
4865,syria,607,28519021,91.9128099078,_100,5,>100
4866,desperate,607,28519628,91.9147661838,_100,9,>100
4867,cloud,606,28520234,91.9167192369,_100,5,>100
4868,replacing,606,28520840,91.91867229,_100,9,>100
4869,exact,606,28521446,91.9206253431,_100,5,>100
4870,catches,606,28522052,91.9225783962,_100,7,>100
4871,tracking,605,28522657,91.9245282265,_100,8,>100
4872,understands,605,28523262,91.9264780567,_100,11,>100
4873,crossed,605,28523867,91.928427887,_100,7,>100
4874,emerging,605,28524472,91.9303777172,_100,8,>100
4875,lovely,605,28525077,91.9323275475,_100,6,>100
4876,shell,605,28525682,91.9342773778,_100,5,>100
4877,posting,605,28526287,91.936227208,_100,7,>100
4878,stressed,604,28526891,91.9381738154,_100,8,>100
4879,popularity,604,28527495,91.9401204228,_100,10,>100
4880,efficiency,604,28528099,91.9420670302,_100,10,>100
4881,uncertainty,604,28528703,91.9440136376,_100,11,>100
4882,explanation,604,28529307,91.945960245,_100,11,>100
4883,calendar,603,28529910,91.9479036295,_100,8,>100
4884,connections,603,28530513,91.9498470141,_100,11,>100
4885,method,603,28531116,91.9517903986,_100,6,>100
4886,remembers,603,28531719,91.9537337831,_100,9,>100
4887,jet,602,28532321,91.9556739448,_100,3,>100
4888,matheny,602,28532923,91.9576141065,_100,7,>100
4889,seeks,602,28533525,91.9595542682,_100,5,>100
4890,damages,602,28534127,91.9614944298,_100,7,>100
4891,audiences,602,28534729,91.9634345915,_100,9,>100
4892,sweep,601,28535330,91.9653715303,_100,5,>100
4893,mystery,601,28535931,91.9673084691,_100,7,>100
4894,perez,601,28536532,91.969245408,_100,5,>100
4895,reserves,601,28537133,91.9711823468,_100,8,>100
4896,eagle,601,28537734,91.9731192856,_100,5,>100
4897,yield,601,28538335,91.9750562244,_100,5,>100
4898,judicial,601,28538936,91.9769931632,_100,8,>100
4899,replied,601,28539537,91.978930102,_100,7,>100
4900,celebrating,601,28540138,91.9808670408,_100,11,>100
4901,defined,601,28540739,91.9828039797,_100,7,>100
4902,600,600,28541339,91.9847376956,_100,3,>100
4903,enjoying,600,28541939,91.9866714116,_100,8,>100
4904,tougher,600,28542539,91.9886051275,_100,7,>100
4905,respectively,600,28543139,91.9905388435,_100,12,>100
4906,steep,599,28543738,91.9924693366,_100,5,>100
4907,raymond,599,28544337,91.9943998297,_100,7,>100
4908,performers,599,28544936,91.9963303228,_100,10,>100
4909,monroe,599,28545535,91.9982608159,_100,6,>100
4910,courthouse,599,28546134,92.000191309,_100,10,>100
4911,paterno,598,28546732,92.0021185792,_100,7,>100
4912,pit,598,28547330,92.0040458494,_100,3,>100
4913,lightly,598,28547928,92.0059731197,_100,7,>100
4914,accountability,598,28548526,92.0079003899,_100,14,>100
4915,reid,597,28549123,92.0098244373,_100,4,>100
4916,dynamic,597,28549720,92.0117484847,_100,7,>100
4917,singled,597,28550317,92.013672532,_100,7,>100
4918,louisville,597,28550914,92.0155965794,_100,10,>100
4919,angel,596,28551510,92.0175174039,_100,5,>100
4920,tear,596,28552106,92.0194382284,_100,4,>100
4921,resource,596,28552702,92.021359053,_100,8,>100
4922,taxpayer,596,28553298,92.0232798775,_100,8,>100
4923,disclosure,596,28553894,92.025200702,_100,10,>100
4924,rivera,596,28554490,92.0271215265,_100,6,>100
4925,discount,596,28555086,92.029042351,_100,8,>100
4926,berry,596,28555682,92.0309631755,_100,5,>100
4927,techniques,596,28556278,92.0328840001,_100,10,>100
4928,regime,595,28556873,92.0348016017,_100,6,>100
4929,decent,595,28557468,92.0367192034,_100,6,>100
4930,architect,595,28558063,92.038636805,_100,9,>100
4931,simpson,595,28558658,92.0405544067,_100,7,>100
4932,pensions,595,28559253,92.0424720083,_100,8,>100
4933,pole,595,28559848,92.04438961,_100,4,>100
4934,dressing,595,28560443,92.0463072116,_100,8,>100
4935,depends,594,28561037,92.0482215904,_100,7,>100
4936,privately,594,28561631,92.0501359692,_100,9,>100
4937,sustained,594,28562225,92.052050348,_100,9,>100
4938,arnold,594,28562819,92.0539647268,_100,6,>100
4939,restored,594,28563413,92.0558791056,_100,8,>100
4940,medication,593,28564006,92.0577902616,_100,10,>100
4941,editorial,593,28564599,92.0597014175,_100,9,>100
4942,sophisticated,593,28565192,92.0616125734,_100,13,>100
4943,bake,593,28565785,92.0635237294,_100,4,>100
4944,springfield,593,28566378,92.0654348853,_100,11,>100
4945,operators,593,28566971,92.0673460412,_100,9,>100
4946,recruit,592,28567563,92.0692539743,_100,7,>100
4947,deny,592,28568155,92.0711619074,_100,4,>100
4948,innovation,592,28568747,92.0730698405,_100,10,>100
4949,branches,592,28569339,92.0749777735,_100,8,>100
4950,disorder,592,28569931,92.0768857066,_100,8,>100
4951,excitement,592,28570523,92.0787936397,_100,10,>100
4952,choosing,592,28571115,92.0807015728,_100,8,>100
4953,ambitious,592,28571707,92.0826095059,_100,9,>100
4954,beloved,592,28572299,92.0845174389,_100,7,>100
4955,nominated,591,28572890,92.0864221491,_100,9,>100
4956,packages,591,28573481,92.0883268594,_100,8,>100
4957,islands,591,28574072,92.0902315696,_100,7,>100
4958,moral,591,28574663,92.0921362798,_100,5,>100
4959,quinn,591,28575254,92.09404099,_100,5,>100
4960,formerly,591,28575845,92.0959457002,_100,8,>100
4961,treatments,590,28576435,92.0978471876,_100,10,>100
4962,baked,590,28577025,92.0997486749,_100,5,>100
4963,routes,590,28577615,92.1016501623,_100,6,>100
4964,lenders,589,28578204,92.1035484268,_100,7,>100
4965,bergen,589,28578793,92.1054466913,_100,6,>100
4966,hunting,589,28579382,92.1073449558,_100,7,>100
4967,engage,589,28579971,92.1092432203,_100,6,>100
4968,grateful,589,28580560,92.1111414848,_100,8,>100
4969,questioning,589,28581149,92.1130397493,_100,11,>100
4970,liquor,589,28581738,92.1149380138,_100,6,>100
4971,rankings,589,28582327,92.1168362783,_100,8,>100
4972,preseason,588,28582915,92.1187313199,_100,9,>100
4973,qb,588,28583503,92.1206263615,_100,2,>100
4974,dale,588,28584091,92.1225214032,_100,4,>100
4975,philosophy,588,28584679,92.1244164448,_100,10,>100
4976,quietly,588,28585267,92.1263114864,_100,7,>100
4977,clerk,588,28585855,92.1282065281,_100,5,>100
4978,shake,588,28586443,92.1301015697,_100,5,>100
4979,desserts,588,28587031,92.1319966114,_100,8,>100
4980,newspapers,588,28587619,92.133891653,_100,10,>100
4981,lasted,588,28588207,92.1357866946,_100,6,>100
4982,physicians,588,28588795,92.1376817363,_100,10,>100
4983,accepting,588,28589383,92.1395767779,_100,9,>100
4984,casey,587,28589970,92.1414685967,_100,5,>100
4985,congressman,587,28590557,92.1433604155,_100,11,>100
4986,kate,587,28591144,92.1452522342,_100,4,>100
4987,pound,587,28591731,92.147144053,_100,5,>100
4988,suburbs,587,28592318,92.1490358718,_100,7,>100
4989,cookies,586,28592904,92.1509244677,_100,7,>100
4990,advised,586,28593490,92.1528130636,_100,7,>100
4991,pilots,586,28594076,92.1547016595,_100,6,>100
4992,corrections,586,28594662,92.1565902555,_100,11,>100
4993,pipe,586,28595248,92.1584788514,_100,4,>100
4994,provisions,586,28595834,92.1603674473,_100,10,>100
4995,adjusted,585,28596419,92.1622528203,_100,8,>100
4996,brilliant,585,28597004,92.1641381934,_100,9,>100
4997,irs,584,28597588,92.1660203436,_100,3,>100
4998,aboard,584,28598172,92.1679024938,_100,6,>100
4999,revolution,584,28598756,92.169784644,_100,10,>100
5000,globe,584,28599340,92.1716667942,_100,5,>100
5001,ireland,584,28599924,92.1735489444,_100,7,>100
5002,gibson,584,28600508,92.1754310946,_100,6,>100
5003,greens,583,28601091,92.1773100219,_100,6,>100
5004,bee,583,28601674,92.1791889493,_100,3,>100
5005,converted,583,28602257,92.1810678766,_100,9,>100
5006,v,583,28602840,92.1829468039,_100,1,>100
5007,slowed,582,28603422,92.1848225084,_100,6,>100
5008,neighboring,582,28604004,92.1866982129,_100,11,>100
5009,array,582,28604586,92.1885739174,_100,5,>100
5010,emotions,582,28605168,92.1904496218,_100,8,>100
5011,comic,582,28605750,92.1923253263,_100,5,>100
5012,youtube,582,28606332,92.1942010308,_100,7,>100
5013,planes,581,28606913,92.1960735124,_100,6,>100
5014,disclose,581,28607494,92.197945994,_100,8,>100
5015,legend,581,28608075,92.1998184756,_100,6,>100
5016,ferry,581,28608656,92.2016909573,_100,5,>100
5017,vietnam,581,28609237,92.2035634389,_100,7,>100
5018,leagues,581,28609818,92.2054359205,_100,7,>100
5019,suggesting,581,28610399,92.2073084021,_100,10,>100
5020,examples,581,28610980,92.2091808837,_100,8,>100
5021,hernandez,581,28611561,92.2110533653,_100,9,>100
5022,fastest,581,28612142,92.212925847,_100,7,>100
5023,wire,581,28612723,92.2147983286,_100,4,>100
5024,australia,581,28613304,92.2166708102,_100,9,>100
5025,technologies,581,28613885,92.2185432918,_100,12,>100
5026,bishop,580,28614465,92.2204125506,_100,6,>100
5027,encounter,580,28615045,92.2222818093,_100,9,>100
5028,careers,579,28615624,92.2241478452,_100,7,>100
5029,swept,579,28616203,92.2260138811,_100,5,>100
5030,beds,579,28616782,92.227879917,_100,4,>100
5031,therefore,579,28617361,92.2297459529,_100,9,>100
5032,purposes,579,28617940,92.2316119888,_100,8,>100
5033,banned,578,28618518,92.2334748018,_100,6,>100
5034,lebron,578,28619096,92.2353376149,_100,6,>100
5035,occasional,578,28619674,92.2372004279,_100,10,>100
5036,naturally,578,28620252,92.239063241,_100,9,>100
5037,draws,578,28620830,92.240926054,_100,5,>100
5038,offset,578,28621408,92.242788867,_100,6,>100
5039,marc,578,28621986,92.2446516801,_100,4,>100
5040,amazon,578,28622564,92.2465144931,_100,6,>100
5041,burns,578,28623142,92.2483773061,_100,5,>100
5042,concerts,577,28623719,92.2502368963,_100,8,>100
5043,nutrition,577,28624296,92.2520964865,_100,9,>100
5044,cain,576,28624872,92.2539528538,_100,4,>100
5045,wise,576,28625448,92.2558092211,_100,4,>100
5046,integrity,576,28626024,92.2576655884,_100,9,>100
5047,slide,576,28626600,92.2595219558,_100,5,>100
5048,tons,576,28627176,92.2613783231,_100,4,>100
5049,description,575,28627751,92.2632314675,_100,11,>100
5050,emily,575,28628326,92.265084612,_100,5,>100
5051,leonard,575,28628901,92.2669377565,_100,7,>100
5052,praise,575,28629476,92.2687909009,_100,6,>100
5053,rid,575,28630051,92.2706440454,_100,3,>100
5054,fits,574,28630625,92.272493967,_100,4,>100
5055,pledged,574,28631199,92.2743438886,_100,7,>100
5056,depend,574,28631773,92.2761938102,_100,6,>100
5057,ranking,574,28632347,92.2780437318,_100,7,>100
5058,electronics,574,28632921,92.2798936534,_100,11,>100
5059,compelling,574,28633495,92.281743575,_100,10,>100
5060,disappeared,574,28634069,92.2835934966,_100,11,>100
5061,responding,573,28634642,92.2854401953,_100,10,>100
5062,mortgages,573,28635215,92.287286894,_100,9,>100
5063,studios,573,28635788,92.2891335928,_100,7,>100
5064,defendant,573,28636361,92.2909802915,_100,9,>100
5065,planted,573,28636934,92.2928269902,_100,7,>100
5066,mild,573,28637507,92.294673689,_100,4,>100
5067,barrel,573,28638080,92.2965203877,_100,6,>100
5068,goalie,573,28638653,92.2983670865,_100,6,>100
5069,temporarily,572,28639225,92.3002105623,_100,11,>100
5070,predators,572,28639797,92.3020540382,_100,9,>100
5071,impression,572,28640369,92.3038975141,_100,10,>100
5072,vista,572,28640941,92.30574099,_100,5,>100
5073,context,572,28641513,92.3075844658,_100,7,>100
5074,wheel,572,28642085,92.3094279417,_100,5,>100
5075,unfair,571,28642656,92.3112681947,_100,6,>100
5076,initiatives,571,28643227,92.3131084478,_100,11,>100
5077,misconduct,571,28643798,92.3149487008,_100,10,>100
5078,palmer,571,28644369,92.3167889538,_100,6,>100
5079,architecture,571,28644940,92.3186292068,_100,12,>100
5080,nowhere,571,28645511,92.3204694598,_100,7,>100
5081,motors,571,28646082,92.3223097128,_100,6,>100
5082,buses,571,28646653,92.3241499659,_100,5,>100
5083,financially,570,28647223,92.325986996,_100,11,>100
5084,surprisingly,570,28647793,92.3278240262,_100,12,>100
5085,chevrolet,570,28648363,92.3296610563,_100,9,>100
5086,borders,570,28648933,92.3314980865,_100,7,>100
5087,andrea,570,28649503,92.3333351166,_100,6,>100
5088,nasa,570,28650073,92.3351721468,_100,4,>100
5089,stunning,570,28650643,92.337009177,_100,8,>100
5090,sustainable,569,28651212,92.3388429843,_100,11,>100
5091,wrestling,569,28651781,92.3406767916,_100,9,>100
5092,scared,569,28652350,92.3425105989,_100,6,>100
5093,punishment,568,28652918,92.3443411833,_100,10,>100
5094,hearts,568,28653486,92.3461717677,_100,6,>100
5095,motivated,568,28654054,92.3480023522,_100,9,>100
5096,ellis,568,28654622,92.3498329366,_100,5,>100
5097,gerald,568,28655190,92.351663521,_100,6,>100
5098,wildcats,568,28655758,92.3534941055,_100,8,>100
5099,participation,567,28656325,92.3553214671,_100,13,>100
5100,investigated,567,28656892,92.3571488286,_100,12,>100
5101,teenage,567,28657459,92.3589761902,_100,7,>100
5102,deer,567,28658026,92.3608035518,_100,4,>100
5103,ignore,567,28658593,92.3626309134,_100,6,>100
5104,stream,567,28659160,92.364458275,_100,6,>100
5105,testify,566,28659726,92.3662824137,_100,7,>100
5106,hurricane,566,28660292,92.3681065524,_100,9,>100
5107,purple,566,28660858,92.3699306911,_100,6,>100
5108,nuggets,566,28661424,92.3717548298,_100,7,>100
5109,counting,565,28661989,92.3735757457,_100,8,>100
5110,parma,565,28662554,92.3753966615,_100,5,>100
5111,negotiating,565,28663119,92.3772175774,_100,11,>100
5112,sorts,565,28663684,92.3790384933,_100,5,>100
5113,toss,565,28664249,92.3808594091,_100,4,>100
5114,default,565,28664814,92.382680325,_100,7,>100
5115,fines,565,28665379,92.3845012408,_100,5,>100
5116,mound,565,28665944,92.3863221567,_100,5,>100
5117,seating,565,28666509,92.3881430725,_100,7,>100
5118,pinot,565,28667074,92.3899639884,_100,5,>100
5119,bipartisan,564,28667638,92.3917816814,_100,10,>100
5120,alert,564,28668202,92.3935993744,_100,5,>100
5121,vegetable,564,28668766,92.3954170674,_100,9,>100
5122,aspect,564,28669330,92.3972347604,_100,6,>100
5123,recommendation,564,28669894,92.3990524534,_100,14,>100
5124,longest,564,28670458,92.4008701464,_100,7,>100
5125,joel,563,28671021,92.4026846165,_100,4,>100
5126,preferred,563,28671584,92.4044990867,_100,9,>100
5127,municipalities,563,28672147,92.4063135568,_100,14,>100
5128,alaska,562,28672709,92.4081248041,_100,6,>100
5129,licenses,562,28673271,92.4099360514,_100,8,>100
5130,sang,561,28673832,92.4117440758,_100,4,>100
5131,segment,561,28674393,92.4135521002,_100,7,>100
5132,engines,561,28674954,92.4153601246,_100,7,>100
5133,slight,561,28675515,92.417168149,_100,6,>100
5134,legendary,561,28676076,92.4189761735,_100,9,>100
5135,stern,560,28676636,92.420780975,_100,5,>100
5136,epa,560,28677196,92.4225857766,_100,3,>100
5137,texture,560,28677756,92.4243905781,_100,7,>100
5138,gateway,560,28678316,92.4261953797,_100,7,>100
5139,newport,560,28678876,92.4280001813,_100,7,>100
5140,announcing,559,28679435,92.42980176,_100,10,>100
5141,peterson,559,28679994,92.4316033387,_100,8,>100
5142,dried,559,28680553,92.4334049173,_100,5,>100
5143,collapsed,559,28681112,92.435206496,_100,9,>100
5144,jenkins,559,28681671,92.4370080747,_100,7,>100
5145,notified,558,28682229,92.4388064306,_100,8,>100
5146,suv,558,28682787,92.4406047864,_100,3,>100
5147,memorable,558,28683345,92.4424031423,_100,9,>100
5148,dirt,558,28683903,92.4442014981,_100,4,>100
5149,elbow,558,28684461,92.4459998539,_100,5,>100
5150,etc,558,28685019,92.4477982098,_100,3,>100
5151,sb,557,28685576,92.4495933428,_100,2,>100
5152,spectacular,557,28686133,92.4513884757,_100,11,>100
5153,outs,557,28686690,92.4531836087,_100,4,>100
5154,bulk,557,28687247,92.4549787417,_100,4,>100
5155,ought,557,28687804,92.4567738747,_100,5,>100
5156,stark,556,28688360,92.4585657848,_100,5,>100
5157,negotiate,556,28688916,92.4603576949,_100,9,>100
5158,booked,556,28689472,92.462149605,_100,6,>100
5159,ounces,556,28690028,92.4639415151,_100,6,>100
5160,cox,556,28690584,92.4657334253,_100,3,>100
5161,juan,556,28691140,92.4675253354,_100,4,>100
5162,thrilled,555,28691695,92.4693140226,_100,8,>100
5163,tossed,555,28692250,92.4711027099,_100,6,>100
5164,productive,555,28692805,92.4728913972,_100,10,>100
5165,wheat,555,28693360,92.4746800844,_100,5,>100
5166,disclosed,555,28693915,92.4764687717,_100,9,>100
5167,jamie,555,28694470,92.4782574589,_100,5,>100
5168,borrowing,555,28695025,92.4800461462,_100,9,>100
5169,ancient,554,28695579,92.4818316106,_100,7,>100
5170,fries,554,28696133,92.483617075,_100,5,>100
5171,scouting,554,28696687,92.4854025394,_100,8,>100
5172,enrolled,554,28697241,92.4871880038,_100,8,>100
5173,towers,554,28697795,92.4889734682,_100,6,>100
5174,clinical,554,28698349,92.4907589326,_100,8,>100
5175,loop,553,28698902,92.4925411741,_100,4,>100
5176,scoreless,553,28699455,92.4943234157,_100,9,>100
5177,accessible,553,28700008,92.4961056572,_100,10,>100
5178,stopping,553,28700561,92.4978878987,_100,8,>100
5179,helicopter,553,28701114,92.4996701403,_100,10,>100
5180,wondered,553,28701667,92.5014523818,_100,8,>100
5181,stroke,552,28702219,92.5032314005,_100,6,>100
5182,uncle,552,28702771,92.5050104192,_100,5,>100
5183,bitter,552,28703323,92.5067894379,_100,6,>100
5184,awesome,552,28703875,92.5085684565,_100,7,>100
5185,valued,552,28704427,92.5103474752,_100,6,>100
5186,blew,552,28704979,92.5121264939,_100,4,>100
5187,teeth,551,28705530,92.5139022897,_100,5,>100
5188,routinely,551,28706081,92.5156780855,_100,9,>100
5189,rehab,551,28706632,92.5174538814,_100,5,>100
5190,immigrant,551,28707183,92.5192296772,_100,9,>100
5191,anonymous,551,28707734,92.521005473,_100,9,>100
5192,downs,551,28708285,92.5227812688,_100,5,>100
5193,homeland,550,28708835,92.5245538418,_100,8,>100
5194,saint,550,28709385,92.5263264147,_100,5,>100
5195,beneath,550,28709935,92.5280989877,_100,7,>100
5196,550,550,28710485,92.5298715607,_100,3,>100
5197,endorsed,550,28711035,92.5316441336,_100,8,>100
5198,stakes,550,28711585,92.5334167066,_100,6,>100
5199,occasion,549,28712134,92.5351860567,_100,8,>100
5200,dominant,549,28712683,92.5369554068,_100,8,>100
5201,graduates,549,28713232,92.5387247569,_100,9,>100
5202,demanded,549,28713781,92.540494107,_100,8,>100
5203,remote,548,28714329,92.5422602342,_100,6,>100
5204,shuttle,548,28714877,92.5440263614,_100,7,>100
5205,secondary,548,28715425,92.5457924887,_100,9,>100
5206,incentive,548,28715973,92.5475586159,_100,9,>100
5207,gaming,547,28716520,92.5493215203,_100,6,>100
5208,surveillance,547,28717067,92.5510844247,_100,12,>100
5209,lutheran,547,28717614,92.5528473291,_100,8,>100
5210,wet,547,28718161,92.5546102334,_100,3,>100
5211,premier,547,28718708,92.5563731378,_100,7,>100
5212,gonna,547,28719255,92.5581360422,_100,5,>100
5213,indicted,547,28719802,92.5598989466,_100,8,>100
5214,chiefs,547,28720349,92.561661851,_100,6,>100
5215,entertaining,547,28720896,92.5634247553,_100,12,>100
5216,finger,546,28721442,92.5651844369,_100,6,>100
5217,helpful,546,28721988,92.5669441184,_100,7,>100
5218,lets,546,28722534,92.5687037999,_100,4,>100
5219,unified,546,28723080,92.5704634814,_100,7,>100
5220,highland,546,28723626,92.5722231629,_100,8,>100
5221,tressel,546,28724172,92.5739828445,_100,7,>100
5222,knight,546,28724718,92.575742526,_100,6,>100
5223,iconic,546,28725264,92.5775022075,_100,6,>100
5224,upgrade,545,28725809,92.5792586662,_100,7,>100
5225,trends,545,28726354,92.5810151248,_100,6,>100
5226,sandusky,544,28726898,92.5827683606,_100,8,>100
5227,chemicals,544,28727442,92.5845215964,_100,9,>100
5228,diversity,544,28727986,92.5862748322,_100,9,>100
5229,tiger,543,28728529,92.5880248452,_100,5,>100
5230,evaluation,543,28729072,92.5897748581,_100,10,>100
5231,shifts,542,28729614,92.5915216482,_100,6,>100
5232,patio,542,28730156,92.5932684383,_100,5,>100
5233,fake,542,28730698,92.5950152283,_100,4,>100
5234,venues,542,28731240,92.5967620184,_100,6,>100
5235,shower,541,28731781,92.5985055856,_100,6,>100
5236,sundays,541,28732322,92.6002491529,_100,7,>100
5237,oversees,541,28732863,92.6019927201,_100,8,>100
5238,stability,541,28733404,92.6037362873,_100,9,>100
5239,derek,541,28733945,92.6054798545,_100,5,>100
5240,sidewalk,541,28734486,92.6072234217,_100,8,>100
5241,holidays,541,28735027,92.608966989,_100,8,>100
5242,lifted,541,28735568,92.6107105562,_100,6,>100
5243,matchup,540,28736108,92.6124509005,_100,7,>100
5244,breathing,540,28736648,92.6141912449,_100,9,>100
5245,chambers,540,28737188,92.6159315893,_100,8,>100
5246,creamy,540,28737728,92.6176719336,_100,6,>100
5247,powell,540,28738268,92.619412278,_100,6,>100
5248,warehouse,540,28738808,92.6211526223,_100,9,>100
5249,habitat,540,28739348,92.6228929667,_100,7,>100
5250,curtis,540,28739888,92.6246333111,_100,6,>100
5251,speculation,539,28740427,92.6263704326,_100,11,>100
5252,visual,539,28740966,92.6281075541,_100,6,>100
5253,teaches,539,28741505,92.6298446756,_100,7,>100
5254,cemetery,539,28742044,92.6315817971,_100,8,>100
5255,christ,539,28742583,92.6333189186,_100,6,>100
5256,cedar,538,28743121,92.6350528172,_100,5,>100
5257,overwhelming,538,28743659,92.6367867158,_100,12,>100
5258,retain,538,28744197,92.6385206145,_100,6,>100
5259,obesity,538,28744735,92.6402545131,_100,7,>100
5260,trauma,538,28745273,92.6419884118,_100,6,>100
5261,programming,538,28745811,92.6437223104,_100,11,>100
5262,smell,538,28746349,92.645456209,_100,5,>100
5263,parliament,537,28746886,92.6471868848,_100,10,>100
5264,twist,537,28747423,92.6489175606,_100,5,>100
5265,smoked,537,28747960,92.6506482364,_100,6,>100
5266,jumping,536,28748496,92.6523756893,_100,7,>100
5267,lengthy,536,28749032,92.6541031422,_100,7,>100
5268,buck,536,28749568,92.6558305951,_100,4,>100
5269,sacks,536,28750104,92.6575580481,_100,5,>100
5270,suits,536,28750640,92.659285501,_100,5,>100
5271,pure,536,28751176,92.6610129539,_100,4,>100
5272,footage,536,28751712,92.6627404068,_100,7,>100
5273,arriving,536,28752248,92.6644678597,_100,8,>100
5274,elaborate,536,28752784,92.6661953127,_100,9,>100
5275,guidance,536,28753320,92.6679227656,_100,8,>100
5276,timothy,535,28753855,92.6696469956,_100,7,>100
5277,ski,535,28754390,92.6713712257,_100,3,>100
5278,database,535,28754925,92.6730954558,_100,8,>100
5279,verizon,535,28755460,92.6748196858,_100,7,>100
5280,tying,534,28755994,92.676540693,_100,5,>100
5281,citrus,534,28756528,92.6782617002,_100,6,>100
5282,outlook,534,28757062,92.6799827074,_100,7,>100
5283,aviation,533,28757595,92.6817004918,_100,8,>100
5284,fortunate,533,28758128,92.6834182761,_100,9,>100
5285,copies,533,28758661,92.6851360604,_100,6,>100
5286,reverse,533,28759194,92.6868538448,_100,7,>100
5287,confirm,533,28759727,92.6885716291,_100,7,>100
5288,acknowledge,533,28760260,92.6902894135,_100,11,>100
5289,bound,533,28760793,92.6920071978,_100,5,>100
5290,sprint,533,28761326,92.6937249821,_100,6,>100
5291,methods,533,28761859,92.6954427665,_100,7,>100
5292,reviewing,533,28762392,92.6971605508,_100,9,>100
5293,favored,533,28762925,92.6988783352,_100,7,>100
5294,vary,532,28763457,92.7005928966,_100,4,>100
5295,suggestions,532,28763989,92.7023074581,_100,11,>100
5296,difficulty,532,28764521,92.7040220196,_100,10,>100
5297,declining,532,28765053,92.7057365811,_100,9,>100
5298,accountable,531,28765584,92.7074479197,_100,11,>100
5299,chronic,531,28766115,92.7091592583,_100,7,>100
5300,aspects,531,28766646,92.710870597,_100,7,>100
5301,toys,531,28767177,92.7125819356,_100,4,>100
5302,irving,530,28767707,92.7142900513,_100,6,>100
5303,bend,530,28768237,92.7159981671,_100,4,>100
5304,compact,530,28768767,92.7177062829,_100,7,>100
5305,flexibility,530,28769297,92.7194143986,_100,11,>100
5306,turnpike,530,28769827,92.7211225144,_100,8,>100
5307,indication,530,28770357,92.7228306301,_100,10,>100
5308,andre,529,28770886,92.724535523,_100,5,>100
5309,explaining,529,28771415,92.7262404159,_100,10,>100
5310,retiring,529,28771944,92.7279453088,_100,8,>100
5311,pump,529,28772473,92.7296502017,_100,4,>100
5312,eliminating,529,28773002,92.7313550946,_100,11,>100
5313,ashley,529,28773531,92.7330599875,_100,6,>100
5314,closest,529,28774060,92.7347648804,_100,7,>100
5315,imposed,529,28774589,92.7364697733,_100,7,>100
5316,owed,529,28775118,92.7381746662,_100,4,>100
5317,rapidly,529,28775647,92.7398795591,_100,7,>100
5318,adopt,528,28776175,92.7415812292,_100,5,>100
5319,innocent,528,28776703,92.7432828992,_100,8,>100
5320,abroad,528,28777231,92.7449845693,_100,6,>100
5321,governors,528,28777759,92.7466862393,_100,9,>100
5322,everyday,528,28778287,92.7483879094,_100,8,>100
5323,chargers,528,28778815,92.7500895794,_100,8,>100
5324,emails,527,28779342,92.7517880266,_100,6,>100
5325,samples,527,28779869,92.7534864738,_100,7,>100
5326,diners,527,28780396,92.7551849209,_100,6,>100
5327,reagan,527,28780923,92.7568833681,_100,6,>100
5328,displayed,527,28781450,92.7585818153,_100,9,>100
5329,recovering,527,28781977,92.7602802625,_100,10,>100
5330,versus,527,28782504,92.7619787097,_100,6,>100
5331,emissions,526,28783030,92.763673934,_100,9,>100
5332,ravi,526,28783556,92.7653691583,_100,4,>100
5333,sewer,526,28784082,92.7670643826,_100,5,>100
5334,wrap,526,28784608,92.7687596069,_100,4,>100
5335,underground,526,28785134,92.7704548313,_100,11,>100
5336,maintaining,526,28785660,92.7721500556,_100,11,>100
5337,mandatory,526,28786186,92.7738452799,_100,9,>100
5338,carbon,526,28786712,92.7755405042,_100,6,>100
5339,appealing,525,28787237,92.7772325057,_100,9,>100
5340,focuses,525,28787762,92.7789245071,_100,7,>100
5341,periods,525,28788287,92.7806165086,_100,7,>100
5342,rear,525,28788812,92.7823085101,_100,4,>100
5343,bachelor,524,28789336,92.7839972887,_100,8,>100
5344,slated,524,28789860,92.7856860673,_100,6,>100
5345,showcase,524,28790384,92.7873748459,_100,8,>100
5346,directions,524,28790908,92.7890636245,_100,10,>100
5347,cardinal,524,28791432,92.7907524031,_100,8,>100
5348,broth,524,28791956,92.7924411817,_100,5,>100
5349,predict,524,28792480,92.7941299603,_100,7,>100
5350,donate,524,28793004,92.7958187389,_100,6,>100
5351,drops,524,28793528,92.7975075175,_100,5,>100
5352,lou,524,28794052,92.7991962961,_100,3,>100
5353,cape,524,28794576,92.8008850747,_100,4,>100
5354,ordinary,524,28795100,92.8025738533,_100,8,>100
5355,unveiled,524,28795624,92.8042626319,_100,8,>100
5356,shaw,524,28796148,92.8059514105,_100,4,>100
5357,whitney,523,28796671,92.8076369662,_100,7,>100
5358,youngest,523,28797194,92.809322522,_100,8,>100
5359,renewed,523,28797717,92.8110080777,_100,7,>100
5360,horizon,523,28798240,92.8126936335,_100,7,>100
5361,holdings,523,28798763,92.8143791892,_100,8,>100
5362,shed,522,28799285,92.8160615221,_100,4,>100
5363,tommy,522,28799807,92.817743855,_100,5,>100
5364,reminder,522,28800329,92.8194261878,_100,8,>100
5365,dawn,522,28800851,92.8211085207,_100,4,>100
5366,receives,522,28801373,92.8227908536,_100,8,>100
5367,multnomah,522,28801895,92.8244731865,_100,9,>100
5368,attraction,522,28802417,92.8261555194,_100,10,>100
5369,committees,522,28802939,92.8278378522,_100,10,>100
5370,scientific,522,28803461,92.8295201851,_100,10,>100
5371,lineman,522,28803983,92.831202518,_100,7,>100
5372,dealt,521,28804504,92.832881628,_100,5,>100
5373,portfolio,521,28805025,92.8345607381,_100,9,>100
5374,aide,521,28805546,92.8362398481,_100,4,>100
5375,reflected,521,28806067,92.8379189581,_100,9,>100
5376,murdoch,521,28806588,92.8395980681,_100,7,>100
5377,blocking,521,28807109,92.8412771781,_100,8,>100
5378,convince,521,28807630,92.8429562882,_100,8,>100
5379,fastball,521,28808151,92.8446353982,_100,8,>100
5380,counseling,521,28808672,92.8463145082,_100,10,>100
5381,cocaine,521,28809193,92.8479936182,_100,7,>100
5382,camps,521,28809714,92.8496727282,_100,5,>100
5383,fingers,520,28810234,92.8513486154,_100,7,>100
5384,borough,520,28810754,92.8530245026,_100,7,>100
5385,attacking,520,28811274,92.8547003897,_100,9,>100
5386,thieves,520,28811794,92.8563762769,_100,7,>100
5387,louisiana,520,28812314,92.8580521641,_100,9,>100
5388,subsidies,520,28812834,92.8597280512,_100,9,>100
5389,authors,520,28813354,92.8614039384,_100,7,>100
5390,drain,520,28813874,92.8630798255,_100,5,>100
5391,allies,520,28814394,92.8647557127,_100,6,>100
5392,reductions,520,28814914,92.8664315999,_100,10,>100
5393,mirror,519,28815433,92.8681042642,_100,6,>100
5394,reads,519,28815952,92.8697769285,_100,5,>100
5395,manages,519,28816471,92.8714495928,_100,7,>100
5396,flu,519,28816990,92.8731222571,_100,3,>100
5397,oswego,519,28817509,92.8747949214,_100,6,>100
5398,nuts,519,28818028,92.8764675857,_100,4,>100
5399,edition,518,28818546,92.8781370271,_100,7,>100
5400,achieved,518,28819064,92.8798064686,_100,8,>100
5401,load,518,28819582,92.88147591,_100,4,>100
5402,info,518,28820100,92.8831453514,_100,4,>100
5403,patterns,517,28820617,92.88481157,_100,8,>100
5404,supervisors,517,28821134,92.8864777886,_100,11,>100
5405,saturdays,517,28821651,92.8881440072,_100,9,>100
5406,tobacco,517,28822168,92.8898102258,_100,7,>100
5407,coat,517,28822685,92.8914764443,_100,4,>100
5408,devastating,517,28823202,92.8931426629,_100,11,>100
5409,cooperation,516,28823718,92.8948056586,_100,11,>100
5410,subjects,516,28824234,92.8964686544,_100,8,>100
5411,compliance,516,28824750,92.8981316501,_100,10,>100
5412,ballet,516,28825266,92.8997946458,_100,6,>100
5413,landmark,516,28825782,92.9014576415,_100,8,>100
5414,jacobs,515,28826297,92.9031174144,_100,6,>100
5415,escaped,515,28826812,92.9047771873,_100,7,>100
5416,resignation,515,28827327,92.9064369601,_100,11,>100
5417,hurdles,515,28827842,92.908096733,_100,7,>100
5418,anna,515,28828357,92.9097565058,_100,4,>100
5419,dwight,515,28828872,92.9114162787,_100,6,>100
5420,locals,514,28829386,92.9130728287,_100,6,>100
5421,credited,514,28829900,92.9147293787,_100,8,>100
5422,proceedings,514,28830414,92.9163859287,_100,11,>100
5423,sausage,514,28830928,92.9180424787,_100,7,>100
5424,displays,514,28831442,92.9196990287,_100,8,>100
5425,hell,514,28831956,92.9213555787,_100,4,>100
5426,sends,514,28832470,92.9230121287,_100,5,>100
5427,sparked,514,28832984,92.9246686787,_100,7,>100
5428,collaboration,513,28833497,92.9263220059,_100,13,>100
5429,musician,513,28834010,92.927975333,_100,8,>100
5430,carol,513,28834523,92.9296286601,_100,5,>100
5431,anonymity,512,28835035,92.9312787644,_100,9,>100
5432,dialogue,512,28835547,92.9329288687,_100,8,>100
5433,sanctions,512,28836059,92.934578973,_100,9,>100
5434,julie,512,28836571,92.9362290773,_100,5,>100
5435,seal,512,28837083,92.9378791816,_100,4,>100
5436,matching,512,28837595,92.9395292858,_100,8,>100
5437,shortstop,512,28838107,92.9411793901,_100,9,>100
5438,standout,512,28838619,92.9428294944,_100,8,>100
5439,philip,512,28839131,92.9444795987,_100,6,>100
5440,premiere,512,28839643,92.946129703,_100,8,>100
5441,pacers,512,28840155,92.9477798072,_100,6,>100
5442,strain,511,28840666,92.9494266887,_100,6,>100
5443,regard,511,28841177,92.9510735701,_100,6,>100
5444,grandfather,511,28841688,92.9527204515,_100,11,>100
5445,enthusiasm,511,28842199,92.9543673329,_100,10,>100
5446,workforce,511,28842710,92.9560142144,_100,9,>100
5447,pets,511,28843221,92.9576610958,_100,4,>100
5448,taliban,510,28843731,92.9593047543,_100,7,>100
5449,provider,510,28844241,92.9609484129,_100,8,>100
5450,workshop,510,28844751,92.9625920715,_100,8,>100
5451,offenses,510,28845261,92.96423573,_100,8,>100
5452,median,510,28845771,92.9658793886,_100,6,>100
5453,strikeouts,510,28846281,92.9675230472,_100,10,>100
5454,designs,510,28846791,92.9691667057,_100,7,>100
5455,cabrera,510,28847301,92.9708103643,_100,7,>100
5456,harvey,510,28847811,92.9724540228,_100,6,>100
5457,welcomed,509,28848320,92.9740944585,_100,8,>100
5458,scholarships,509,28848829,92.9757348942,_100,12,>100
5459,bloomberg,509,28849338,92.9773753299,_100,9,>100
5460,priced,509,28849847,92.9790157657,_100,6,>100
5461,sharks,509,28850356,92.9806562014,_100,6,>100
5462,reliable,509,28850865,92.9822966371,_100,8,>100
5463,lodge,509,28851374,92.9839370728,_100,5,>100
5464,discussing,509,28851883,92.9855775085,_100,10,>100
5465,fantastic,508,28852391,92.9872147213,_100,9,>100
5466,technique,508,28852899,92.9888519341,_100,9,>100
5467,arranged,508,28853407,92.990489147,_100,8,>100
5468,headlines,508,28853915,92.9921263598,_100,9,>100
5469,ugly,508,28854423,92.9937635727,_100,4,>100
5470,bailey,507,28854930,92.9953975627,_100,6,>100
5471,bullet,507,28855437,92.9970315526,_100,6,>100
5472,topics,507,28855944,92.9986655426,_100,6,>100
5473,cabin,507,28856451,93.0002995326,_100,5,>100
5474,partisan,507,28856958,93.0019335226,_100,8,>100
5475,beaverton,507,28857465,93.0035675126,_100,9,>100
5476,melissa,507,28857972,93.0052015025,_100,7,>100
5477,designers,506,28858478,93.0068322697,_100,9,>100
5478,comply,506,28858984,93.0084630368,_100,6,>100
5479,engaging,506,28859490,93.0100938039,_100,8,>100
5480,contests,506,28859996,93.011724571,_100,8,>100
5481,pursuing,505,28860501,93.0133521153,_100,8,>100
5482,excessive,505,28861006,93.0149796596,_100,9,>100
5483,click,505,28861511,93.0166072038,_100,5,>100
5484,brook,505,28862016,93.0182347481,_100,5,>100
5485,defenseman,505,28862521,93.0198622924,_100,10,>100
5486,smiling,505,28863026,93.0214898366,_100,7,>100
5487,meantime,505,28863531,93.0231173809,_100,8,>100
5488,tastes,505,28864036,93.0247449251,_100,6,>100
5489,unprecedented,504,28864540,93.0263692465,_100,13,>100
5490,consent,504,28865044,93.0279935679,_100,7,>100
5491,styles,504,28865548,93.0296178893,_100,6,>100
5492,weigh,504,28866052,93.0312422108,_100,5,>100
5493,bones,504,28866556,93.0328665322,_100,5,>100
5494,measured,504,28867060,93.0344908536,_100,8,>100
5495,opinions,503,28867563,93.0361119521,_100,8,>100
5496,bullying,503,28868066,93.0377330506,_100,8,>100
5497,federation,503,28868569,93.0393541492,_100,10,>100
5498,safely,503,28869072,93.0409752477,_100,6,>100
5499,resolved,502,28869574,93.0425931234,_100,8,>100
5500,ribs,502,28870076,93.0442109991,_100,4,>100
5501,benjamin,502,28870578,93.0458288748,_100,8,>100
5502,hybrid,502,28871080,93.0474467505,_100,6,>100
5503,capt,502,28871582,93.0490646261,_100,4,>100
5504,hook,502,28872084,93.0506825018,_100,4,>100
5505,strickland,502,28872586,93.0523003775,_100,10,>100
5506,agrees,502,28873088,93.0539182532,_100,6,>100
5507,stealing,501,28873589,93.055532906,_100,8,>100
5508,brazil,501,28874090,93.0571475588,_100,6,>100
5509,businessman,501,28874591,93.0587622117,_100,11,>100
5510,homemade,501,28875092,93.0603768645,_100,8,>100
5511,weird,501,28875593,93.0619915173,_100,5,>100
5512,mainstream,501,28876094,93.0636061701,_100,10,>100
5513,layer,501,28876595,93.0652208229,_100,5,>100
5514,deemed,500,28877095,93.0668322529,_100,6,>100
5515,500,500,28877595,93.0684436829,_100,3,>100
5516,zach,500,28878095,93.0700551128,_100,4,>100
5517,powder,500,28878595,93.0716665428,_100,6,>100
5518,theaters,500,28879095,93.0732779728,_100,8,>100
5519,anchor,499,28879594,93.0748861799,_100,6,>100
5520,coyotes,499,28880093,93.076494387,_100,7,>100
5521,beverly,499,28880592,93.0781025941,_100,7,>100
5522,dirty,499,28881091,93.0797108012,_100,5,>100
5523,adjust,499,28881590,93.0813190083,_100,6,>100
5524,noble,499,28882089,93.0829272154,_100,5,>100
5525,cousin,499,28882588,93.0845354225,_100,6,>100
5526,pierce,499,28883087,93.0861436296,_100,6,>100
5527,crust,499,28883586,93.0877518367,_100,5,>100
5528,journalists,499,28884085,93.0893600438,_100,11,>100
5529,thousand,498,28884583,93.090965028,_100,8,>100
5530,definition,498,28885081,93.0925700123,_100,10,>100
5531,burglary,498,28885579,93.0941749965,_100,8,>100
5532,glen,498,28886077,93.0957799808,_100,4,>100
5533,placing,498,28886575,93.097384965,_100,7,>100
5534,clara,498,28887073,93.0989899493,_100,5,>100
5535,qualifying,497,28887570,93.1005917106,_100,10,>100
5536,grams,497,28888067,93.102193472,_100,5,>100
5537,kicks,497,28888564,93.1037952334,_100,5,>100
5538,laughing,497,28889061,93.1053969948,_100,8,>100
5539,jokes,497,28889558,93.1069987562,_100,5,>100
5540,empire,497,28890055,93.1086005176,_100,6,>100
5541,baylor,496,28890551,93.1101990561,_100,6,>100
5542,starring,496,28891047,93.1117975946,_100,8,>100
5543,litigation,496,28891543,93.1133961331,_100,10,>100
5544,ana,496,28892039,93.1149946716,_100,3,>100
5545,batter,496,28892535,93.1165932102,_100,6,>100
5546,costa,496,28893031,93.1181917487,_100,5,>100
5547,stomach,496,28893527,93.1197902872,_100,7,>100
5548,delivering,496,28894023,93.1213888257,_100,10,>100
5549,samuel,495,28894518,93.1229841414,_100,6,>100
5550,lending,495,28895013,93.1245794571,_100,7,>100
5551,heroes,495,28895508,93.1261747727,_100,6,>100
5552,licensed,495,28896003,93.1277700884,_100,8,>100
5553,stephanie,495,28896498,93.1293654041,_100,9,>100
5554,coastal,494,28896992,93.1309574969,_100,7,>100
5555,selections,494,28897486,93.1325495897,_100,10,>100
5556,reluctant,494,28897980,93.1341416825,_100,9,>100
5557,rallied,494,28898474,93.1357337753,_100,7,>100
5558,tracy,494,28898968,93.1373258681,_100,5,>100
5559,sooner,494,28899462,93.1389179609,_100,6,>100
5560,pursuit,494,28899956,93.1405100537,_100,7,>100
5561,lately,494,28900450,93.1421021465,_100,6,>100
5562,ian,494,28900944,93.1436942393,_100,3,>100
5563,stevens,494,28901438,93.1452863321,_100,7,>100
5564,snapped,493,28901931,93.146875202,_100,7,>100
5565,distributed,493,28902424,93.148464072,_100,11,>100
5566,inspector,493,28902917,93.1500529419,_100,9,>100
5567,mccarthy,493,28903410,93.1516418119,_100,8,>100
5568,households,493,28903903,93.1532306818,_100,10,>100
5569,fargo,492,28904395,93.1548163289,_100,5,>100
5570,excess,492,28904887,93.156401976,_100,6,>100
5571,brewery,492,28905379,93.1579876231,_100,7,>100
5572,bull,492,28905871,93.1595732701,_100,4,>100
5573,boats,492,28906363,93.1611589172,_100,5,>100
5574,tablet,492,28906855,93.1627445643,_100,6,>100
5575,exists,491,28907346,93.1643269885,_100,6,>100
5576,gene,491,28907837,93.1659094128,_100,4,>100
5577,chemistry,491,28908328,93.167491837,_100,9,>100
5578,recycling,491,28908819,93.1690742612,_100,9,>100
5579,feared,491,28909310,93.1706566854,_100,6,>100
5580,compare,491,28909801,93.1722391097,_100,7,>100
5581,zumwalt,491,28910292,93.1738215339,_100,7,>100
5582,corporation,491,28910783,93.1754039581,_100,11,>100
5583,cry,491,28911274,93.1769863823,_100,3,>100
5584,baptist,491,28911765,93.1785688065,_100,7,>100
5585,spill,491,28912256,93.1801512308,_100,5,>100
5586,bp,491,28912747,93.181733655,_100,2,>100
5587,brewing,491,28913238,93.1833160792,_100,7,>100
5588,acquisition,491,28913729,93.1848985034,_100,11,>100
5589,offenders,490,28914219,93.1864777048,_100,9,>100
5590,wolf,490,28914709,93.1880569062,_100,4,>100
5591,ensemble,490,28915199,93.1896361075,_100,8,>100
5592,consumption,490,28915689,93.1912153089,_100,11,>100
5593,intensity,490,28916179,93.1927945103,_100,9,>100
5594,exploring,490,28916669,93.1943737116,_100,9,>100
5595,violating,489,28917158,93.1959496901,_100,9,>100
5596,innovative,489,28917647,93.1975256686,_100,10,>100
5597,adjacent,489,28918136,93.1991016471,_100,8,>100
5598,safer,489,28918625,93.2006776256,_100,5,>100
5599,flags,489,28919114,93.2022536041,_100,5,>100
5600,shoulders,489,28919603,93.2038295826,_100,9,>100
5601,flooding,489,28920092,93.2054055611,_100,8,>100
5602,sowell,489,28920581,93.2069815397,_100,6,>100
5603,castle,489,28921070,93.2085575182,_100,6,>100
5604,protective,488,28921558,93.2101302738,_100,10,>100
5605,buyer,488,28922046,93.2117030294,_100,5,>100
5606,critic,488,28922534,93.2132757851,_100,6,>100
5607,delicate,488,28923022,93.2148485407,_100,8,>100
5608,automaker,488,28923510,93.2164212964,_100,9,>100
5609,anaheim,488,28923998,93.217994052,_100,7,>100
5610,counted,488,28924486,93.2195668077,_100,7,>100
5611,awful,487,28924973,93.2211363404,_100,5,>100
5612,considers,487,28925460,93.2227058732,_100,9,>100
5613,robin,487,28925947,93.224275406,_100,5,>100
5614,barbecue,487,28926434,93.2258449388,_100,8,>100
5615,celtics,487,28926921,93.2274144716,_100,7,>100
5616,knock,487,28927408,93.2289840044,_100,5,>100
5617,relevant,486,28927894,93.2305503143,_100,8,>100
5618,egypt,486,28928380,93.2321166242,_100,5,>100
5619,demonstrated,486,28928866,93.2336829341,_100,12,>100
5620,appetizers,486,28929352,93.2352492441,_100,10,>100
5621,awaiting,486,28929838,93.236815554,_100,8,>100
5622,auditorium,486,28930324,93.2383818639,_100,10,>100
5623,similarly,486,28930810,93.2399481738,_100,9,>100
5624,sizes,485,28931295,93.2415112609,_100,5,>100
5625,ships,485,28931780,93.243074348,_100,5,>100
5626,sandy,485,28932265,93.244637435,_100,5,>100
5627,regions,485,28932750,93.2462005221,_100,7,>100
5628,boulder,485,28933235,93.2477636092,_100,7,>100
5629,tucson,485,28933720,93.2493266962,_100,6,>100
5630,decrease,485,28934205,93.2508897833,_100,8,>100
5631,conventional,485,28934690,93.2524528703,_100,12,>100
5632,stoudemire,485,28935175,93.2540159574,_100,10,>100
5633,mere,485,28935660,93.2555790445,_100,4,>100
5634,removing,485,28936145,93.2571421315,_100,8,>100
5635,gaining,484,28936629,93.2587019957,_100,7,>100
5636,burst,484,28937113,93.2602618599,_100,5,>100
5637,heated,484,28937597,93.2618217242,_100,6,>100
5638,crude,484,28938081,93.2633815884,_100,5,>100
5639,radiation,484,28938565,93.2649414526,_100,9,>100
5640,henderson,483,28939048,93.2664980939,_100,9,>100
5641,erie,483,28939531,93.2680547352,_100,4,>100
5642,gregory,483,28940014,93.2696113766,_100,7,>100
5643,semifinal,483,28940497,93.2711680179,_100,9,>100
5644,edwardsville,483,28940980,93.2727246593,_100,12,>100
5645,medications,483,28941463,93.2742813006,_100,11,>100
5646,tablespoon,483,28941946,93.275837942,_100,10,>100
5647,raiders,483,28942429,93.2773945833,_100,7,>100
5648,bowls,483,28942912,93.2789512247,_100,5,>100
5649,newest,482,28943394,93.2805046431,_100,6,>100
5650,reds,482,28943876,93.2820580616,_100,4,>100
5651,portions,482,28944358,93.2836114801,_100,8,>100
5652,screaming,482,28944840,93.2851648986,_100,9,>100
5653,complain,482,28945322,93.2867183171,_100,8,>100
5654,uncertain,482,28945804,93.2882717356,_100,9,>100
5655,cps,482,28946286,93.289825154,_100,3,>100
5656,admits,481,28946767,93.2913753497,_100,6,>100
5657,holder,481,28947248,93.2929255453,_100,6,>100
5658,inch,481,28947729,93.2944757409,_100,4,>100
5659,vincent,481,28948210,93.2960259365,_100,7,>100
5660,lean,480,28948690,93.2975729093,_100,4,>100
5661,politician,480,28949170,93.2991198821,_100,10,>100
5662,burton,480,28949650,93.3006668548,_100,6,>100
5663,sometime,480,28950130,93.3022138276,_100,8,>100
5664,480,480,28950610,93.3037608004,_100,3,>100
5665,worthy,480,28951090,93.3053077731,_100,6,>100
5666,snap,480,28951570,93.3068547459,_100,4,>100
5667,holmes,480,28952050,93.3084017187,_100,6,>100
5668,batters,480,28952530,93.3099486914,_100,7,>100
5669,crying,480,28953010,93.3114956642,_100,6,>100
5670,intends,480,28953490,93.313042637,_100,7,>100
5671,android,480,28953970,93.3145896097,_100,7,>100
5672,photographer,479,28954449,93.3161333596,_100,12,>100
5673,arab,479,28954928,93.3176771095,_100,4,>100
5674,unnecessary,479,28955407,93.3192208594,_100,11,>100
5675,cohen,479,28955886,93.3207646093,_100,5,>100
5676,brewers,478,28956364,93.3223051364,_100,7,>100
5677,syrup,478,28956842,93.3238456634,_100,5,>100
5678,nicole,478,28957320,93.3253861905,_100,6,>100
5679,mavericks,478,28957798,93.3269267175,_100,9,>100
5680,accusations,478,28958276,93.3284672446,_100,11,>100
5681,sufficient,478,28958754,93.3300077716,_100,10,>100
5682,chemical,478,28959232,93.3315482986,_100,8,>100
5683,veto,478,28959710,93.3330888257,_100,4,>100
5684,fundamental,478,28960188,93.3346293527,_100,11,>100
5685,civilian,478,28960666,93.3361698798,_100,8,>100
5686,bargain,477,28961143,93.337707184,_100,7,>100
5687,montgomery,477,28961620,93.3392444882,_100,10,>100
5688,strongest,477,28962097,93.3407817923,_100,9,>100
5689,practical,477,28962574,93.3423190965,_100,9,>100
5690,ariz,477,28963051,93.3438564007,_100,4,>100
5691,seton,477,28963528,93.3453937049,_100,5,>100
5692,expertise,477,28964005,93.3469310091,_100,9,>100
5693,transmission,477,28964482,93.3484683133,_100,12,>100
5694,motorcycle,477,28964959,93.3500056174,_100,10,>100
5695,salads,477,28965436,93.3515429216,_100,6,>100
5696,bowling,477,28965913,93.3530802258,_100,7,>100
5697,chile,477,28966390,93.35461753,_100,5,>100
5698,hungry,476,28966866,93.3561516113,_100,6,>100
5699,investing,476,28967342,93.3576856926,_100,9,>100
5700,newt,476,28967818,93.359219774,_100,4,>100
5701,parole,476,28968294,93.3607538553,_100,6,>100
5702,lime,476,28968770,93.3622879366,_100,4,>100
5703,formally,476,28969246,93.3638220179,_100,8,>100
5704,booth,476,28969722,93.3653560993,_100,5,>100
5705,flash,476,28970198,93.3668901806,_100,5,>100
5706,eddie,476,28970674,93.3684242619,_100,5,>100
5707,debris,476,28971150,93.3699583432,_100,6,>100
5708,dancers,476,28971626,93.3714924246,_100,7,>100
5709,travis,476,28972102,93.3730265059,_100,6,>100
5710,brett,475,28972577,93.3745573644,_100,5,>100
5711,implement,475,28973052,93.3760882228,_100,9,>100
5712,northwestern,475,28973527,93.3776190813,_100,12,>100
5713,battling,475,28974002,93.3791499398,_100,8,>100
5714,humans,475,28974477,93.3806807982,_100,6,>100
5715,memo,475,28974952,93.3822116567,_100,4,>100
5716,disappointment,475,28975427,93.3837425151,_100,14,>100
5717,profitable,475,28975902,93.3852733736,_100,10,>100
5718,renovation,475,28976377,93.3868042321,_100,10,>100
5719,palace,474,28976851,93.3883318677,_100,6,>100
5720,commander,474,28977325,93.3898595033,_100,9,>100
5721,arthur,474,28977799,93.3913871389,_100,6,>100
5722,pleasure,474,28978273,93.3929147745,_100,8,>100
5723,boehner,474,28978747,93.3944424101,_100,7,>100
5724,jesse,474,28979221,93.3959700457,_100,5,>100
5725,reader,474,28979695,93.3974976813,_100,6,>100
5726,input,474,28980169,93.3990253169,_100,5,>100
5727,pressed,474,28980643,93.4005529525,_100,7,>100
5728,cops,474,28981117,93.4020805881,_100,4,>100
5729,elegant,474,28981591,93.4036082237,_100,7,>100
5730,vibe,473,28982064,93.4051326365,_100,4,>100
5731,columnist,473,28982537,93.4066570492,_100,9,>100
5732,joked,473,28983010,93.408181462,_100,5,>100
5733,emerge,473,28983483,93.4097058747,_100,6,>100
5734,lynch,473,28983956,93.4112302875,_100,5,>100
5735,stepping,473,28984429,93.4127547002,_100,8,>100
5736,updates,473,28984902,93.4142791129,_100,7,>100
5737,mack,473,28985375,93.4158035257,_100,4,>100
5738,excuse,473,28985848,93.4173279384,_100,6,>100
5739,investigator,473,28986321,93.4188523512,_100,12,>100
5740,divide,473,28986794,93.4203767639,_100,6,>100
5741,loving,472,28987266,93.4218979538,_100,6,>100
5742,produces,472,28987738,93.4234191437,_100,8,>100
5743,maple,472,28988210,93.4249403336,_100,5,>100
5744,paradise,472,28988682,93.4264615235,_100,8,>100
5745,strategies,471,28989153,93.4279794905,_100,10,>100
5746,bud,471,28989624,93.4294974575,_100,3,>100
5747,reliever,471,28990095,93.4310154245,_100,8,>100
5748,interceptions,471,28990566,93.4325333916,_100,13,>100
5749,ballots,471,28991037,93.4340513586,_100,7,>100
5750,structures,471,28991508,93.4355693256,_100,10,>100
5751,objects,470,28991978,93.4370840698,_100,7,>100
5752,occupied,470,28992448,93.4385988139,_100,8,>100
5753,subsequent,470,28992918,93.4401135581,_100,10,>100
5754,dam,470,28993388,93.4416283023,_100,3,>100
5755,reserved,470,28993858,93.4431430464,_100,8,>100
5756,speakers,470,28994328,93.4446577906,_100,8,>100
5757,patrons,470,28994798,93.4461725348,_100,7,>100
5758,governing,470,28995268,93.4476872789,_100,9,>100
5759,completion,470,28995738,93.4492020231,_100,10,>100
5760,metrohealth,470,28996208,93.4507167673,_100,11,>100
5761,collections,470,28996678,93.4522315114,_100,11,>100
5762,freeze,470,28997148,93.4537462556,_100,6,>100
5763,transport,469,28997617,93.4552577769,_100,9,>100
5764,bath,469,28998086,93.4567692982,_100,4,>100
5765,harper,469,28998555,93.4582808195,_100,6,>100
5766,frustrating,469,28999024,93.4597923408,_100,11,>100
5767,opted,469,28999493,93.4613038621,_100,5,>100
5768,skillet,469,28999962,93.4628153834,_100,7,>100
5769,jacket,469,29000431,93.4643269047,_100,6,>100
5770,unfortunate,469,29000900,93.465838426,_100,11,>100
5771,infection,469,29001369,93.4673499473,_100,9,>100
5772,shifted,469,29001838,93.4688614687,_100,7,>100
5773,jam,469,29002307,93.47037299,_100,3,>100
5774,noir,469,29002776,93.4718845113,_100,4,>100
5775,gently,469,29003245,93.4733960326,_100,6,>100
5776,preservation,469,29003714,93.4749075539,_100,12,>100
5777,shaker,469,29004183,93.4764190752,_100,6,>100
5778,jacob,469,29004652,93.4779305965,_100,5,>100
5779,walsh,468,29005120,93.4794388949,_100,5,>100
5780,entrepreneurs,468,29005588,93.4809471934,_100,13,>100
5781,climbing,468,29006056,93.4824554918,_100,8,>100
5782,confused,468,29006524,93.4839637903,_100,8,>100
5783,discrimination,468,29006992,93.4854720887,_100,14,>100
5784,chili,468,29007460,93.4869803872,_100,5,>100
5785,insists,468,29007928,93.4884886856,_100,7,>100
5786,survival,468,29008396,93.489996984,_100,8,>100
5787,harsh,467,29008863,93.4915020596,_100,5,>100
5788,exam,467,29009330,93.4930071352,_100,4,>100
5789,trap,467,29009797,93.4945122108,_100,4,>100
5790,goldman,467,29010264,93.4960172864,_100,7,>100
5791,campuses,467,29010731,93.497522362,_100,8,>100
5792,shootings,467,29011198,93.4990274376,_100,9,>100
5793,edison,467,29011665,93.5005325131,_100,6,>100
5794,wrist,467,29012132,93.5020375887,_100,5,>100
5795,automatically,467,29012599,93.5035426643,_100,13,>100
5796,aim,467,29013066,93.5050477399,_100,3,>100
5797,perkins,467,29013533,93.5065528155,_100,7,>100
5798,dust,467,29014000,93.5080578911,_100,4,>100
5799,paperwork,467,29014467,93.5095629667,_100,9,>100
5800,nicholas,467,29014934,93.5110680422,_100,8,>100
5801,corzine,466,29015400,93.512569895,_100,7,>100
5802,diseases,466,29015866,93.5140717477,_100,8,>100
5803,detention,466,29016332,93.5155736004,_100,9,>100
5804,debts,466,29016798,93.5170754531,_100,5,>100
5805,hood,466,29017264,93.5185773059,_100,4,>100
5806,forgotten,466,29017730,93.5200791586,_100,9,>100
5807,electrical,466,29018196,93.5215810113,_100,10,>100
5808,caucus,466,29018662,93.523082864,_100,6,>100
5809,observers,466,29019128,93.5245847168,_100,9,>100
5810,viewing,466,29019594,93.5260865695,_100,7,>100
5811,ridiculous,466,29020060,93.5275884222,_100,10,>100
5812,rings,466,29020526,93.5290902749,_100,5,>100
5813,victoria,466,29020992,93.5305921277,_100,8,>100
5814,pledge,466,29021458,93.5320939804,_100,6,>100
5815,dakota,465,29021923,93.5335926103,_100,6,>100
5816,removal,465,29022388,93.5350912401,_100,7,>100
5817,jean,465,29022853,93.53658987,_100,4,>100
5818,danielle,465,29023318,93.5380884999,_100,8,>100
5819,kenneth,465,29023783,93.5395871297,_100,7,>100
5820,discover,465,29024248,93.5410857596,_100,8,>100
5821,silence,464,29024712,93.5425811666,_100,7,>100
5822,catching,464,29025176,93.5440765736,_100,8,>100
5823,posts,464,29025640,93.5455719806,_100,5,>100
5824,peers,464,29026104,93.5470673876,_100,5,>100
5825,beth,464,29026568,93.5485627946,_100,4,>100
5826,chorus,464,29027032,93.5500582016,_100,6,>100
5827,westminster,464,29027496,93.5515536086,_100,11,>100
5828,patricia,464,29027960,93.5530490156,_100,8,>100
5829,burke,464,29028424,93.5545444226,_100,5,>100
5830,trigger,463,29028887,93.5560366068,_100,7,>100
5831,rant,463,29029350,93.5575287909,_100,4,>100
5832,define,463,29029813,93.5590209751,_100,6,>100
5833,swim,463,29030276,93.5605131592,_100,4,>100
5834,airports,463,29030739,93.5620053434,_100,8,>100
5835,boundaries,463,29031202,93.5634975275,_100,10,>100
5836,irvine,463,29031665,93.5649897117,_100,6,>100
5837,accidents,463,29032128,93.5664818958,_100,9,>100
5838,intimate,463,29032591,93.56797408,_100,8,>100
5839,remind,463,29033054,93.5694662641,_100,6,>100
5840,glendale,463,29033517,93.5709584482,_100,8,>100
5841,marie,462,29033979,93.5724474095,_100,5,>100
5842,alike,462,29034441,93.5739363708,_100,5,>100
5843,neuman,462,29034903,93.5754253321,_100,6,>100
5844,cure,462,29035365,93.5769142934,_100,4,>100
5845,useful,462,29035827,93.5784032547,_100,6,>100
5846,islamic,462,29036289,93.579892216,_100,7,>100
5847,knights,462,29036751,93.5813811772,_100,7,>100
5848,links,462,29037213,93.5828701385,_100,5,>100
5849,valid,462,29037675,93.5843590998,_100,5,>100
5850,nasdaq,462,29038137,93.5858480611,_100,6,>100
5851,disability,462,29038599,93.5873370224,_100,10,>100
5852,tent,461,29039060,93.5888227608,_100,4,>100
5853,id,461,29039521,93.5903084992,_100,2,>100
5854,pressing,461,29039982,93.5917942377,_100,8,>100
5855,adequate,461,29040443,93.5932799761,_100,8,>100
5856,establishment,461,29040904,93.5947657145,_100,13,>100
5857,meaningful,460,29041364,93.5962482301,_100,10,>100
5858,wr,460,29041824,93.5977307457,_100,2,>100
5859,liability,460,29042284,93.5992132612,_100,9,>100
5860,wounds,460,29042744,93.6006957768,_100,6,>100
5861,idaho,460,29043204,93.6021782923,_100,5,>100
5862,demonstrations,460,29043664,93.6036608079,_100,14,>100
5863,lafayette,460,29044124,93.6051433235,_100,9,>100
5864,julia,459,29044583,93.6066226162,_100,5,>100
5865,thriller,459,29045042,93.6081019089,_100,8,>100
5866,staffers,459,29045501,93.6095812016,_100,8,>100
5867,respected,459,29045960,93.6110604943,_100,9,>100
5868,permitted,459,29046419,93.612539787,_100,9,>100
5869,corners,459,29046878,93.6140190797,_100,7,>100
5870,mothers,458,29047336,93.6154951496,_100,7,>100
5871,lorain,458,29047794,93.6169712194,_100,6,>100
5872,random,458,29048252,93.6184472893,_100,6,>100
5873,maps,458,29048710,93.6199233591,_100,4,>100
5874,treats,458,29049168,93.6213994289,_100,6,>100
5875,lap,458,29049626,93.6228754988,_100,3,>100
5876,argues,458,29050084,93.6243515686,_100,6,>100
5877,nebraska,458,29050542,93.6258276385,_100,8,>100
5878,touches,458,29051000,93.6273037083,_100,7,>100
5879,consensus,457,29051457,93.6287765553,_100,9,>100
5880,transformed,457,29051914,93.6302494023,_100,11,>100
5881,trailer,457,29052371,93.6317222493,_100,7,>100
5882,soda,457,29052828,93.6331950963,_100,4,>100
5883,aides,457,29053285,93.6346679433,_100,5,>100
5884,favors,456,29053741,93.6361375674,_100,6,>100
5885,teenagers,456,29054197,93.6376071915,_100,9,>100
5886,sarkozy,456,29054653,93.6390768156,_100,7,>100
5887,dip,456,29055109,93.6405464398,_100,3,>100
5888,fruits,456,29055565,93.6420160639,_100,6,>100
5889,transplant,456,29056021,93.643485688,_100,10,>100
5890,repeal,456,29056477,93.6449553121,_100,6,>100
5891,packers,456,29056933,93.6464249363,_100,7,>100
5892,install,455,29057388,93.6478913375,_100,7,>100
5893,aims,455,29057843,93.6493577388,_100,4,>100
5894,symbol,455,29058298,93.6508241401,_100,6,>100
5895,tribe,455,29058753,93.6522905413,_100,5,>100
5896,redevelopment,455,29059208,93.6537569426,_100,13,>100
5897,anxiety,455,29059663,93.6552233439,_100,7,>100
5898,skip,455,29060118,93.6566897451,_100,4,>100
5899,panthers,455,29060573,93.6581561464,_100,8,>100
5900,dunn,455,29061028,93.6596225477,_100,4,>100
5901,wishes,454,29061482,93.6610857261,_100,6,>100
5902,kills,454,29061936,93.6625489045,_100,5,>100
5903,shame,454,29062390,93.6640120829,_100,5,>100
5904,hikes,454,29062844,93.6654752613,_100,5,>100
5905,shoe,454,29063298,93.6669384397,_100,4,>100
5906,brutal,454,29063752,93.6684016181,_100,6,>100
5907,purchasing,454,29064206,93.6698647965,_100,10,>100
5908,battles,454,29064660,93.6713279749,_100,7,>100
5909,israeli,454,29065114,93.6727911533,_100,7,>100
5910,robertson,454,29065568,93.6742543317,_100,9,>100
5911,rehabilitation,453,29066021,93.6757142873,_100,14,>100
5912,carriers,453,29066474,93.6771742428,_100,8,>100
5913,trick,453,29066927,93.6786341984,_100,5,>100
5914,phrase,453,29067380,93.6800941539,_100,6,>100
5915,pub,453,29067833,93.6815541095,_100,3,>100
5916,drag,453,29068286,93.683014065,_100,4,>100
5917,arrives,453,29068739,93.6844740206,_100,7,>100
5918,leaf,453,29069192,93.6859339761,_100,4,>100
5919,pile,452,29069644,93.6873907088,_100,4,>100
5920,educators,452,29070096,93.6888474415,_100,9,>100
5921,embraced,452,29070548,93.6903041742,_100,8,>100
5922,greene,452,29071000,93.6917609069,_100,6,>100
5923,napa,452,29071452,93.6932176395,_100,4,>100
5924,searched,452,29071904,93.6946743722,_100,8,>100
5925,coughlin,451,29072355,93.6961278821,_100,8,>100
5926,rebuild,451,29072806,93.6975813919,_100,7,>100
5927,inquiry,451,29073257,93.6990349017,_100,7,>100
5928,sole,451,29073708,93.7004884115,_100,4,>100
5929,arrangements,451,29074159,93.7019419214,_100,12,>100
5930,exclusive,451,29074610,93.7033954312,_100,9,>100
5931,warming,451,29075061,93.704848941,_100,7,>100
5932,developments,450,29075511,93.706299228,_100,12,>100
5933,ethnic,450,29075961,93.7077495149,_100,6,>100
5934,luis,450,29076411,93.7091998019,_100,4,>100
5935,softball,450,29076861,93.7106500889,_100,8,>100
5936,affects,450,29077311,93.7121003758,_100,7,>100
5937,finalists,450,29077761,93.7135506628,_100,9,>100
5938,hart,450,29078211,93.7150009498,_100,4,>100
5939,megan,450,29078661,93.7164512367,_100,5,>100
5940,targeting,450,29079111,93.7179015237,_100,9,>100
5941,horror,450,29079561,93.7193518107,_100,6,>100
5942,450,450,29080011,93.7208020976,_100,3,>100
5943,crop,450,29080461,93.7222523846,_100,4,>100
5944,tune,450,29080911,93.7237026716,_100,4,>100
5945,valentine,449,29081360,93.7251497357,_100,9,>100
5946,narrative,449,29081809,93.7265967998,_100,9,>100
5947,beaches,449,29082258,93.7280438639,_100,7,>100
5948,partially,449,29082707,93.729490928,_100,9,>100
5949,nationals,449,29083156,93.7309379921,_100,9,>100
5950,romance,449,29083605,93.7323850562,_100,7,>100
5951,monster,449,29084054,93.7338321203,_100,7,>100
5952,greatly,449,29084503,93.7352791844,_100,7,>100
5953,concussion,449,29084952,93.7367262485,_100,10,>100
5954,graduating,448,29085400,93.7381700898,_100,10,>100
5955,refund,448,29085848,93.739613931,_100,6,>100
5956,heck,448,29086296,93.7410577723,_100,4,>100
5957,sciences,448,29086744,93.7425016135,_100,8,>100
5958,huntington,448,29087192,93.7439454548,_100,10,>100
5959,justices,448,29087640,93.745389296,_100,8,>100
5960,tragic,448,29088088,93.7468331373,_100,6,>100
5961,curious,448,29088536,93.7482769785,_100,7,>100
5962,aaa,448,29088984,93.7497208198,_100,3,>100
5963,posed,448,29089432,93.751164661,_100,5,>100
5964,willingness,448,29089880,93.7526085023,_100,11,>100
5965,premiums,447,29090327,93.7540491206,_100,8,>100
5966,rim,447,29090774,93.755489739,_100,3,>100
5967,alzheimer,447,29091221,93.7569303574,_100,9,>100
5968,porter,447,29091668,93.7583709758,_100,6,>100
5969,listing,447,29092115,93.7598115942,_100,7,>100
5970,majors,447,29092562,93.7612522126,_100,6,>100
5971,notable,447,29093009,93.762692831,_100,7,>100
5972,examined,447,29093456,93.7641334493,_100,8,>100
5973,flames,447,29093903,93.7655740677,_100,6,>100
5974,hardest,447,29094350,93.7670146861,_100,7,>100
5975,ace,447,29094797,93.7684553045,_100,3,>100
5976,muslims,447,29095244,93.7698959229,_100,7,>100
5977,mode,446,29095690,93.7713333184,_100,4,>100
5978,pharmacy,446,29096136,93.7727707139,_100,8,>100
5979,vibrant,446,29096582,93.7742081095,_100,7,>100
5980,jared,446,29097028,93.775645505,_100,5,>100
5981,syrian,446,29097474,93.7770829005,_100,6,>100
5982,pioneer,446,29097920,93.7785202961,_100,7,>100
5983,storms,446,29098366,93.7799576916,_100,6,>100
5984,scary,446,29098812,93.7813950871,_100,5,>100
5985,armstrong,446,29099258,93.7828324826,_100,9,>100
5986,alarm,446,29099704,93.7842698782,_100,5,>100
5987,spin,446,29100150,93.7857072737,_100,4,>100
5988,misdemeanor,446,29100596,93.7871446692,_100,11,>100
5989,heroin,445,29101041,93.7885788419,_100,6,>100
5990,diane,445,29101486,93.7900130146,_100,5,>100
5991,hub,445,29101931,93.7914471872,_100,3,>100
5992,addresses,445,29102376,93.7928813599,_100,9,>100
5993,neil,445,29102821,93.7943155326,_100,4,>100
5994,tenants,445,29103266,93.7957497052,_100,7,>100
5995,loyal,445,29103711,93.7971838779,_100,5,>100
5996,resorts,445,29104156,93.7986180506,_100,7,>100
5997,postal,445,29104601,93.8000522232,_100,6,>100
5998,fares,445,29105046,93.8014863959,_100,5,>100
5999,kurt,444,29105490,93.8029173457,_100,4,>100
6000,trout,444,29105934,93.8043482955,_100,5,>100
6001,peaceful,444,29106378,93.8057792453,_100,8,>100
6002,thoroughly,444,29106822,93.8072101951,_100,10,>100
6003,supportive,444,29107266,93.8086411449,_100,10,>100
6004,tourist,444,29107710,93.8100720947,_100,7,>100
6005,outing,444,29108154,93.8115030445,_100,6,>100
6006,maine,444,29108598,93.8129339943,_100,5,>100
6007,projections,444,29109042,93.8143649442,_100,11,>100
6008,transparency,444,29109486,93.815795894,_100,12,>100
6009,outlets,444,29109930,93.8172268438,_100,7,>100
6010,vinegar,443,29110373,93.8186545707,_100,7,>100
6011,enforce,443,29110816,93.8200822977,_100,7,>100
6012,rumors,443,29111259,93.8215100246,_100,6,>100
6013,retailer,443,29111702,93.8229377516,_100,8,>100
6014,applicants,443,29112145,93.8243654785,_100,10,>100
6015,impose,443,29112588,93.8257932055,_100,6,>100
6016,caring,443,29113031,93.8272209324,_100,6,>100
6017,garbage,443,29113474,93.8286486593,_100,7,>100
6018,inspection,442,29113916,93.8300731634,_100,10,>100
6019,chart,442,29114358,93.8314976675,_100,5,>100
6020,approaches,442,29114800,93.8329221716,_100,10,>100
6021,ralph,442,29115242,93.8343466757,_100,5,>100
6022,johns,442,29115684,93.8357711798,_100,5,>100
6023,bubble,442,29116126,93.8371956839,_100,6,>100
6024,quoted,442,29116568,93.838620188,_100,6,>100
6025,pools,442,29117010,93.840044692,_100,5,>100
6026,warriors,442,29117452,93.8414691961,_100,8,>100
6027,herbs,441,29117893,93.8428904774,_100,5,>100
6028,lauren,441,29118334,93.8443117586,_100,6,>100
6029,christine,441,29118775,93.8457330398,_100,9,>100
6030,shutout,441,29119216,93.847154321,_100,7,>100
6031,satisfied,440,29119656,93.8485723794,_100,9,>100
6032,bounced,440,29120096,93.8499904378,_100,7,>100
6033,siblings,440,29120536,93.8514084961,_100,8,>100
6034,curry,440,29120976,93.8528265545,_100,5,>100
6035,inventory,440,29121416,93.8542446129,_100,9,>100
6036,evil,440,29121856,93.8556626712,_100,4,>100
6037,440,440,29122296,93.8570807296,_100,3,>100
6038,fountain,440,29122736,93.858498788,_100,8,>100
6039,evaluate,440,29123176,93.8599168463,_100,8,>100
6040,pose,440,29123616,93.8613349047,_100,4,>100
6041,user,440,29124056,93.8627529631,_100,4,>100
6042,renewable,440,29124496,93.8641710214,_100,9,>100
6043,potter,440,29124936,93.8655890798,_100,6,>100
6044,silicon,439,29125375,93.8670039153,_100,7,>100
6045,arrangement,439,29125814,93.8684187508,_100,11,>100
6046,freddie,439,29126253,93.8698335863,_100,7,>100
6047,tornado,439,29126692,93.8712484218,_100,7,>100
6048,carpet,439,29127131,93.8726632574,_100,6,>100
6049,colt,439,29127570,93.8740780929,_100,4,>100
6050,quest,439,29128009,93.8754929284,_100,5,>100
6051,fabric,439,29128448,93.8769077639,_100,6,>100
6052,grows,439,29128887,93.8783225994,_100,5,>100
6053,springsteen,439,29129326,93.8797374349,_100,11,>100
6054,reaches,438,29129764,93.8811490475,_100,7,>100
6055,joan,438,29130202,93.8825606602,_100,4,>100
6056,carson,438,29130640,93.8839722728,_100,6,>100
6057,dome,438,29131078,93.8853838855,_100,4,>100
6058,nurses,438,29131516,93.8867954981,_100,6,>100
6059,rhythm,438,29131954,93.8882071108,_100,6,>100
6060,countless,438,29132392,93.8896187234,_100,9,>100
6061,completing,438,29132830,93.8910303361,_100,10,>100
6062,ali,438,29133268,93.8924419487,_100,3,>100
6063,revised,438,29133706,93.8938535614,_100,7,>100
6064,examine,438,29134144,93.895265174,_100,7,>100
6065,questionable,437,29134581,93.8966735638,_100,12,>100
6066,prevented,437,29135018,93.8980819536,_100,9,>100
6067,bicycle,437,29135455,93.8994903434,_100,7,>100
6068,instant,437,29135892,93.9008987332,_100,7,>100
6069,resistance,437,29136329,93.902307123,_100,10,>100
6070,derrick,437,29136766,93.9037155127,_100,7,>100
6071,transactions,437,29137203,93.9051239025,_100,12,>100
6072,stupid,437,29137640,93.9065322923,_100,6,>100
6073,secured,437,29138077,93.9079406821,_100,7,>100
6074,dj,437,29138514,93.9093490719,_100,2,>100
6075,midway,437,29138951,93.9107574617,_100,6,>100
6076,perception,437,29139388,93.9121658515,_100,10,>100
6077,nathan,437,29139825,93.9135742413,_100,6,>100
6078,blunt,437,29140262,93.914982631,_100,5,>100
6079,boil,437,29140699,93.9163910208,_100,4,>100
6080,dairy,437,29141136,93.9177994106,_100,5,>100
6081,vanilla,437,29141573,93.9192078004,_100,7,>100
6082,barrier,437,29142010,93.9206161902,_100,7,>100
6083,myers,436,29142446,93.9220213571,_100,5,>100
6084,bynum,436,29142882,93.923426524,_100,5,>100
6085,prizes,436,29143318,93.924831691,_100,6,>100
6086,waterfront,436,29143754,93.9262368579,_100,10,>100
6087,lobbying,436,29144190,93.9276420248,_100,8,>100
6088,soldier,436,29144626,93.9290471918,_100,7,>100
6089,raid,436,29145062,93.9304523587,_100,4,>100
6090,salon,436,29145498,93.9318575256,_100,5,>100
6091,ambulance,436,29145934,93.9332626925,_100,9,>100
6092,indicates,436,29146370,93.9346678595,_100,9,>100
6093,unanimously,435,29146805,93.9360698035,_100,11,>100
6094,dolphins,435,29147240,93.9374717476,_100,8,>100
6095,doubts,435,29147675,93.9388736917,_100,6,>100
6096,dixon,435,29148110,93.9402756357,_100,5,>100
6097,clementi,435,29148545,93.9416775798,_100,8,>100
6098,conducting,435,29148980,93.9430795239,_100,10,>100
6099,separately,435,29149415,93.9444814679,_100,10,>100
6100,launching,435,29149850,93.945883412,_100,9,>100
6101,automotive,435,29150285,93.9472853561,_100,10,>100
6102,slam,435,29150720,93.9486873001,_100,4,>100
6103,workouts,435,29151155,93.9500892442,_100,8,>100
6104,stem,435,29151590,93.9514911883,_100,4,>100
6105,bcs,435,29152025,93.9528931323,_100,3,>100
6106,toledo,434,29152459,93.9542918536,_100,6,>100
6107,shakespeare,434,29152893,93.9556905748,_100,11,>100
6108,willamette,434,29153327,93.957089296,_100,10,>100
6109,occasions,434,29153761,93.9584880172,_100,9,>100
6110,batum,434,29154195,93.9598867384,_100,5,>100
6111,webb,434,29154629,93.9612854596,_100,4,>100
6112,joyce,434,29155063,93.9626841808,_100,5,>100
6113,chat,434,29155497,93.964082902,_100,4,>100
6114,risen,434,29155931,93.9654816232,_100,5,>100
6115,fights,433,29156364,93.9668771216,_100,6,>100
6116,separated,433,29156797,93.9682726199,_100,9,>100
6117,apologized,433,29157230,93.9696681183,_100,10,>100
6118,patterson,433,29157663,93.9710636166,_100,9,>100
6119,laptop,433,29158096,93.972459115,_100,6,>100
6120,concessions,433,29158529,93.9738546133,_100,11,>100
6121,auburn,433,29158962,93.9752501117,_100,6,>100
6122,stance,433,29159395,93.97664561,_100,6,>100
6123,identification,433,29159828,93.9780411084,_100,14,>100
6124,contributing,433,29160261,93.9794366067,_100,12,>100
6125,eli,432,29160693,93.9808288822,_100,3,>100
6126,cabinet,432,29161125,93.9822211577,_100,7,>100
6127,approaching,432,29161557,93.9836134332,_100,11,>100
6128,jobless,432,29161989,93.9850057087,_100,7,>100
6129,boasts,432,29162421,93.9863979841,_100,6,>100
6130,fancy,432,29162853,93.9877902596,_100,5,>100
6131,ate,432,29163285,93.9891825351,_100,3,>100
6132,belleville,432,29163717,93.9905748106,_100,10,>100
6133,varieties,432,29164149,93.9919670861,_100,9,>100
6134,bakery,432,29164581,93.9933593616,_100,6,>100
6135,exports,432,29165013,93.9947516371,_100,7,>100
6136,turf,432,29165445,93.9961439126,_100,4,>100
6137,cory,432,29165877,93.997536188,_100,4,>100
6138,aggressively,432,29166309,93.9989284635,_100,12,>100
6139,somerset,432,29166741,94.000320739,_100,8,>100
6140,nicely,431,29167172,94.0017097916,_100,6,>100
6141,tsunami,431,29167603,94.0030988443,_100,7,>100
6142,kenny,431,29168034,94.0044878969,_100,5,>100
6143,theatrical,431,29168465,94.0058769495,_100,10,>100
6144,gen,431,29168896,94.0072660022,_100,3,>100
6145,stretches,431,29169327,94.0086550548,_100,9,>100
6146,corridor,431,29169758,94.0100441074,_100,8,>100
6147,sore,431,29170189,94.01143316,_100,4,>100
6148,ferguson,431,29170620,94.0128222127,_100,8,>100
6149,mar,431,29171051,94.0142112653,_100,3,>100
6150,reyes,430,29171481,94.0155970951,_100,5,>100
6151,vaccine,430,29171911,94.0169829248,_100,7,>100
6152,gradually,430,29172341,94.0183687546,_100,9,>100
6153,flower,430,29172771,94.0197545844,_100,6,>100
6154,components,430,29173201,94.0211404141,_100,10,>100
6155,kindergarten,430,29173631,94.0225262439,_100,12,>100
6156,ear,430,29174061,94.0239120737,_100,3,>100
6157,weber,430,29174491,94.0252979034,_100,5,>100
6158,joshua,430,29174921,94.0266837332,_100,6,>100
6159,inevitable,430,29175351,94.028069563,_100,10,>100
6160,insurers,430,29175781,94.0294553928,_100,8,>100
6161,slip,429,29176210,94.0308379997,_100,4,>100
6162,drunk,429,29176639,94.0322206066,_100,5,>100
6163,confusion,429,29177068,94.0336032135,_100,9,>100
6164,existence,429,29177497,94.0349858204,_100,9,>100
6165,jackie,429,29177926,94.0363684273,_100,6,>100
6166,pregnancy,429,29178355,94.0377510342,_100,9,>100
6167,dig,429,29178784,94.0391336411,_100,3,>100
6168,halfway,428,29179212,94.0405130252,_100,7,>100
6169,sections,428,29179640,94.0418924092,_100,8,>100
6170,santana,428,29180068,94.0432717933,_100,7,>100
6171,corey,428,29180496,94.0446511773,_100,5,>100
6172,troubles,428,29180924,94.0460305613,_100,8,>100
6173,oversee,427,29181351,94.0474067225,_100,7,>100
6174,upscale,427,29181778,94.0487828837,_100,7,>100
6175,swiss,427,29182205,94.0501590449,_100,5,>100
6176,pearl,427,29182632,94.0515352061,_100,5,>100
6177,deficits,427,29183059,94.0529113673,_100,8,>100
6178,subtle,427,29183486,94.0542875285,_100,6,>100
6179,rodgers,427,29183913,94.0556636897,_100,7,>100
6180,penny,427,29184340,94.0570398509,_100,5,>100
6181,lands,427,29184767,94.058416012,_100,5,>100
6182,midfielder,427,29185194,94.0597921732,_100,10,>100
6183,communicate,427,29185621,94.0611683344,_100,11,>100
6184,intention,427,29186048,94.0625444956,_100,9,>100
6185,holland,427,29186475,94.0639206568,_100,7,>100
6186,recommends,426,29186901,94.0652935951,_100,10,>100
6187,signals,426,29187327,94.0666665335,_100,7,>100
6188,capped,426,29187753,94.0680394718,_100,6,>100
6189,celebrities,426,29188179,94.0694124101,_100,11,>100
6190,spray,426,29188605,94.0707853484,_100,5,>100
6191,liver,426,29189031,94.0721582868,_100,5,>100
6192,experiment,426,29189457,94.0735312251,_100,10,>100
6193,christina,426,29189883,94.0749041634,_100,9,>100
6194,pockets,426,29190309,94.0762771018,_100,7,>100
6195,syracuse,426,29190735,94.0776500401,_100,8,>100
6196,hint,426,29191161,94.0790229784,_100,4,>100
6197,risky,426,29191587,94.0803959167,_100,5,>100
6198,object,425,29192012,94.0817656322,_100,6,>100
6199,biden,425,29192437,94.0831353477,_100,5,>100
6200,tempe,425,29192862,94.0845050631,_100,5,>100
6201,lock,425,29193287,94.0858747786,_100,4,>100
6202,en,425,29193712,94.0872444941,_100,2,>100
6203,amanda,425,29194137,94.0886142096,_100,6,>100
6204,recruited,425,29194562,94.089983925,_100,9,>100
6205,norman,425,29194987,94.0913536405,_100,6,>100
6206,containing,425,29195412,94.092723356,_100,10,>100
6207,425,425,29195837,94.0940930714,_100,3,>100
6208,reynolds,424,29196261,94.095459564,_100,8,>100
6209,lloyd,424,29196685,94.0968260566,_100,5,>100
6210,attractions,424,29197109,94.0981925493,_100,11,>100
6211,kirk,424,29197533,94.0995590419,_100,4,>100
6212,ln,424,29197957,94.1009255345,_100,2,>100
6213,traditionally,424,29198381,94.1022920271,_100,13,>100
6214,chains,423,29198804,94.1036552968,_100,6,>100
6215,choir,423,29199227,94.1050185666,_100,5,>100
6216,steals,423,29199650,94.1063818363,_100,6,>100
6217,kathy,423,29200073,94.1077451061,_100,5,>100
6218,principles,423,29200496,94.1091083758,_100,10,>100
6219,sake,423,29200919,94.1104716456,_100,4,>100
6220,katie,423,29201342,94.1118349153,_100,5,>100
6221,wider,423,29201765,94.1131981851,_100,5,>100
6222,proceed,423,29202188,94.1145614548,_100,7,>100
6223,considerable,423,29202611,94.1159247246,_100,12,>100
6224,promotion,422,29203033,94.1172847715,_100,9,>100
6225,spiritual,422,29203455,94.1186448183,_100,9,>100
6226,nominations,422,29203877,94.1200048652,_100,11,>100
6227,lighter,422,29204299,94.1213649121,_100,7,>100
6228,alternatives,422,29204721,94.122724959,_100,12,>100
6229,blown,422,29205143,94.1240850059,_100,5,>100
6230,retirees,422,29205565,94.1254450528,_100,8,>100
6231,extending,422,29205987,94.1268050997,_100,9,>100
6232,surveyed,421,29206408,94.1281619237,_100,8,>100
6233,bible,421,29206829,94.1295187477,_100,5,>100
6234,upgrades,421,29207250,94.1308755718,_100,8,>100
6235,fiction,421,29207671,94.1322323958,_100,7,>100
6236,trayvon,421,29208092,94.1335892198,_100,7,>100
6237,cleanup,421,29208513,94.1349460438,_100,7,>100
6238,killings,421,29208934,94.1363028679,_100,8,>100
6239,hiding,421,29209355,94.1376596919,_100,6,>100
6240,mandel,421,29209776,94.1390165159,_100,6,>100
6241,fails,421,29210197,94.14037334,_100,5,>100
6242,logan,421,29210618,94.141730164,_100,5,>100
6243,leather,421,29211039,94.143086988,_100,7,>100
6244,handles,421,29211460,94.144443812,_100,7,>100
6245,albums,421,29211881,94.1458006361,_100,6,>100
6246,cathedral,420,29212301,94.1471542372,_100,9,>100
6247,expired,420,29212721,94.1485078384,_100,7,>100
6248,format,420,29213141,94.1498614396,_100,6,>100
6249,guided,420,29213561,94.1512150408,_100,6,>100
6250,restricted,420,29213981,94.1525686419,_100,10,>100
6251,layers,420,29214401,94.1539222431,_100,6,>100
6252,wal,420,29214821,94.1552758443,_100,3,>100
6253,contend,420,29215241,94.1566294454,_100,7,>100
6254,chad,420,29215661,94.1579830466,_100,4,>100
6255,420,420,29216081,94.1593366478,_100,3,>100
6256,witnessed,419,29216500,94.1606870261,_100,9,>100
6257,presidents,419,29216919,94.1620374044,_100,10,>100
6258,irene,419,29217338,94.1633877827,_100,5,>100
6259,buddy,419,29217757,94.164738161,_100,5,>100
6260,destruction,419,29218176,94.1660885393,_100,11,>100
6261,reservation,419,29218595,94.1674389176,_100,11,>100
6262,harvest,419,29219014,94.1687892959,_100,7,>100
6263,austerity,419,29219433,94.1701396742,_100,9,>100
6264,colleague,419,29219852,94.1714900525,_100,9,>100
6265,volleyball,419,29220271,94.1728404309,_100,10,>100
6266,lord,419,29220690,94.1741908092,_100,4,>100
6267,lacked,419,29221109,94.1755411875,_100,6,>100
6268,strict,418,29221527,94.1768883429,_100,6,>100
6269,skeptical,418,29221945,94.1782354984,_100,9,>100
6270,diagnosis,418,29222363,94.1795826538,_100,9,>100
6271,emotion,418,29222781,94.1809298093,_100,7,>100
6272,sheets,418,29223199,94.1822769647,_100,6,>100
6273,dutch,418,29223617,94.1836241202,_100,5,>100
6274,lsu,418,29224035,94.1849712756,_100,3,>100
6275,radar,418,29224453,94.1863184311,_100,5,>100
6276,showers,418,29224871,94.1876655865,_100,7,>100
6277,lyrics,418,29225289,94.189012742,_100,6,>100
6278,quake,418,29225707,94.1903598974,_100,5,>100
6279,bonuses,418,29226125,94.1917070529,_100,7,>100
6280,le,418,29226543,94.1930542083,_100,2,>100
6281,influential,418,29226961,94.1944013638,_100,11,>100
6282,weighed,418,29227379,94.1957485192,_100,7,>100
6283,toast,418,29227797,94.1970956747,_100,5,>100
6284,cart,418,29228215,94.1984428301,_100,4,>100
6285,highlighted,418,29228633,94.1997899856,_100,11,>100
6286,mario,418,29229051,94.201137141,_100,5,>100
6287,sf,417,29229468,94.2024810736,_100,2,>100
6288,foreclosures,417,29229885,94.2038250062,_100,12,>100
6289,wisdom,417,29230302,94.2051689388,_100,6,>100
6290,texans,417,29230719,94.2065128714,_100,6,>100
6291,quarterly,417,29231136,94.207856804,_100,9,>100
6292,tension,417,29231553,94.2092007365,_100,7,>100
6293,rubber,417,29231970,94.2105446691,_100,6,>100
6294,adoption,417,29232387,94.2118886017,_100,8,>100
6295,knees,417,29232804,94.2132325343,_100,5,>100
6296,ballpark,416,29233220,94.214573244,_100,8,>100
6297,founding,416,29233636,94.2159139538,_100,8,>100
6298,supporter,416,29234052,94.2172546635,_100,9,>100
6299,themes,416,29234468,94.2185953732,_100,6,>100
6300,sink,416,29234884,94.219936083,_100,4,>100
6301,scorer,416,29235300,94.2212767927,_100,6,>100
6302,productions,416,29235716,94.2226175024,_100,11,>100
6303,vineyards,416,29236132,94.2239582121,_100,9,>100
6304,container,416,29236548,94.2252989219,_100,9,>100
6305,midst,415,29236963,94.2266364087,_100,5,>100
6306,gallons,415,29237378,94.2279738956,_100,7,>100
6307,makeup,415,29237793,94.2293113825,_100,6,>100
6308,traditions,415,29238208,94.2306488693,_100,10,>100
6309,tops,415,29238623,94.2319863562,_100,4,>100
6310,tsa,415,29239038,94.2333238431,_100,3,>100
6311,desired,414,29239452,94.2346581071,_100,7,>100
6312,ladies,414,29239866,94.2359923711,_100,6,>100
6313,appearing,414,29240280,94.2373266351,_100,9,>100
6314,openly,414,29240694,94.2386608991,_100,6,>100
6315,functions,414,29241108,94.2399951631,_100,9,>100
6316,declines,414,29241522,94.2413294271,_100,8,>100
6317,wagner,414,29241936,94.2426636912,_100,6,>100
6318,turnout,414,29242350,94.2439979552,_100,7,>100
6319,intervention,414,29242764,94.2453322192,_100,12,>100
6320,invitation,414,29243178,94.2466664832,_100,10,>100
6321,tube,414,29243592,94.2480007472,_100,4,>100
6322,helm,413,29244005,94.2493317883,_100,4,>100
6323,freshmen,413,29244418,94.2506628295,_100,8,>100
6324,possibilities,413,29244831,94.2519938706,_100,13,>100
6325,roosevelt,413,29245244,94.2533249118,_100,9,>100
6326,trades,413,29245657,94.2546559529,_100,6,>100
6327,belong,413,29246070,94.2559869941,_100,6,>100
6328,factories,413,29246483,94.2573180352,_100,9,>100
6329,obligation,413,29246896,94.2586490764,_100,10,>100
6330,prisoners,413,29247309,94.2599801175,_100,9,>100
6331,practicing,413,29247722,94.2613111587,_100,10,>100
6332,conditioning,413,29248135,94.2626421998,_100,12,>100
6333,educate,413,29248548,94.263973241,_100,7,>100
6334,tires,412,29248960,94.2653010593,_100,5,>100
6335,transaction,412,29249372,94.2666288776,_100,11,>100
6336,clinics,412,29249784,94.2679566958,_100,7,>100
6337,fantasy,412,29250196,94.2692845141,_100,7,>100
6338,isolated,412,29250608,94.2706123324,_100,8,>100
6339,laughed,412,29251020,94.2719401507,_100,7,>100
6340,entrees,412,29251432,94.273267969,_100,7,>100
6341,sticking,412,29251844,94.2745957873,_100,8,>100
6342,ears,411,29252255,94.2759203827,_100,4,>100
6343,fairview,411,29252666,94.2772449782,_100,8,>100
6344,evan,411,29253077,94.2785695736,_100,4,>100
6345,monica,411,29253488,94.279894169,_100,6,>100
6346,curb,411,29253899,94.2812187644,_100,4,>100
6347,outreach,411,29254310,94.2825433599,_100,8,>100
6348,robust,411,29254721,94.2838679553,_100,6,>100
6349,steelers,410,29255131,94.2851893279,_100,8,>100
6350,nato,410,29255541,94.2865107004,_100,4,>100
6351,shannon,410,29255951,94.287832073,_100,7,>100
6352,royals,410,29256361,94.2891534456,_100,6,>100
6353,hampshire,410,29256771,94.2904748182,_100,9,>100
6354,uncomfortable,410,29257181,94.2917961907,_100,13,>100
6355,stan,410,29257591,94.2931175633,_100,4,>100
6356,stint,410,29258001,94.2944389359,_100,5,>100
6357,jeans,410,29258411,94.2957603084,_100,5,>100
6358,recipients,410,29258821,94.297081681,_100,10,>100
6359,thunder,410,29259231,94.2984030536,_100,7,>100
6360,ramirez,410,29259641,94.2997244261,_100,7,>100
6361,joey,409,29260050,94.3010425758,_100,4,>100
6362,finishes,409,29260459,94.3023607256,_100,8,>100
6363,exotic,409,29260868,94.3036788753,_100,6,>100
6364,trim,409,29261277,94.304997025,_100,4,>100
6365,worn,409,29261686,94.3063151747,_100,4,>100
6366,restructuring,409,29262095,94.3076333244,_100,13,>100
6367,shipping,409,29262504,94.3089514741,_100,8,>100
6368,sharon,409,29262913,94.3102696238,_100,6,>100
6369,enemy,409,29263322,94.3115877735,_100,5,>100
6370,addressing,409,29263731,94.3129059232,_100,10,>100
6371,discounts,408,29264139,94.3142208501,_100,9,>100
6372,dana,408,29264547,94.3155357769,_100,4,>100
6373,marion,408,29264955,94.3168507038,_100,6,>100
6374,battled,408,29265363,94.3181656306,_100,7,>100
6375,journalist,408,29265771,94.3194805575,_100,10,>100
6376,enacted,408,29266179,94.3207954843,_100,7,>100
6377,collinsville,408,29266587,94.3221104112,_100,12,>100
6378,abused,408,29266995,94.323425338,_100,6,>100
6379,borrow,408,29267403,94.3247402649,_100,6,>100
6380,warnings,407,29267810,94.3260519689,_100,8,>100
6381,fork,407,29268217,94.3273636729,_100,4,>100
6382,slower,407,29268624,94.3286753769,_100,6,>100
6383,realistic,407,29269031,94.3299870808,_100,9,>100
6384,excellence,407,29269438,94.3312987848,_100,10,>100
6385,feedback,407,29269845,94.3326104888,_100,8,>100
6386,fleet,407,29270252,94.3339221928,_100,5,>100
6387,listened,407,29270659,94.3352338968,_100,8,>100
6388,jimenez,406,29271065,94.3365423779,_100,7,>100
6389,bean,406,29271471,94.3378508591,_100,4,>100
6390,criteria,406,29271877,94.3391593402,_100,8,>100
6391,strengthen,406,29272283,94.3404678213,_100,10,>100
6392,friendship,406,29272689,94.3417763025,_100,10,>100
6393,baldwin,406,29273095,94.3430847836,_100,7,>100
6394,freeway,406,29273501,94.3443932647,_100,7,>100
6395,varsity,406,29273907,94.3457017458,_100,7,>100
6396,leadoff,406,29274313,94.347010227,_100,7,>100
6397,koschman,406,29274719,94.3483187081,_100,8,>100
6398,hunterdon,406,29275125,94.3496271892,_100,9,>100
6399,inappropriate,406,29275531,94.3509356704,_100,13,>100
6400,centennial,405,29275936,94.3522409286,_100,10,>100
6401,broker,405,29276341,94.3535461869,_100,6,>100
6402,motivation,405,29276746,94.3548514452,_100,10,>100
6403,carrots,405,29277151,94.3561567034,_100,7,>100
6404,shaking,405,29277556,94.3574619617,_100,7,>100
6405,dvd,405,29277961,94.35876722,_100,3,>100
6406,staged,405,29278366,94.3600724783,_100,6,>100
6407,explosive,405,29278771,94.3613777365,_100,9,>100
6408,charm,405,29279176,94.3626829948,_100,5,>100
6409,shooter,405,29279581,94.3639882531,_100,7,>100
6410,clubhouse,404,29279985,94.3652902885,_100,9,>100
6411,handgun,404,29280389,94.3665923239,_100,7,>100
6412,monmouth,404,29280793,94.3678943593,_100,8,>100
6413,spirits,404,29281197,94.3691963947,_100,7,>100
6414,betty,404,29281601,94.3704984301,_100,5,>100
6415,severely,404,29282005,94.3718004655,_100,8,>100
6416,releases,404,29282409,94.3731025009,_100,8,>100
6417,spectrum,404,29282813,94.3744045363,_100,8,>100
6418,surgeon,404,29283217,94.3757065718,_100,7,>100
6419,karl,404,29283621,94.3770086072,_100,4,>100
6420,specializes,404,29284025,94.3783106426,_100,11,>100
6421,preventing,404,29284429,94.379612678,_100,10,>100
6422,palin,403,29284832,94.3809114905,_100,5,>100
6423,bounty,403,29285235,94.3822103031,_100,6,>100
6424,swift,403,29285638,94.3835091156,_100,5,>100
6425,steam,403,29286041,94.3848079282,_100,5,>100
6426,enhance,403,29286444,94.3861067407,_100,7,>100
6427,curriculum,403,29286847,94.3874055533,_100,10,>100
6428,pryor,403,29287250,94.3887043658,_100,5,>100
6429,habits,403,29287653,94.3900031784,_100,6,>100
6430,sentiment,403,29288056,94.3913019909,_100,9,>100
6431,florence,403,29288459,94.3926008035,_100,8,>100
6432,garrett,403,29288862,94.393899616,_100,7,>100
6433,connecting,403,29289265,94.3951984286,_100,10,>100
6434,province,403,29289668,94.3964972411,_100,8,>100
6435,sandra,402,29290070,94.3977928308,_100,6,>100
6436,fridays,402,29290472,94.3990884205,_100,7,>100
6437,manufacturer,402,29290874,94.4003840102,_100,12,>100
6438,scope,402,29291276,94.4016795999,_100,5,>100
6439,downturn,402,29291678,94.4029751896,_100,8,>100
6440,sanders,402,29292080,94.4042707793,_100,7,>100
6441,strategist,402,29292482,94.405566369,_100,10,>100
6442,parenthood,402,29292884,94.4068619587,_100,10,>100
6443,barrels,402,29293286,94.4081575483,_100,7,>100
6444,cheating,401,29293687,94.4094499152,_100,8,>100
6445,roast,401,29294088,94.410742282,_100,5,>100
6446,nonetheless,401,29294489,94.4120346488,_100,11,>100
6447,statehouse,401,29294890,94.4133270157,_100,10,>100
6448,instruction,401,29295291,94.4146193825,_100,11,>100
6449,presidency,401,29295692,94.4159117493,_100,10,>100
6450,priest,401,29296093,94.4172041162,_100,6,>100
6451,victor,401,29296494,94.418496483,_100,6,>100
6452,ellen,401,29296895,94.4197888498,_100,5,>100
6453,interactive,401,29297296,94.4210812167,_100,11,>100
6454,spare,401,29297697,94.4223735835,_100,5,>100
6455,apologize,401,29298098,94.4236659503,_100,9,>100
6456,gentle,401,29298499,94.4249583171,_100,6,>100
6457,bidding,401,29298900,94.426250684,_100,7,>100
6458,schmidt,400,29299300,94.4275398279,_100,7,>100
6459,outfielder,400,29299700,94.4288289719,_100,10,>100
6460,gender,400,29300100,94.4301181159,_100,6,>100
6461,400,400,29300500,94.4314072599,_100,3,>100
6462,webcam,400,29300900,94.4326964038,_100,6,>100
6463,lugar,400,29301300,94.4339855478,_100,5,>100
6464,kicking,400,29301700,94.4352746918,_100,7,>100
6465,urge,400,29302100,94.4365638357,_100,4,>100
6466,camby,399,29302499,94.4378497568,_100,5,>100
6467,ohioans,399,29302898,94.439135678,_100,7,>100
6468,creditors,399,29303297,94.4404215991,_100,9,>100
6469,addiction,399,29303696,94.4417075202,_100,9,>100
6470,reject,399,29304095,94.4429934413,_100,6,>100
6471,advisers,399,29304494,94.4442793624,_100,8,>100
6472,casting,399,29304893,94.4455652835,_100,7,>100
6473,lacks,399,29305292,94.4468512046,_100,5,>100
6474,shifting,398,29305690,94.4481339029,_100,8,>100
6475,elevated,398,29306088,94.4494166011,_100,8,>100
6476,trailed,398,29306486,94.4506992994,_100,7,>100
6477,bits,398,29306884,94.4519819976,_100,4,>100
6478,movements,398,29307282,94.4532646959,_100,9,>100
6479,virus,398,29307680,94.4545473941,_100,5,>100
6480,engagement,398,29308078,94.4558300924,_100,10,>100
6481,circles,397,29308475,94.4571095678,_100,7,>100
6482,refreshing,397,29308872,94.4583890432,_100,10,>100
6483,touring,397,29309269,94.4596685185,_100,7,>100
6484,eligibility,397,29309666,94.4609479939,_100,11,>100
6485,lion,397,29310063,94.4622274693,_100,4,>100
6486,encourages,397,29310460,94.4635069447,_100,10,>100
6487,evident,396,29310856,94.4647831972,_100,7,>100
6488,mizzou,396,29311252,94.4660594498,_100,6,>100
6489,rented,396,29311648,94.4673357023,_100,6,>100
6490,par,396,29312044,94.4686119548,_100,3,>100
6491,bucks,396,29312440,94.4698882074,_100,5,>100
6492,scientist,396,29312836,94.4711644599,_100,9,>100
6493,rays,396,29313232,94.4724407124,_100,4,>100
6494,execution,396,29313628,94.473716965,_100,9,>100
6495,episodes,396,29314024,94.4749932175,_100,8,>100
6496,stabbed,396,29314420,94.47626947,_100,7,>100
6497,stunned,396,29314816,94.4775457226,_100,7,>100
6498,poorly,395,29315211,94.4788187522,_100,6,>100
6499,yogurt,395,29315606,94.4800917819,_100,6,>100
6500,lobster,395,29316001,94.4813648116,_100,7,>100
6501,ramsey,395,29316396,94.4826378412,_100,6,>100
6502,mich,395,29316791,94.4839108709,_100,4,>100
6503,upstairs,395,29317186,94.4851839006,_100,8,>100
6504,donor,395,29317581,94.4864569302,_100,5,>100
6505,chesterfield,395,29317976,94.4877299599,_100,12,>100
6506,describing,395,29318371,94.4890029896,_100,10,>100
6507,dedication,394,29318765,94.4902727964,_100,10,>100
6508,burgers,394,29319159,94.4915426032,_100,7,>100
6509,decides,394,29319553,94.49281241,_100,7,>100
6510,kathleen,394,29319947,94.4940822168,_100,8,>100
6511,cowboys,394,29320341,94.4953520236,_100,7,>100
6512,gardner,394,29320735,94.4966218305,_100,7,>100
6513,poured,394,29321129,94.4978916373,_100,6,>100
6514,audio,394,29321523,94.4991614441,_100,5,>100
6515,mining,394,29321917,94.5004312509,_100,6,>100
6516,beliefs,394,29322311,94.5017010577,_100,7,>100
6517,sara,394,29322705,94.5029708645,_100,4,>100
6518,australian,393,29323098,94.5042374485,_100,10,>100
6519,opt,393,29323491,94.5055040324,_100,3,>100
6520,walmart,393,29323884,94.5067706164,_100,7,>100
6521,healthier,393,29324277,94.5080372003,_100,9,>100
6522,tavern,393,29324670,94.5093037843,_100,6,>100
6523,helmet,393,29325063,94.5105703682,_100,6,>100
6524,crushed,393,29325456,94.5118369522,_100,7,>100
6525,patience,393,29325849,94.5131035361,_100,8,>100
6526,sunshine,393,29326242,94.5143701201,_100,8,>100
6527,mt,393,29326635,94.515636704,_100,2,>100
6528,toxic,393,29327028,94.516903288,_100,5,>100
6529,steadily,393,29327421,94.5181698719,_100,8,>100
6530,courage,393,29327814,94.5194364559,_100,7,>100
6531,roses,393,29328207,94.5207030398,_100,5,>100
6532,disagree,393,29328600,94.5219696238,_100,8,>100
6533,attributed,392,29328992,94.5232329849,_100,10,>100
6534,automakers,392,29329384,94.524496346,_100,10,>100
6535,daniels,392,29329776,94.525759707,_100,7,>100
6536,workplace,392,29330168,94.5270230681,_100,9,>100
6537,hospitalized,392,29330560,94.5282864292,_100,12,>100
6538,kirkwood,392,29330952,94.5295497903,_100,8,>100
6539,mayo,392,29331344,94.5308131514,_100,4,>100
6540,renewal,392,29331736,94.5320765125,_100,7,>100
6541,mansion,392,29332128,94.5333398736,_100,7,>100
6542,appreciation,391,29332519,94.5346000118,_100,12,>100
6543,loses,391,29332910,94.5358601501,_100,5,>100
6544,bids,391,29333301,94.5371202883,_100,4,>100
6545,paired,391,29333692,94.5383804265,_100,6,>100
6546,unpaid,391,29334083,94.5396405647,_100,6,>100
6547,introduction,391,29334474,94.540900703,_100,12,>100
6548,plug,391,29334865,94.5421608412,_100,4,>100
6549,determination,391,29335256,94.5434209794,_100,13,>100
6550,consistency,391,29335647,94.5446811177,_100,11,>100
6551,filings,391,29336038,94.5459412559,_100,7,>100
6552,collision,391,29336429,94.5472013941,_100,9,>100
6553,merchandise,391,29336820,94.5484615324,_100,11,>100
6554,pope,391,29337211,94.5497216706,_100,4,>100
6555,appealed,391,29337602,94.5509818088,_100,8,>100
6556,optimism,391,29337993,94.5522419471,_100,8,>100
6557,avengers,391,29338384,94.5535020853,_100,8,>100
6558,montana,390,29338774,94.5547590007,_100,7,>100
6559,insight,390,29339164,94.556015916,_100,7,>100
6560,pga,390,29339554,94.5572728314,_100,3,>100
6561,prompting,390,29339944,94.5585297468,_100,9,>100
6562,torres,390,29340334,94.5597866621,_100,6,>100
6563,responsibilities,390,29340724,94.5610435775,_100,16,>100
6564,limiting,390,29341114,94.5623004929,_100,8,>100
6565,failures,390,29341504,94.5635574083,_100,8,>100
6566,sticks,390,29341894,94.5648143236,_100,6,>100
6567,saturated,389,29342283,94.5660680161,_100,9,>100
6568,teresa,389,29342672,94.5673217086,_100,6,>100
6569,solely,389,29343061,94.5685754012,_100,6,>100
6570,sideline,389,29343450,94.5698290937,_100,8,>100
6571,conflicts,389,29343839,94.5710827862,_100,9,>100
6572,tissue,389,29344228,94.5723364787,_100,6,>100
6573,farther,389,29344617,94.5735901712,_100,7,>100
6574,thai,389,29345006,94.5748438637,_100,4,>100
6575,spark,389,29345395,94.5760975562,_100,5,>100
6576,controlling,389,29345784,94.5773512487,_100,11,>100
6577,chaos,389,29346173,94.5786049413,_100,5,>100
6578,laying,389,29346562,94.5798586338,_100,6,>100
6579,tokyo,388,29346950,94.5811091034,_100,5,>100
6580,lure,388,29347338,94.5823595731,_100,4,>100
6581,shook,388,29347726,94.5836100427,_100,5,>100
6582,wrongdoing,388,29348114,94.5848605124,_100,10,>100
6583,floyd,388,29348502,94.586110982,_100,5,>100
6584,fernandez,388,29348890,94.5873614517,_100,9,>100
6585,observed,388,29349278,94.5886119213,_100,8,>100
6586,mature,387,29349665,94.5898591681,_100,6,>100
6587,suppliers,387,29350052,94.5911064149,_100,9,>100
6588,courtney,387,29350439,94.5923536617,_100,8,>100
6589,andrews,387,29350826,94.5936009085,_100,7,>100
6590,shortage,387,29351213,94.5948481553,_100,8,>100
6591,mercury,387,29351600,94.5960954021,_100,7,>100
6592,bernard,387,29351987,94.5973426489,_100,7,>100
6593,bistro,387,29352374,94.5985898957,_100,6,>100
6594,overly,387,29352761,94.5998371424,_100,6,>100
6595,mustard,387,29353148,94.6010843892,_100,7,>100
6596,shine,387,29353535,94.602331636,_100,5,>100
6597,nod,387,29353922,94.6035788828,_100,3,>100
6598,stalled,387,29354309,94.6048261296,_100,7,>100
6599,convenience,386,29354695,94.6060701535,_100,11,>100
6600,statute,386,29355081,94.6073141775,_100,7,>100
6601,resign,386,29355467,94.6085582014,_100,6,>100
6602,specifics,386,29355853,94.6098022253,_100,9,>100
6603,employs,386,29356239,94.6110462493,_100,7,>100
6604,dresses,386,29356625,94.6122902732,_100,7,>100
6605,dodge,386,29357011,94.6135342971,_100,5,>100
6606,intriguing,386,29357397,94.6147783211,_100,10,>100
6607,alley,386,29357783,94.616022345,_100,5,>100
6608,organize,385,29358168,94.6172631461,_100,8,>100
6609,marry,385,29358553,94.6185039471,_100,5,>100
6610,bikes,385,29358938,94.6197447482,_100,5,>100
6611,pier,385,29359323,94.6209855493,_100,4,>100
6612,sushi,385,29359708,94.6222263503,_100,5,>100
6613,convictions,385,29360093,94.6234671514,_100,11,>100
6614,apples,385,29360478,94.6247079525,_100,6,>100
6615,shirts,385,29360863,94.6259487536,_100,6,>100
6616,suggestion,385,29361248,94.6271895546,_100,10,>100
6617,firefighter,385,29361633,94.6284303557,_100,11,>100
6618,museums,385,29362018,94.6296711568,_100,7,>100
6619,hong,385,29362403,94.6309119578,_100,4,>100
6620,refuse,385,29362788,94.6321527589,_100,6,>100
6621,justify,384,29363172,94.6333903371,_100,7,>100
6622,edges,384,29363556,94.6346279153,_100,5,>100
6623,insist,384,29363940,94.6358654936,_100,6,>100
6624,richards,384,29364324,94.6371030718,_100,8,>100
6625,implemented,384,29364708,94.63834065,_100,11,>100
6626,terror,384,29365092,94.6395782282,_100,6,>100
6627,lining,383,29365475,94.6408125835,_100,6,>100
6628,confidential,383,29365858,94.6420469389,_100,12,>100
6629,emphasized,383,29366241,94.6432812942,_100,10,>100
6630,defenders,383,29366624,94.6445156496,_100,9,>100
6631,minimal,383,29367007,94.6457500049,_100,7,>100
6632,pentagon,383,29367390,94.6469843603,_100,8,>100
6633,clair,383,29367773,94.6482187157,_100,5,>100
6634,component,383,29368156,94.649453071,_100,9,>100
6635,acta,383,29368539,94.6506874264,_100,4,>100
6636,gomez,383,29368922,94.6519217817,_100,5,>100
6637,citizenship,383,29369305,94.6531561371,_100,11,>100
6638,exhibits,383,29369688,94.6543904924,_100,8,>100
6639,reese,383,29370071,94.6556248478,_100,5,>100
6640,rafael,383,29370454,94.6568592031,_100,6,>100
6641,exceed,383,29370837,94.6580935585,_100,6,>100
6642,suns,382,29371219,94.659324691,_100,4,>100
6643,shelves,382,29371601,94.6605558234,_100,7,>100
6644,practically,382,29371983,94.6617869559,_100,11,>100
6645,wrestler,382,29372365,94.6630180884,_100,8,>100
6646,negotiated,382,29372747,94.6642492209,_100,10,>100
6647,lowered,382,29373129,94.6654803534,_100,7,>100
6648,dental,382,29373511,94.6667114859,_100,6,>100
6649,vandalism,382,29373893,94.6679426184,_100,9,>100
6650,dubbed,382,29374275,94.6691737509,_100,6,>100
6651,angela,382,29374657,94.6704048834,_100,6,>100
6652,installation,382,29375039,94.6716360159,_100,12,>100
6653,inaugural,381,29375420,94.6728639255,_100,9,>100
6654,avon,381,29375801,94.6740918351,_100,4,>100
6655,trevor,381,29376182,94.6753197448,_100,6,>100
6656,primaries,381,29376563,94.6765476544,_100,9,>100
6657,custom,381,29376944,94.677775564,_100,6,>100
6658,skilled,381,29377325,94.6790034737,_100,7,>100
6659,singers,381,29377706,94.6802313833,_100,7,>100
6660,tends,381,29378087,94.6814592929,_100,5,>100
6661,scratch,380,29378467,94.6826839797,_100,7,>100
6662,castro,380,29378847,94.6839086665,_100,6,>100
6663,printed,380,29379227,94.6851333532,_100,7,>100
6664,futures,380,29379607,94.68635804,_100,7,>100
6665,sculpture,380,29379987,94.6875827268,_100,9,>100
6666,credibility,380,29380367,94.6888074136,_100,11,>100
6667,charming,380,29380747,94.6900321003,_100,8,>100
6668,poetry,380,29381127,94.6912567871,_100,6,>100
6669,fueled,380,29381507,94.6924814739,_100,6,>100
6670,epic,380,29381887,94.6937061606,_100,4,>100
6671,radical,380,29382267,94.6949308474,_100,7,>100
6672,gourmet,380,29382647,94.6961555342,_100,7,>100
6673,oden,380,29383027,94.697380221,_100,4,>100
6674,luther,379,29383406,94.6986016849,_100,6,>100
6675,duo,379,29383785,94.6998231488,_100,3,>100
6676,rod,379,29384164,94.7010446127,_100,3,>100
6677,halt,379,29384543,94.7022660766,_100,4,>100
6678,mercy,379,29384922,94.7034875405,_100,5,>100
6679,lettuce,379,29385301,94.7047090044,_100,7,>100
6680,chronicle,378,29385679,94.7059272455,_100,9,>100
6681,farmer,378,29386057,94.7071454865,_100,6,>100
6682,thorough,378,29386435,94.7083637276,_100,8,>100
6683,executed,378,29386813,94.7095819686,_100,8,>100
6684,expire,378,29387191,94.7108002097,_100,6,>100
6685,hazing,378,29387569,94.7120184507,_100,6,>100
6686,transformation,378,29387947,94.7132366918,_100,14,>100
6687,yields,378,29388325,94.7144549328,_100,6,>100
6688,reservoir,378,29388703,94.7156731739,_100,9,>100
6689,heaven,378,29389081,94.716891415,_100,6,>100
6690,bo,378,29389459,94.718109656,_100,2,>100
6691,lovers,378,29389837,94.7193278971,_100,6,>100
6692,cooks,378,29390215,94.7205461381,_100,5,>100
6693,principals,378,29390593,94.7217643792,_100,10,>100
6694,sparkling,377,29390970,94.7229793974,_100,9,>100
6695,instruments,377,29391347,94.7241944155,_100,11,>100
6696,maricopa,377,29391724,94.7254094337,_100,8,>100
6697,builders,377,29392101,94.7266244519,_100,8,>100
6698,rhp,377,29392478,94.7278394701,_100,3,>100
6699,lucrative,377,29392855,94.7290544883,_100,9,>100
6700,disturbing,377,29393232,94.7302695065,_100,10,>100
6701,applying,377,29393609,94.7314845247,_100,8,>100
6702,shorter,377,29393986,94.7326995429,_100,7,>100
6703,wesley,376,29394362,94.7339113382,_100,6,>100
6704,trapped,376,29394738,94.7351231336,_100,7,>100
6705,poised,376,29395114,94.7363349289,_100,6,>100
6706,greeted,376,29395490,94.7375467242,_100,7,>100
6707,tide,376,29395866,94.7387585195,_100,4,>100
6708,releasing,376,29396242,94.7399703149,_100,9,>100
6709,donna,376,29396618,94.7411821102,_100,5,>100
6710,compiled,376,29396994,94.7423939055,_100,8,>100
6711,ratio,376,29397370,94.7436057009,_100,5,>100
6712,nominees,376,29397746,94.7448174962,_100,8,>100
6713,intend,376,29398122,94.7460292915,_100,6,>100
6714,competed,376,29398498,94.7472410869,_100,8,>100
6715,caution,376,29398874,94.7484528822,_100,7,>100
6716,375,375,29399249,94.7496614547,_100,3,>100
6717,monetary,375,29399624,94.7508700272,_100,8,>100
6718,airways,375,29399999,94.7520785996,_100,7,>100
6719,standings,375,29400374,94.7532871721,_100,9,>100
6720,trafficking,375,29400749,94.7544957446,_100,11,>100
6721,outdoors,375,29401124,94.755704317,_100,8,>100
6722,instructor,375,29401499,94.7569128895,_100,10,>100
6723,panic,375,29401874,94.758121462,_100,5,>100
6724,housed,375,29402249,94.7593300345,_100,6,>100
6725,banner,375,29402624,94.7605386069,_100,6,>100
6726,tournaments,375,29402999,94.7617471794,_100,11,>100
6727,cousins,375,29403374,94.7629557519,_100,7,>100
6728,appointments,375,29403749,94.7641643243,_100,12,>100
6729,phillies,374,29404123,94.765369674,_100,8,>100
6730,literature,374,29404497,94.7665750236,_100,10,>100
6731,pavilion,374,29404871,94.7677803732,_100,8,>100
6732,visa,374,29405245,94.7689857228,_100,4,>100
6733,overhead,374,29405619,94.7701910724,_100,8,>100
6734,schwartz,374,29405993,94.771396422,_100,8,>100
6735,nevertheless,374,29406367,94.7726017716,_100,12,>100
6736,interception,374,29406741,94.7738071212,_100,12,>100
6737,silly,373,29407114,94.775009248,_100,5,>100
6738,endless,373,29407487,94.7762113747,_100,7,>100
6739,blaze,373,29407860,94.7774135015,_100,5,>100
6740,donovan,373,29408233,94.7786156283,_100,7,>100
6741,availability,373,29408606,94.779817755,_100,12,>100
6742,publisher,373,29408979,94.7810198818,_100,9,>100
6743,satellite,373,29409352,94.7822220085,_100,9,>100
6744,enjoys,373,29409725,94.7834241353,_100,6,>100
6745,closet,373,29410098,94.784626262,_100,6,>100
6746,barrett,373,29410471,94.7858283888,_100,7,>100
6747,osama,373,29410844,94.7870305155,_100,5,>100
6748,affecting,373,29411217,94.7882326423,_100,9,>100
6749,researcher,372,29411589,94.7894315462,_100,10,>100
6750,articles,372,29411961,94.7906304501,_100,8,>100
6751,monument,372,29412333,94.791829354,_100,8,>100
6752,freeman,372,29412705,94.7930282578,_100,7,>100
6753,glimpse,372,29413077,94.7942271617,_100,7,>100
6754,mateo,372,29413449,94.7954260656,_100,5,>100
6755,ale,372,29413821,94.7966249695,_100,3,>100
6756,brennan,372,29414193,94.7978238734,_100,7,>100
6757,avoiding,372,29414565,94.7990227773,_100,8,>100
6758,nicolas,372,29414937,94.8002216812,_100,7,>100
6759,unlawful,372,29415309,94.8014205851,_100,8,>100
6760,historically,372,29415681,94.802619489,_100,12,>100
6761,affidavit,372,29416053,94.8038183929,_100,9,>100
6762,lifelong,372,29416425,94.8050172968,_100,8,>100
6763,adventures,372,29416797,94.8062162007,_100,10,>100
6764,bounce,372,29417169,94.8074151046,_100,6,>100
6765,instantly,372,29417541,94.8086140084,_100,9,>100
6766,adapted,372,29417913,94.8098129123,_100,7,>100
6767,surveys,372,29418285,94.8110118162,_100,7,>100
6768,dated,372,29418657,94.8122107201,_100,5,>100
6769,heather,371,29419028,94.8134064012,_100,7,>100
6770,uniforms,371,29419399,94.8146020822,_100,8,>100
6771,exploded,371,29419770,94.8157977632,_100,8,>100
6772,unrelated,371,29420141,94.8169934443,_100,9,>100
6773,imagination,371,29420512,94.8181891253,_100,11,>100
6774,blessed,371,29420883,94.8193848063,_100,7,>100
6775,brunch,371,29421254,94.8205804873,_100,6,>100
6776,hayward,371,29421625,94.8217761684,_100,7,>100
6777,rebuilding,371,29421996,94.8229718494,_100,10,>100
6778,towards,371,29422367,94.8241675304,_100,7,>100
6779,drill,371,29422738,94.8253632115,_100,5,>100
6780,hats,370,29423108,94.8265556697,_100,4,>100
6781,maintains,370,29423478,94.8277481278,_100,9,>100
6782,labeled,370,29423848,94.828940586,_100,7,>100
6783,cares,370,29424218,94.8301330442,_100,5,>100
6784,weakness,370,29424588,94.8313255023,_100,8,>100
6785,tweeted,370,29424958,94.8325179605,_100,7,>100
6786,playground,370,29425328,94.8337104187,_100,10,>100
6787,non,370,29425698,94.8349028769,_100,3,>100
6788,parish,369,29426067,94.8360921122,_100,6,>100
6789,pm,369,29426436,94.8372813475,_100,2,>100
6790,punched,369,29426805,94.8384705828,_100,7,>100
6791,civilians,369,29427174,94.8396598181,_100,9,>100
6792,buffett,369,29427543,94.8408490534,_100,7,>100
6793,disabilities,369,29427912,94.8420382887,_100,12,>100
6794,aids,369,29428281,94.843227524,_100,4,>100
6795,cop,369,29428650,94.8444167594,_100,3,>100
6796,russa,369,29429019,94.8456059947,_100,5,>100
6797,tapped,369,29429388,94.84679523,_100,6,>100
6798,genuine,369,29429757,94.8479844653,_100,7,>100
6799,monterey,369,29430126,94.8491737006,_100,8,>100
6800,blackmon,369,29430495,94.8503629359,_100,8,>100
6801,hammer,369,29430864,94.8515521712,_100,6,>100
6802,ruth,369,29431233,94.8527414066,_100,4,>100
6803,zoning,369,29431602,94.8539306419,_100,6,>100
6804,fierce,369,29431971,94.8551198772,_100,6,>100
6805,decorated,368,29432339,94.8563058896,_100,9,>100
6806,picnic,368,29432707,94.8574919021,_100,6,>100
6807,spreading,368,29433075,94.8586779145,_100,9,>100
6808,virtual,368,29433443,94.859863927,_100,7,>100
6809,importantly,368,29433811,94.8610499394,_100,11,>100
6810,rode,368,29434179,94.8622359519,_100,4,>100
6811,marvel,368,29434547,94.8634219643,_100,6,>100
6812,chunks,367,29434914,94.8646047539,_100,6,>100
6813,performs,367,29435281,94.8657875435,_100,8,>100
6814,costumes,367,29435648,94.8669703331,_100,8,>100
6815,evolved,367,29436015,94.8681531227,_100,7,>100
6816,artwork,367,29436382,94.8693359123,_100,7,>100
6817,bloom,367,29436749,94.8705187019,_100,5,>100
6818,rhetoric,367,29437116,94.8717014915,_100,8,>100
6819,incomes,367,29437483,94.8728842811,_100,7,>100
6820,tasted,367,29437850,94.8740670707,_100,6,>100
6821,mitch,367,29438217,94.8752498603,_100,5,>100
6822,slay,367,29438584,94.8764326499,_100,4,>100
6823,ramp,367,29438951,94.8776154395,_100,4,>100
6824,manchester,367,29439318,94.8787982291,_100,10,>100
6825,fascinating,367,29439685,94.8799810186,_100,11,>100
6826,hollande,367,29440052,94.8811638082,_100,8,>100
6827,expression,367,29440419,94.8823465978,_100,10,>100
6828,merit,367,29440786,94.8835293874,_100,5,>100
6829,slowing,367,29441153,94.884712177,_100,7,>100
6830,photography,366,29441519,94.8858917437,_100,11,>100
6831,publication,366,29441885,94.8870713105,_100,11,>100
6832,dose,366,29442251,94.8882508772,_100,4,>100
6833,gloucester,366,29442617,94.8894304439,_100,10,>100
6834,driveway,366,29442983,94.8906100107,_100,8,>100
6835,applies,366,29443349,94.8917895774,_100,7,>100
6836,turnaround,366,29443715,94.8929691441,_100,10,>100
6837,marlins,366,29444081,94.8941487109,_100,7,>100
6838,gauge,366,29444447,94.8953282776,_100,5,>100
6839,ripped,365,29444812,94.8965046215,_100,6,>100
6840,leak,365,29445177,94.8976809654,_100,4,>100
6841,rapid,365,29445542,94.8988573092,_100,5,>100
6842,emanuel,365,29445907,94.9000336531,_100,7,>100
6843,hilton,365,29446272,94.901209997,_100,6,>100
6844,hedge,365,29446637,94.9023863408,_100,5,>100
6845,365,365,29447002,94.9035626847,_100,3,>100
6846,protections,365,29447367,94.9047390286,_100,11,>100
6847,galleries,365,29447732,94.9059153725,_100,9,>100
6848,camping,365,29448097,94.9070917163,_100,7,>100
6849,pastry,365,29448462,94.9082680602,_100,6,>100
6850,spinach,365,29448827,94.9094444041,_100,7,>100
6851,chancellor,365,29449192,94.910620748,_100,10,>100
6852,asparagus,365,29449557,94.9117970918,_100,9,>100
6853,diving,365,29449922,94.9129734357,_100,6,>100
6854,terrorism,365,29450287,94.9141497796,_100,9,>100
6855,woes,365,29450652,94.9153261235,_100,4,>100
6856,jumper,365,29451017,94.9165024673,_100,6,>100
6857,marquette,365,29451382,94.9176788112,_100,9,>100
6858,transported,365,29451747,94.9188551551,_100,11,>100
6859,terrorists,365,29452112,94.9200314989,_100,10,>100
6860,toughest,365,29452477,94.9212078428,_100,8,>100
6861,accounted,365,29452842,94.9223841867,_100,9,>100
6862,demonstration,365,29453207,94.9235605306,_100,13,>100
6863,acceptable,364,29453571,94.9247336516,_100,10,>100
6864,output,364,29453935,94.9259067726,_100,6,>100
6865,garnish,364,29454299,94.9270798936,_100,7,>100
6866,bribery,364,29454663,94.9282530146,_100,7,>100
6867,constructed,364,29455027,94.9294261356,_100,11,>100
6868,tracked,364,29455391,94.9305992566,_100,7,>100
6869,onstage,364,29455755,94.9317723777,_100,7,>100
6870,travels,364,29456119,94.9329454987,_100,7,>100
6871,graphic,364,29456483,94.9341186197,_100,7,>100
6872,relaxed,364,29456847,94.9352917407,_100,7,>100
6873,prix,364,29457211,94.9364648617,_100,4,>100
6874,bother,364,29457575,94.9376379827,_100,6,>100
6875,processing,363,29457938,94.9388078809,_100,10,>100
6876,practiced,363,29458301,94.939977779,_100,9,>100
6877,wears,363,29458664,94.9411476772,_100,5,>100
6878,ginger,363,29459027,94.9423175753,_100,6,>100
6879,horn,363,29459390,94.9434874735,_100,4,>100
6880,shortfall,363,29459753,94.9446573716,_100,9,>100
6881,katz,363,29460116,94.9458272698,_100,4,>100
6882,willie,363,29460479,94.9469971679,_100,6,>100
6883,basin,363,29460842,94.9481670661,_100,5,>100
6884,architects,363,29461205,94.9493369643,_100,10,>100
6885,elway,362,29461567,94.9505036395,_100,5,>100
6886,prayers,362,29461929,94.9516703148,_100,7,>100
6887,sprinkle,362,29462291,94.9528369901,_100,8,>100
6888,pills,362,29462653,94.9540036654,_100,5,>100
6889,perceived,362,29463015,94.9551703407,_100,9,>100
6890,paula,362,29463377,94.956337016,_100,5,>100
6891,puerto,362,29463739,94.9575036913,_100,6,>100
6892,fitting,362,29464101,94.9586703666,_100,7,>100
6893,beautifully,362,29464463,94.9598370419,_100,11,>100
6894,complications,362,29464825,94.9610037172,_100,13,>100
6895,gala,362,29465187,94.9621703925,_100,4,>100
6896,heating,362,29465549,94.9633370678,_100,7,>100
6897,trent,361,29465910,94.9645005202,_100,5,>100
6898,enhanced,361,29466271,94.9656639726,_100,8,>100
6899,exceptional,361,29466632,94.9668274251,_100,11,>100
6900,favorable,361,29466993,94.9679908775,_100,9,>100
6901,spartans,361,29467354,94.9691543299,_100,8,>100
6902,specials,361,29467715,94.9703177824,_100,8,>100
6903,customs,361,29468076,94.9714812348,_100,7,>100
6904,elimination,361,29468437,94.9726446872,_100,11,>100
6905,totaled,360,29468797,94.9738049168,_100,7,>100
6906,reveals,360,29469157,94.9749651464,_100,7,>100
6907,shawn,360,29469517,94.976125376,_100,5,>100
6908,pedestrian,360,29469877,94.9772856055,_100,10,>100
6909,judy,360,29470237,94.9784458351,_100,4,>100
6910,palo,360,29470597,94.9796060647,_100,4,>100
6911,wives,360,29470957,94.9807662942,_100,5,>100
6912,emotionally,360,29471317,94.9819265238,_100,11,>100
6913,transform,360,29471677,94.9830867534,_100,9,>100
6914,strained,360,29472037,94.984246983,_100,8,>100
6915,menus,360,29472397,94.9854072125,_100,5,>100
6916,360,360,29472757,94.9865674421,_100,3,>100
6917,sanford,360,29473117,94.9877276717,_100,7,>100
6918,journalism,360,29473477,94.9888879013,_100,10,>100
6919,prop,360,29473837,94.9900481308,_100,4,>100
6920,statue,360,29474197,94.9912083604,_100,6,>100
6921,polish,360,29474557,94.99236859,_100,6,>100
6922,supposedly,360,29474917,94.9935288196,_100,10,>100
6923,overwhelmed,360,29475277,94.9946890491,_100,11,>100
6924,couch,360,29475637,94.9958492787,_100,5,>100
6925,prom,360,29475997,94.9970095083,_100,4,>100
6926,cave,360,29476357,94.9981697378,_100,4,>100
6927,lin,360,29476717,94.9993299674,_100,3,>100
6928,cuban,359,29477076,95.0004869741,_100,5,>100
6929,kidney,359,29477435,95.0016439808,_100,6,>100
6930,floating,359,29477794,95.0028009876,_100,8,>100
6931,shallow,359,29478153,95.0039579943,_100,7,>100
6932,reversed,359,29478512,95.005115001,_100,8,>100
6933,adjustments,359,29478871,95.0062720077,_100,11,>100
6934,horrible,359,29479230,95.0074290144,_100,8,>100
6935,westbrook,359,29479589,95.0085860211,_100,9,>100
6936,kickoff,359,29479948,95.0097430278,_100,7,>100
6937,distant,359,29480307,95.0109000346,_100,7,>100
6938,healing,359,29480666,95.0120570413,_100,7,>100
6939,talents,359,29481025,95.013214048,_100,7,>100
6940,sprawling,358,29481383,95.0143678318,_100,9,>100
6941,beverage,358,29481741,95.0155216157,_100,8,>100
6942,wheels,358,29482099,95.0166753995,_100,6,>100
6943,relax,358,29482457,95.0178291834,_100,5,>100
6944,shelters,358,29482815,95.0189829672,_100,8,>100
6945,sellers,358,29483173,95.0201367511,_100,7,>100
6946,cautious,358,29483531,95.021290535,_100,8,>100
6947,menendez,358,29483889,95.0224443188,_100,8,>100
6948,belongs,358,29484247,95.0235981027,_100,7,>100
6949,hurting,358,29484605,95.0247518865,_100,7,>100
6950,infant,358,29484963,95.0259056704,_100,6,>100
6951,viable,358,29485321,95.0270594542,_100,6,>100
6952,caps,358,29485679,95.0282132381,_100,4,>100
6953,gloves,357,29486036,95.0293637991,_100,6,>100
6954,react,357,29486393,95.0305143601,_100,5,>100
6955,regarded,357,29486750,95.0316649211,_100,8,>100
6956,stems,357,29487107,95.0328154821,_100,5,>100
6957,newton,357,29487464,95.033966043,_100,6,>100
6958,ally,357,29487821,95.035116604,_100,4,>100
6959,alice,357,29488178,95.036267165,_100,5,>100
6960,nascar,357,29488535,95.037417726,_100,6,>100
6961,toy,356,29488891,95.0385650642,_100,3,>100
6962,lawson,356,29489247,95.0397124023,_100,6,>100
6963,leon,356,29489603,95.0408597404,_100,4,>100
6964,complaining,356,29489959,95.0420070786,_100,11,>100
6965,carmel,356,29490315,95.0431544167,_100,6,>100
6966,frankly,356,29490671,95.0443017548,_100,7,>100
6967,compound,356,29491027,95.045449093,_100,8,>100
6968,simmons,356,29491383,95.0465964311,_100,7,>100
6969,ghost,356,29491739,95.0477437692,_100,5,>100
6970,ga,356,29492095,95.0488911074,_100,2,>100
6971,staples,356,29492451,95.0500384455,_100,7,>100
6972,infield,356,29492807,95.0511857836,_100,7,>100
6973,blowing,356,29493163,95.0523331218,_100,7,>100
6974,eaton,356,29493519,95.0534804599,_100,5,>100
6975,lockout,356,29493875,95.054627798,_100,7,>100
6976,goodell,356,29494231,95.0557751362,_100,7,>100
6977,boots,355,29494586,95.0569192514,_100,5,>100
6978,licensing,355,29494941,95.0580633667,_100,9,>100
6979,acquire,355,29495296,95.059207482,_100,7,>100
6980,gorgeous,355,29495651,95.0603515973,_100,8,>100
6981,westlake,355,29496006,95.0614957125,_100,8,>100
6982,stuart,355,29496361,95.0626398278,_100,6,>100
6983,weaver,355,29496716,95.0637839431,_100,6,>100
6984,nasty,355,29497071,95.0649280584,_100,5,>100
6985,des,355,29497426,95.0660721736,_100,3,>100
6986,supplier,355,29497781,95.0672162889,_100,8,>100
6987,feeding,355,29498136,95.0683604042,_100,7,>100
6988,hoffman,355,29498491,95.0695045194,_100,7,>100
6989,surgeries,355,29498846,95.0706486347,_100,9,>100
6990,commonly,354,29499200,95.0717895271,_100,8,>100
6991,drum,354,29499554,95.0729304195,_100,4,>100
6992,responses,354,29499908,95.074071312,_100,9,>100
6993,confronted,354,29500262,95.0752122044,_100,10,>100
6994,purse,354,29500616,95.0763530968,_100,5,>100
6995,mint,354,29500970,95.0774939892,_100,4,>100
6996,southwestern,354,29501324,95.0786348816,_100,12,>100
6997,lindsey,354,29501678,95.079775774,_100,7,>100
6998,br,353,29502031,95.0809134436,_100,2,>100
6999,sour,353,29502384,95.0820511131,_100,4,>100
7000,urgency,353,29502737,95.0831887827,_100,7,>100
7001,circus,353,29503090,95.0843264522,_100,6,>100
7002,switched,353,29503443,95.0854641218,_100,8,>100
7003,mayfield,353,29503796,95.0866017914,_100,8,>100
7004,rebecca,353,29504149,95.0877394609,_100,7,>100
7005,equipped,353,29504502,95.0888771305,_100,8,>100
7006,hiv,353,29504855,95.0900148,_100,3,>100
7007,boyd,353,29505208,95.0911524696,_100,4,>100
7008,totals,353,29505561,95.0922901391,_100,6,>100
7009,porch,353,29505914,95.0934278087,_100,5,>100
7010,intact,353,29506267,95.0945654782,_100,6,>100
7011,chasing,353,29506620,95.0957031478,_100,7,>100
7012,precisely,353,29506973,95.0968408173,_100,9,>100
7013,reminds,353,29507326,95.0979784869,_100,7,>100
7014,mu,353,29507679,95.0991161564,_100,2,>100
7015,amenities,352,29508031,95.1002506031,_100,9,>100
7016,slots,352,29508383,95.1013850498,_100,5,>100
7017,debbie,352,29508735,95.1025194965,_100,6,>100
7018,ballroom,352,29509087,95.1036539432,_100,8,>100
7019,helen,352,29509439,95.1047883899,_100,5,>100
7020,architectural,352,29509791,95.1059228366,_100,13,>100
7021,cotton,352,29510143,95.1070572833,_100,6,>100
7022,boosted,352,29510495,95.10819173,_100,7,>100
7023,galaxy,352,29510847,95.1093261767,_100,6,>100
7024,intellectual,351,29511198,95.1104574005,_100,12,>100
7025,humane,351,29511549,95.1115886244,_100,6,>100
7026,komen,351,29511900,95.1127198482,_100,5,>100
7027,inspire,351,29512251,95.113851072,_100,7,>100
7028,slammed,351,29512602,95.1149822959,_100,7,>100
7029,whites,351,29512953,95.1161135197,_100,6,>100
7030,crafts,351,29513304,95.1172447435,_100,6,>100
7031,demonstrators,351,29513655,95.1183759674,_100,13,>100
7032,pricing,351,29514006,95.1195071912,_100,7,>100
7033,borrowers,351,29514357,95.120638415,_100,9,>100
7034,unbelievable,350,29514707,95.121766416,_100,12,>100
7035,enthusiastic,350,29515057,95.122894417,_100,12,>100
7036,clever,350,29515407,95.124022418,_100,6,>100
7037,agricultural,350,29515757,95.1251504189,_100,12,>100
7038,diocese,350,29516107,95.1262784199,_100,7,>100
7039,drills,350,29516457,95.1274064209,_100,6,>100
7040,vernon,350,29516807,95.1285344219,_100,6,>100
7041,nolan,350,29517157,95.1296624228,_100,5,>100
7042,baskets,350,29517507,95.1307904238,_100,7,>100
7043,prisons,350,29517857,95.1319184248,_100,7,>100
7044,vineyard,350,29518207,95.1330464257,_100,8,>100
7045,350,350,29518557,95.1341744267,_100,3,>100
7046,cd,350,29518907,95.1353024277,_100,2,>100
7047,oral,349,29519256,95.1364272058,_100,4,>100
7048,hawaiian,349,29519605,95.1375519839,_100,8,>100
7049,eu,349,29519954,95.138676762,_100,2,>100
7050,miguel,349,29520303,95.1398015402,_100,6,>100
7051,genre,349,29520652,95.1409263183,_100,5,>100
7052,precious,349,29521001,95.1420510964,_100,8,>100
7053,pac,349,29521350,95.1431758745,_100,3,>100
7054,examination,349,29521699,95.1443006526,_100,11,>100
7055,identical,349,29522048,95.1454254307,_100,9,>100
7056,aged,348,29522396,95.146546986,_100,4,>100
7057,shipped,348,29522744,95.1476685412,_100,7,>100
7058,td,348,29523092,95.1487900965,_100,2,>100
7059,delivers,348,29523440,95.1499116517,_100,8,>100
7060,invitational,348,29523788,95.151033207,_100,12,>100
7061,undercover,348,29524136,95.1521547622,_100,10,>100
7062,cargo,348,29524484,95.1532763175,_100,5,>100
7063,persuade,348,29524832,95.1543978728,_100,8,>100
7064,cancel,348,29525180,95.155519428,_100,6,>100
7065,effectiveness,348,29525528,95.1566409833,_100,13,>100
7066,lung,348,29525876,95.1577625385,_100,4,>100
7067,icon,348,29526224,95.1588840938,_100,4,>100
7068,shade,348,29526572,95.160005649,_100,5,>100
7069,humanity,348,29526920,95.1611272043,_100,8,>100
7070,caribbean,347,29527267,95.1622455367,_100,9,>100
7071,hannah,347,29527614,95.1633638691,_100,6,>100
7072,relied,347,29527961,95.1644822015,_100,6,>100
7073,obligations,347,29528308,95.1656005339,_100,11,>100
7074,gamble,347,29528655,95.1667188663,_100,6,>100
7075,sworn,347,29529002,95.1678371986,_100,5,>100
7076,cans,347,29529349,95.168955531,_100,4,>100
7077,zones,347,29529696,95.1700738634,_100,5,>100
7078,popped,347,29530043,95.1711921958,_100,6,>100
7079,willis,347,29530390,95.1723105282,_100,6,>100
7080,freese,347,29530737,95.1734288606,_100,6,>100
7081,planting,347,29531084,95.174547193,_100,8,>100
7082,lively,347,29531431,95.1756655254,_100,6,>100
7083,standpoint,347,29531778,95.1767838578,_100,10,>100
7084,damon,347,29532125,95.1779021902,_100,5,>100
7085,bust,347,29532472,95.1790205226,_100,4,>100
7086,leap,347,29532819,95.180138855,_100,4,>100
7087,contenders,347,29533166,95.1812571874,_100,10,>100
7088,contention,347,29533513,95.1823755198,_100,10,>100
7089,folk,347,29533860,95.1834938522,_100,4,>100
7090,closes,346,29534206,95.1846089617,_100,6,>100
7091,pray,346,29534552,95.1857240712,_100,4,>100
7092,restoration,346,29534898,95.1868391808,_100,11,>100
7093,satisfying,346,29535244,95.1879542903,_100,10,>100
7094,nephew,346,29535590,95.1890693998,_100,6,>100
7095,sealed,346,29535936,95.1901845094,_100,6,>100
7096,endured,346,29536282,95.1912996189,_100,7,>100
7097,employ,346,29536628,95.1924147284,_100,6,>100
7098,difficulties,346,29536974,95.193529838,_100,12,>100
7099,chapman,346,29537320,95.1946449475,_100,7,>100
7100,weighing,346,29537666,95.195760057,_100,8,>100
7101,charitable,346,29538012,95.1968751666,_100,10,>100
7102,altogether,345,29538357,95.1979870533,_100,10,>100
7103,unaware,345,29538702,95.1990989399,_100,7,>100
7104,certificate,345,29539047,95.2002108266,_100,11,>100
7105,tablets,345,29539392,95.2013227133,_100,7,>100
7106,psychological,345,29539737,95.2024346,_100,13,>100
7107,thanked,345,29540082,95.2035464866,_100,7,>100
7108,prohibited,345,29540427,95.2046583733,_100,10,>100
7109,composer,345,29540772,95.20577026,_100,8,>100
7110,herb,345,29541117,95.2068821467,_100,4,>100
7111,awkward,345,29541462,95.2079940333,_100,7,>100
7112,chesapeake,344,29541806,95.2091026971,_100,10,>100
7113,plaintiffs,344,29542150,95.210211361,_100,10,>100
7114,committing,344,29542494,95.2113200248,_100,10,>100
7115,flowing,344,29542838,95.2124286886,_100,7,>100
7116,fortunately,344,29543182,95.2135373524,_100,11,>100
7117,divisions,344,29543526,95.2146460162,_100,9,>100
7118,invasion,344,29543870,95.21575468,_100,8,>100
7119,convert,344,29544214,95.2168633438,_100,7,>100
7120,portrait,344,29544558,95.2179720077,_100,8,>100
7121,accessories,344,29544902,95.2190806715,_100,11,>100
7122,boise,344,29545246,95.2201893353,_100,5,>100
7123,pacifica,344,29545590,95.2212979991,_100,8,>100
7124,saudi,344,29545934,95.2224066629,_100,5,>100
7125,unlimited,344,29546278,95.2235153267,_100,9,>100
7126,speeches,344,29546622,95.2246239905,_100,8,>100
7127,nickname,344,29546966,95.2257326544,_100,8,>100
7128,rack,344,29547310,95.2268413182,_100,4,>100
7129,structural,343,29547653,95.2279467591,_100,10,>100
7130,confrontation,343,29547996,95.2290522001,_100,13,>100
7131,instances,343,29548339,95.230157641,_100,9,>100
7132,pleas,343,29548682,95.231263082,_100,5,>100
7133,gps,343,29549025,95.2323685229,_100,3,>100
7134,neglect,343,29549368,95.2334739639,_100,7,>100
7135,authentic,343,29549711,95.2345794049,_100,9,>100
7136,mixing,343,29550054,95.2356848458,_100,6,>100
7137,knocking,343,29550397,95.2367902868,_100,8,>100
7138,inviting,343,29550740,95.2378957277,_100,8,>100
7139,aftermath,343,29551083,95.2390011687,_100,9,>100
7140,distribute,342,29551425,95.2401033868,_100,10,>100
7141,tail,342,29551767,95.2412056049,_100,4,>100
7142,apiece,342,29552109,95.242307823,_100,6,>100
7143,coliseum,342,29552451,95.2434100411,_100,8,>100
7144,apology,342,29552793,95.2445122591,_100,7,>100
7145,unhappy,342,29553135,95.2456144772,_100,7,>100
7146,jennings,342,29553477,95.2467166953,_100,8,>100
7147,commitments,342,29553819,95.2478189134,_100,11,>100
7148,dylan,342,29554161,95.2489211315,_100,5,>100
7149,exterior,342,29554503,95.2500233496,_100,8,>100
7150,cracked,342,29554845,95.2511255677,_100,7,>100
7151,stellar,341,29555186,95.2522245629,_100,7,>100
7152,wainwright,341,29555527,95.2533235582,_100,10,>100
7153,relieved,341,29555868,95.2544225534,_100,8,>100
7154,noodles,341,29556209,95.2555215487,_100,7,>100
7155,alleging,341,29556550,95.2566205439,_100,8,>100
7156,roommate,341,29556891,95.2577195391,_100,8,>100
7157,visitor,341,29557232,95.2588185344,_100,7,>100
7158,organizing,341,29557573,95.2599175296,_100,10,>100
7159,ribbon,341,29557914,95.2610165248,_100,6,>100
7160,stretched,341,29558255,95.2621155201,_100,9,>100
7161,dash,341,29558596,95.2632145153,_100,4,>100
7162,340,340,29558936,95.2643102877,_100,3,>100
7163,lifting,340,29559276,95.26540606,_100,7,>100
7164,labels,340,29559616,95.2665018324,_100,6,>100
7165,actively,340,29559956,95.2675976048,_100,8,>100
7166,animated,340,29560296,95.2686933772,_100,8,>100
7167,notably,340,29560636,95.2697891495,_100,7,>100
7168,flip,340,29560976,95.2708849219,_100,4,>100
7169,blessing,340,29561316,95.2719806943,_100,8,>100
7170,logo,340,29561656,95.2730764667,_100,4,>100
7171,containers,340,29561996,95.274172239,_100,10,>100
7172,suburb,340,29562336,95.2752680114,_100,6,>100
7173,crashes,340,29562676,95.2763637838,_100,7,>100
7174,relies,340,29563016,95.2774595562,_100,6,>100
7175,catherine,340,29563356,95.2785553285,_100,9,>100
7176,owes,340,29563696,95.2796511009,_100,4,>100
7177,thoughtful,340,29564036,95.2807468733,_100,10,>100
7178,economies,339,29564375,95.2818394228,_100,9,>100
7179,networking,339,29564714,95.2829319723,_100,10,>100
7180,muscles,339,29565053,95.2840245218,_100,7,>100
7181,alleges,339,29565392,95.2851170714,_100,7,>100
7182,voluntary,339,29565731,95.2862096209,_100,9,>100
7183,surf,339,29566070,95.2873021704,_100,4,>100
7184,elk,339,29566409,95.2883947199,_100,3,>100
7185,beck,339,29566748,95.2894872694,_100,4,>100
7186,lobbyists,339,29567087,95.2905798189,_100,9,>100
7187,jews,339,29567426,95.2916723684,_100,4,>100
7188,shurmur,339,29567765,95.292764918,_100,7,>100
7189,halloween,339,29568104,95.2938574675,_100,9,>100
7190,accusing,339,29568443,95.294950017,_100,8,>100
7191,followers,339,29568782,95.2960425665,_100,9,>100
7192,wolves,339,29569121,95.297135116,_100,6,>100
7193,whisk,338,29569459,95.2982244427,_100,5,>100
7194,roth,338,29569797,95.2993137693,_100,4,>100
7195,jacksonville,338,29570135,95.300403096,_100,12,>100
7196,pond,338,29570473,95.3014924226,_100,4,>100
7197,applause,338,29570811,95.3025817493,_100,8,>100
7198,schedules,338,29571149,95.3036710759,_100,9,>100
7199,tenn,338,29571487,95.3047604026,_100,4,>100
7200,threaten,338,29571825,95.3058497293,_100,8,>100
7201,sentences,338,29572163,95.3069390559,_100,9,>100
7202,enable,338,29572501,95.3080283826,_100,6,>100
7203,boeing,338,29572839,95.3091177092,_100,6,>100
7204,mann,338,29573177,95.3102070359,_100,4,>100
7205,campaigning,338,29573515,95.3112963625,_100,11,>100
7206,significance,338,29573853,95.3123856892,_100,12,>100
7207,holt,338,29574191,95.3134750158,_100,4,>100
7208,sneiderman,338,29574529,95.3145643425,_100,10,>100
7209,wherever,337,29574866,95.3156504463,_100,8,>100
7210,yoga,337,29575203,95.3167365501,_100,4,>100
7211,cody,337,29575540,95.3178226539,_100,4,>100
7212,linn,337,29575877,95.3189087577,_100,4,>100
7213,hamstring,337,29576214,95.3199948615,_100,9,>100
7214,gregg,337,29576551,95.3210809653,_100,5,>100
7215,collectors,337,29576888,95.3221670691,_100,10,>100
7216,alto,337,29577225,95.3232531729,_100,4,>100
7217,hillary,337,29577562,95.3243392767,_100,7,>100
7218,implications,337,29577899,95.3254253804,_100,12,>100
7219,snacks,337,29578236,95.3265114842,_100,6,>100
7220,echoed,337,29578573,95.327597588,_100,6,>100
7221,experiencing,336,29578909,95.328680469,_100,12,>100
7222,contender,336,29579245,95.3297633499,_100,9,>100
7223,tuna,336,29579581,95.3308462308,_100,4,>100
7224,refrigerator,336,29579917,95.3319291118,_100,12,>100
7225,challenger,336,29580253,95.3330119927,_100,10,>100
7226,fluid,336,29580589,95.3340948736,_100,5,>100
7227,swinging,336,29580925,95.3351777546,_100,8,>100
7228,headline,336,29581261,95.3362606355,_100,8,>100
7229,deserved,336,29581597,95.3373435165,_100,8,>100
7230,ham,336,29581933,95.3384263974,_100,3,>100
7231,acknowledges,336,29582269,95.3395092783,_100,12,>100
7232,notices,336,29582605,95.3405921593,_100,7,>100
7233,destroy,336,29582941,95.3416750402,_100,7,>100
7234,identifying,336,29583277,95.3427579211,_100,11,>100
7235,tucked,335,29583612,95.3438375792,_100,6,>100
7236,undergo,335,29583947,95.3449172373,_100,7,>100
7237,hiking,335,29584282,95.3459968954,_100,6,>100
7238,varied,335,29584617,95.3470765534,_100,6,>100
7239,precise,335,29584952,95.3481562115,_100,7,>100
7240,criminals,335,29585287,95.3492358696,_100,9,>100
7241,affiliated,335,29585622,95.3503155277,_100,10,>100
7242,falcons,335,29585957,95.3513951857,_100,7,>100
7243,impacts,334,29586291,95.3524716209,_100,7,>100
7244,molina,334,29586625,95.3535480562,_100,6,>100
7245,bats,334,29586959,95.3546244914,_100,4,>100
7246,immune,334,29587293,95.3557009266,_100,6,>100
7247,publishing,334,29587627,95.3567773618,_100,10,>100
7248,mysterious,334,29587961,95.357853797,_100,10,>100
7249,warn,334,29588295,95.3589302322,_100,4,>100
7250,touching,334,29588629,95.3600066675,_100,8,>100
7251,dinners,334,29588963,95.3610831027,_100,7,>100
7252,rap,334,29589297,95.3621595379,_100,3,>100
7253,someday,334,29589631,95.3632359731,_100,7,>100
7254,counselor,334,29589965,95.3643124083,_100,9,>100
7255,outlined,333,29590298,95.3653856207,_100,8,>100
7256,333,333,29590631,95.366458833,_100,3,>100
7257,bing,333,29590964,95.3675320454,_100,4,>100
7258,publicity,333,29591297,95.3686052577,_100,9,>100
7259,honestly,333,29591630,95.3696784701,_100,8,>100
7260,horman,333,29591963,95.3707516824,_100,6,>100
7261,marines,333,29592296,95.3718248948,_100,7,>100
7262,novels,333,29592629,95.3728981072,_100,6,>100
7263,holders,333,29592962,95.3739713195,_100,7,>100
7264,violate,333,29593295,95.3750445319,_100,7,>100
7265,judging,333,29593628,95.3761177442,_100,7,>100
7266,kingdom,333,29593961,95.3771909566,_100,7,>100
7267,cute,332,29594293,95.3782609461,_100,4,>100
7268,conferences,332,29594625,95.3793309356,_100,11,>100
7269,opposes,332,29594957,95.3804009251,_100,7,>100
7270,distinct,332,29595289,95.3814709146,_100,8,>100
7271,lasting,332,29595621,95.3825409041,_100,7,>100
7272,centered,332,29595953,95.3836108936,_100,8,>100
7273,accomplishments,332,29596285,95.384680883,_100,15,>100
7274,eventual,332,29596617,95.3857508725,_100,8,>100
7275,strips,332,29596949,95.386820862,_100,6,>100
7276,robbed,332,29597281,95.3878908515,_100,6,>100
7277,laughs,332,29597613,95.388960841,_100,6,>100
7278,permanently,332,29597945,95.3900308305,_100,11,>100
7279,erik,332,29598277,95.39110082,_100,4,>100
7280,johnston,332,29598609,95.3921708095,_100,8,>100
7281,broadcasting,332,29598941,95.393240799,_100,12,>100
7282,refusing,332,29599273,95.3943107885,_100,8,>100
7283,flexible,332,29599605,95.395380778,_100,8,>100
7284,prospective,332,29599937,95.3964507675,_100,11,>100
7285,recruits,332,29600269,95.397520757,_100,8,>100
7286,kay,332,29600601,95.3985907465,_100,3,>100
7287,rivalry,332,29600933,95.399660736,_100,7,>100
7288,costume,332,29601265,95.4007307255,_100,7,>100
7289,petty,331,29601596,95.4017974921,_100,5,>100
7290,arguably,331,29601927,95.4028642587,_100,8,>100
7291,paths,331,29602258,95.4039310254,_100,5,>100
7292,beside,331,29602589,95.404997792,_100,6,>100
7293,brent,331,29602920,95.4060645587,_100,5,>100
7294,declare,331,29603251,95.4071313253,_100,7,>100
7295,seasoned,331,29603582,95.4081980919,_100,8,>100
7296,vegetarian,331,29603913,95.4092648586,_100,10,>100
7297,newman,331,29604244,95.4103316252,_100,6,>100
7298,dividend,331,29604575,95.4113983918,_100,8,>100
7299,drunken,331,29604906,95.4124651585,_100,7,>100
7300,benson,331,29605237,95.4135319251,_100,6,>100
7301,flynn,331,29605568,95.4145986917,_100,5,>100
7302,meats,330,29605898,95.4156622355,_100,5,>100
7303,dual,330,29606228,95.4167257793,_100,4,>100
7304,distinctive,330,29606558,95.4177893231,_100,11,>100
7305,bacteria,330,29606888,95.4188528668,_100,8,>100
7306,regret,330,29607218,95.4199164106,_100,6,>100
7307,gig,330,29607548,95.4209799544,_100,3,>100
7308,wilkinson,330,29607878,95.4220434982,_100,9,>100
7309,perimeter,330,29608208,95.4231070419,_100,9,>100
7310,colored,330,29608538,95.4241705857,_100,7,>100
7311,cakes,330,29608868,95.4252341295,_100,5,>100
7312,lit,330,29609198,95.4262976733,_100,3,>100
7313,ordering,330,29609528,95.427361217,_100,8,>100
7314,ripe,330,29609858,95.4284247608,_100,4,>100
7315,mechanical,330,29610188,95.4294883046,_100,10,>100
7316,330,330,29610518,95.4305518484,_100,3,>100
7317,tricky,330,29610848,95.4316153921,_100,6,>100
7318,coconut,330,29611178,95.4326789359,_100,7,>100
7319,creativity,329,29611507,95.4337392568,_100,10,>100
7320,dominate,329,29611836,95.4347995778,_100,8,>100
7321,erin,329,29612165,95.4358598987,_100,4,>100
7322,inspections,329,29612494,95.4369202196,_100,11,>100
7323,outlet,329,29612823,95.4379805405,_100,6,>100
7324,davidson,329,29613152,95.4390408614,_100,8,>100
7325,partial,329,29613481,95.4401011823,_100,7,>100
7326,dumped,329,29613810,95.4411615032,_100,6,>100
7327,ethic,329,29614139,95.4422218242,_100,5,>100
7328,girardi,329,29614468,95.4432821451,_100,7,>100
7329,deborah,329,29614797,95.444342466,_100,7,>100
7330,fined,329,29615126,95.4454027869,_100,5,>100
7331,speeds,329,29615455,95.4464631078,_100,6,>100
7332,brendan,329,29615784,95.4475234287,_100,7,>100
7333,disappearance,329,29616113,95.4485837497,_100,13,>100
7334,nash,328,29616441,95.4496408477,_100,4,>100
7335,habit,328,29616769,95.4506979458,_100,5,>100
7336,lieu,328,29617097,95.4517550438,_100,4,>100
7337,intentions,328,29617425,95.4528121419,_100,10,>100
7338,chapel,328,29617753,95.4538692399,_100,6,>100
7339,rewards,328,29618081,95.454926338,_100,7,>100
7340,steroids,328,29618409,95.455983436,_100,8,>100
7341,molly,328,29618737,95.4570405341,_100,5,>100
7342,padres,328,29619065,95.4580976322,_100,6,>100
7343,touted,327,29619392,95.4591515074,_100,6,>100
7344,joins,327,29619719,95.4602053825,_100,5,>100
7345,successor,327,29620046,95.4612592577,_100,9,>100
7346,dismiss,327,29620373,95.4623131329,_100,7,>100
7347,tire,327,29620700,95.4633670081,_100,4,>100
7348,furious,327,29621027,95.4644208833,_100,7,>100
7349,sustain,327,29621354,95.4654747585,_100,7,>100
7350,exceptions,327,29621681,95.4665286337,_100,10,>100
7351,entries,327,29622008,95.4675825089,_100,7,>100
7352,peninsula,327,29622335,95.4686363841,_100,9,>100
7353,bernanke,327,29622662,95.4696902593,_100,8,>100
7354,caucuses,327,29622989,95.4707441345,_100,8,>100
7355,shouted,327,29623316,95.4717980097,_100,7,>100
7356,deposits,326,29623642,95.472848662,_100,8,>100
7357,kaptur,326,29623968,95.4738993144,_100,6,>100
7358,janet,326,29624294,95.4749499667,_100,5,>100
7359,closures,326,29624620,95.476000619,_100,8,>100
7360,export,326,29624946,95.4770512714,_100,6,>100
7361,gunshot,326,29625272,95.4781019237,_100,7,>100
7362,martha,326,29625598,95.4791525761,_100,6,>100
7363,destinations,326,29625924,95.4802032284,_100,12,>100
7364,acid,326,29626250,95.4812538807,_100,4,>100
7365,companion,326,29626576,95.4823045331,_100,9,>100
7366,earliest,326,29626902,95.4833551854,_100,8,>100
7367,filming,326,29627228,95.4844058377,_100,7,>100
7368,exchanges,326,29627554,95.4854564901,_100,9,>100
7369,imagined,326,29627880,95.4865071424,_100,8,>100
7370,spur,326,29628206,95.4875577947,_100,4,>100
7371,holliday,326,29628532,95.4886084471,_100,8,>100
7372,trustee,326,29628858,95.4896590994,_100,7,>100
7373,channels,326,29629184,95.4907097517,_100,8,>100
7374,hansen,325,29629509,95.4917571812,_100,6,>100
7375,influenced,325,29629834,95.4928046107,_100,10,>100
7376,soaring,325,29630159,95.4938520402,_100,7,>100
7377,ton,325,29630484,95.4948994697,_100,3,>100
7378,goodman,325,29630809,95.4959468991,_100,7,>100
7379,thornton,325,29631134,95.4969943286,_100,8,>100
7380,hurts,325,29631459,95.4980417581,_100,5,>100
7381,325,325,29631784,95.4990891876,_100,3,>100
7382,candidacy,325,29632109,95.500136617,_100,9,>100
7383,drought,325,29632434,95.5011840465,_100,7,>100
7384,guarantees,324,29632758,95.5022282531,_100,10,>100
7385,whitman,324,29633082,95.5032724597,_100,7,>100
7386,wholesale,324,29633406,95.5043166664,_100,9,>100
7387,morrison,324,29633730,95.505360873,_100,8,>100
7388,spurs,324,29634054,95.5064050796,_100,5,>100
7389,organ,324,29634378,95.5074492862,_100,5,>100
7390,finest,324,29634702,95.5084934928,_100,6,>100
7391,lacrosse,324,29635026,95.5095376994,_100,8,>100
7392,colin,324,29635350,95.5105819061,_100,5,>100
7393,braves,324,29635674,95.5116261127,_100,6,>100
7394,searches,324,29635998,95.5126703193,_100,8,>100
7395,tart,324,29636322,95.5137145259,_100,4,>100
7396,shall,324,29636646,95.5147587325,_100,5,>100
7397,mentality,324,29636970,95.5158029391,_100,9,>100
7398,overturned,324,29637294,95.5168471457,_100,10,>100
7399,shadow,324,29637618,95.5178913524,_100,6,>100
7400,unsuccessful,323,29637941,95.5189323361,_100,12,>100
7401,wisely,323,29638264,95.5199733199,_100,6,>100
7402,dive,323,29638587,95.5210143036,_100,4,>100
7403,syndrome,323,29638910,95.5220552874,_100,8,>100
7404,avenues,323,29639233,95.5230962711,_100,7,>100
7405,walnut,323,29639556,95.5241372549,_100,6,>100
7406,outfield,323,29639879,95.5251782387,_100,8,>100
7407,arbor,323,29640202,95.5262192224,_100,5,>100
7408,stored,323,29640525,95.5272602062,_100,6,>100
7409,troubling,323,29640848,95.5283011899,_100,9,>100
7410,backdrop,323,29641171,95.5293421737,_100,8,>100
7411,reopen,323,29641494,95.5303831574,_100,6,>100
7412,photograph,322,29641816,95.5314209183,_100,10,>100
7413,harford,322,29642138,95.5324586792,_100,7,>100
7414,bronx,322,29642460,95.5334964401,_100,5,>100
7415,tasty,322,29642782,95.534534201,_100,5,>100
7416,collegiate,322,29643104,95.5355719619,_100,10,>100
7417,nightmare,322,29643426,95.5366097228,_100,9,>100
7418,bias,322,29643748,95.5376474837,_100,4,>100
7419,desperately,322,29644070,95.5386852446,_100,11,>100
7420,convenient,322,29644392,95.5397230055,_100,10,>100
7421,crafted,322,29644714,95.5407607664,_100,7,>100
7422,absolute,322,29645036,95.5417985273,_100,8,>100
7423,detained,321,29645357,95.5428330653,_100,8,>100
7424,divorced,321,29645678,95.5438676034,_100,8,>100
7425,sacred,321,29645999,95.5449021414,_100,6,>100
7426,renaissance,321,29646320,95.5459366794,_100,11,>100
7427,commercials,321,29646641,95.5469712175,_100,11,>100
7428,bulbs,321,29646962,95.5480057555,_100,5,>100
7429,exclusively,321,29647283,95.5490402935,_100,11,>100
7430,holly,321,29647604,95.5500748316,_100,5,>100
7431,bride,321,29647925,95.5511093696,_100,5,>100
7432,cigarette,321,29648246,95.5521439077,_100,9,>100
7433,inducted,321,29648567,95.5531784457,_100,8,>100
7434,calculated,321,29648888,95.5542129837,_100,10,>100
7435,iranian,321,29649209,95.5552475218,_100,7,>100
7436,remainder,321,29649530,95.5562820598,_100,9,>100
7437,ipo,321,29649851,95.5573165978,_100,3,>100
7438,basil,320,29650171,95.558347913,_100,5,>100
7439,latinos,320,29650491,95.5593792282,_100,7,>100
7440,leyland,320,29650811,95.5604105434,_100,7,>100
7441,cheer,320,29651131,95.5614418585,_100,5,>100
7442,debates,320,29651451,95.5624731737,_100,7,>100
7443,glory,320,29651771,95.5635044889,_100,5,>100
7444,320,320,29652091,95.5645358041,_100,3,>100
7445,blanket,320,29652411,95.5655671192,_100,7,>100
7446,generating,320,29652731,95.5665984344,_100,10,>100
7447,fletcher,320,29653051,95.5676297496,_100,8,>100
7448,zip,320,29653371,95.5686610648,_100,3,>100
7449,ups,320,29653691,95.56969238,_100,3,>100
7450,resist,319,29654010,95.5707204723,_100,6,>100
7451,rebounding,319,29654329,95.5717485646,_100,10,>100
7452,chunk,319,29654648,95.5727766569,_100,5,>100
7453,disagreed,319,29654967,95.5738047492,_100,9,>100
7454,inability,319,29655286,95.5748328415,_100,9,>100
7455,providence,319,29655605,95.5758609339,_100,10,>100
7456,mercer,319,29655924,95.5768890262,_100,6,>100
7457,credentials,319,29656243,95.5779171185,_100,11,>100
7458,anticipate,319,29656562,95.5789452108,_100,10,>100
7459,schneider,319,29656881,95.5799733031,_100,9,>100
7460,cia,319,29657200,95.5810013954,_100,3,>100
7461,establishing,319,29657519,95.5820294878,_100,12,>100
7462,strengths,319,29657838,95.5830575801,_100,9,>100
7463,pinch,318,29658156,95.5840824495,_100,5,>100
7464,populations,318,29658474,95.585107319,_100,11,>100
7465,outrage,318,29658792,95.5861321884,_100,7,>100
7466,courtesy,318,29659110,95.5871570579,_100,8,>100
7467,mayors,318,29659428,95.5881819273,_100,6,>100
7468,hardware,318,29659746,95.5892067968,_100,8,>100
7469,consumed,318,29660064,95.5902316663,_100,8,>100
7470,murders,318,29660382,95.5912565357,_100,7,>100
7471,oxygen,318,29660700,95.5922814052,_100,6,>100
7472,disputes,318,29661018,95.5933062746,_100,8,>100
7473,michele,318,29661336,95.5943311441,_100,7,>100
7474,julian,318,29661654,95.5953560135,_100,6,>100
7475,gifted,318,29661972,95.596380883,_100,6,>100
7476,berkman,318,29662290,95.5974057525,_100,7,>100
7477,nfc,318,29662608,95.5984306219,_100,3,>100
7478,sampling,317,29662925,95.5994522685,_100,8,>100
7479,pipes,317,29663242,95.6004739151,_100,5,>100
7480,framed,317,29663559,95.6014955617,_100,6,>100
7481,cuba,317,29663876,95.6025172083,_100,4,>100
7482,moms,317,29664193,95.6035388549,_100,4,>100
7483,bizarre,317,29664510,95.6045605015,_100,7,>100
7484,bronze,317,29664827,95.6055821481,_100,6,>100
7485,charts,317,29665144,95.6066037947,_100,6,>100
7486,vessel,317,29665461,95.6076254413,_100,6,>100
7487,fireworks,317,29665778,95.6086470879,_100,9,>100
7488,repay,317,29666095,95.6096687345,_100,5,>100
7489,dangers,317,29666412,95.6106903811,_100,7,>100
7490,idol,317,29666729,95.6117120277,_100,4,>100
7491,bridgeton,317,29667046,95.6127336743,_100,9,>100
7492,columns,317,29667363,95.6137553209,_100,7,>100
7493,homework,317,29667680,95.6147769675,_100,8,>100
7494,snack,317,29667997,95.6157986141,_100,5,>100
7495,consultants,317,29668314,95.6168202607,_100,11,>100
7496,suites,317,29668631,95.6178419072,_100,6,>100
7497,benefited,317,29668948,95.6188635538,_100,9,>100
7498,monitors,316,29669264,95.6198819776,_100,8,>100
7499,neal,316,29669580,95.6209004013,_100,4,>100
7500,principle,316,29669896,95.6219188251,_100,9,>100
7501,distinction,316,29670212,95.6229372488,_100,11,>100
7502,takeover,316,29670528,95.6239556725,_100,8,>100
7503,glove,316,29670844,95.6249740963,_100,5,>100
7504,dawson,316,29671160,95.62599252,_100,6,>100
7505,eureka,316,29671476,95.6270109437,_100,6,>100
7506,loyalty,316,29671792,95.6280293675,_100,7,>100
7507,elvis,316,29672108,95.6290477912,_100,5,>100
7508,reckless,316,29672424,95.6300662149,_100,8,>100
7509,underwent,316,29672740,95.6310846387,_100,9,>100
7510,yelled,316,29673056,95.6321030624,_100,6,>100
7511,topping,316,29673372,95.6331214862,_100,7,>100
7512,surprises,316,29673688,95.6341399099,_100,9,>100
7513,wu,316,29674004,95.6351583336,_100,2,>100
7514,attracting,315,29674319,95.6361735345,_100,10,>100
7515,yelling,315,29674634,95.6371887354,_100,7,>100
7516,historian,315,29674949,95.6382039363,_100,9,>100
7517,rio,315,29675264,95.6392191371,_100,3,>100
7518,benedict,315,29675579,95.640234338,_100,8,>100
7519,literary,315,29675894,95.6412495389,_100,8,>100
7520,fitch,315,29676209,95.6422647398,_100,5,>100
7521,kris,315,29676524,95.6432799406,_100,4,>100
7522,squash,315,29676839,95.6442951415,_100,6,>100
7523,exceeded,315,29677154,95.6453103424,_100,8,>100
7524,quote,315,29677469,95.6463255433,_100,5,>100
7525,directing,315,29677784,95.6473407441,_100,9,>100
7526,fighter,315,29678099,95.648355945,_100,7,>100
7527,mlb,315,29678414,95.6493711459,_100,3,>100
7528,lobbyist,315,29678729,95.6503863468,_100,8,>100
7529,prestigious,315,29679044,95.6514015477,_100,11,>100
7530,redistricting,315,29679359,95.6524167485,_100,13,>100
7531,yemen,315,29679674,95.6534319494,_100,5,>100
7532,salsa,314,29679988,95.6544439274,_100,5,>100
7533,gavin,314,29680302,95.6554559054,_100,5,>100
7534,staffing,314,29680616,95.6564678835,_100,8,>100
7535,grief,314,29680930,95.6574798615,_100,5,>100
7536,grain,314,29681244,95.6584918395,_100,5,>100
7537,cinnamon,314,29681558,95.6595038175,_100,8,>100
7538,garfield,314,29681872,95.6605157955,_100,8,>100
7539,belonged,314,29682186,95.6615277735,_100,8,>100
7540,televised,314,29682500,95.6625397516,_100,9,>100
7541,ore,314,29682814,95.6635517296,_100,3,>100
7542,canton,314,29683128,95.6645637076,_100,6,>100
7543,smartphone,314,29683442,95.6655756856,_100,10,>100
7544,anytime,314,29683756,95.6665876636,_100,7,>100
7545,predecessor,314,29684070,95.6675996416,_100,11,>100
7546,mediterranean,314,29684384,95.6686116197,_100,13,>100
7547,concentrate,314,29684698,95.6696235977,_100,11,>100
7548,appreciated,314,29685012,95.6706355757,_100,11,>100
7549,filmmaker,314,29685326,95.6716475537,_100,9,>100
7550,hormone,314,29685640,95.6726595317,_100,7,>100
7551,volatile,314,29685954,95.6736715097,_100,8,>100
7552,dragged,313,29686267,95.6746802649,_100,7,>100
7553,lawmaker,313,29686580,95.6756890201,_100,8,>100
7554,spike,313,29686893,95.6766977752,_100,5,>100
7555,tucker,313,29687206,95.6777065304,_100,6,>100
7556,builds,313,29687519,95.6787152855,_100,6,>100
7557,neutral,313,29687832,95.6797240407,_100,7,>100
7558,evenly,313,29688145,95.6807327958,_100,6,>100
7559,costing,313,29688458,95.681741551,_100,7,>100
7560,forests,313,29688771,95.6827503062,_100,7,>100
7561,buffet,313,29689084,95.6837590613,_100,6,>100
7562,youths,313,29689397,95.6847678165,_100,6,>100
7563,plunged,313,29689710,95.6857765716,_100,7,>100
7564,hampton,313,29690023,95.6867853268,_100,7,>100
7565,simmer,312,29690335,95.6877908591,_100,6,>100
7566,superstar,312,29690647,95.6887963914,_100,9,>100
7567,peoria,312,29690959,95.6898019237,_100,6,>100
7568,daley,312,29691271,95.690807456,_100,5,>100
7569,alternate,312,29691583,95.6918129883,_100,9,>100
7570,scrimmage,312,29691895,95.6928185206,_100,9,>100
7571,examiner,312,29692207,95.6938240529,_100,8,>100
7572,proposing,312,29692519,95.6948295852,_100,9,>100
7573,carr,312,29692831,95.6958351175,_100,4,>100
7574,rockets,312,29693143,95.6968406498,_100,7,>100
7575,absent,312,29693455,95.697846182,_100,6,>100
7576,laboratory,312,29693767,95.6988517143,_100,10,>100
7577,southeastern,312,29694079,95.6998572466,_100,12,>100
7578,linemen,312,29694391,95.7008627789,_100,7,>100
7579,slump,312,29694703,95.7018683112,_100,5,>100
7580,totaling,312,29695015,95.7028738435,_100,8,>100
7581,hires,311,29695326,95.703876153,_100,5,>100
7582,freeholder,311,29695637,95.7048784624,_100,10,>100
7583,morristown,311,29695948,95.7058807718,_100,10,>100
7584,christians,311,29696259,95.7068830813,_100,10,>100
7585,pill,311,29696570,95.7078853907,_100,4,>100
7586,upside,311,29696881,95.7088877002,_100,6,>100
7587,barred,311,29697192,95.7098900096,_100,6,>100
7588,filmed,311,29697503,95.710892319,_100,6,>100
7589,damaging,311,29697814,95.7118946285,_100,8,>100
7590,rocket,311,29698125,95.7128969379,_100,6,>100
7591,laguna,311,29698436,95.7138992473,_100,6,>100
7592,kobe,311,29698747,95.7149015568,_100,4,>100
7593,issuing,310,29699057,95.7159006434,_100,7,>100
7594,tropical,310,29699367,95.7168997299,_100,8,>100
7595,olson,310,29699677,95.7178988165,_100,5,>100
7596,separation,310,29699987,95.7188979031,_100,10,>100
7597,edt,310,29700297,95.7198969897,_100,3,>100
7598,olmsted,310,29700607,95.7208960762,_100,7,>100
7599,toilet,310,29700917,95.7218951628,_100,6,>100
7600,310,310,29701227,95.7228942494,_100,3,>100
7601,barriers,310,29701537,95.723893336,_100,8,>100
7602,alvarez,310,29701847,95.7248924225,_100,7,>100
7603,navigate,310,29702157,95.7258915091,_100,8,>100
7604,autopsy,310,29702467,95.7268905957,_100,7,>100
7605,frederick,310,29702777,95.7278896823,_100,9,>100
7606,refer,310,29703087,95.7288887689,_100,5,>100
7607,walt,309,29703396,95.7298846326,_100,4,>100
7608,drummer,309,29703705,95.7308804963,_100,7,>100
7609,stretching,309,29704014,95.73187636,_100,10,>100
7610,correctly,309,29704323,95.7328722237,_100,9,>100
7611,arbitration,309,29704632,95.7338680874,_100,11,>100
7612,firmly,309,29704941,95.7348639512,_100,6,>100
7613,essence,309,29705250,95.7358598149,_100,7,>100
7614,upbeat,309,29705559,95.7368556786,_100,6,>100
7615,cattle,309,29705868,95.7378515423,_100,6,>100
7616,exams,309,29706177,95.738847406,_100,5,>100
7617,stripped,309,29706486,95.7398432697,_100,8,>100
7618,tightly,309,29706795,95.7408391335,_100,7,>100
7619,manny,308,29707103,95.7418317743,_100,5,>100
7620,believing,308,29707411,95.7428244152,_100,9,>100
7621,terri,308,29707719,95.743817056,_100,5,>100
7622,rage,308,29708027,95.7448096969,_100,4,>100
7623,handsome,308,29708335,95.7458023377,_100,8,>100
7624,klein,308,29708643,95.7467949786,_100,5,>100
7625,locate,308,29708951,95.7477876195,_100,6,>100
7626,wonders,308,29709259,95.7487802603,_100,7,>100
7627,occurs,308,29709567,95.7497729012,_100,6,>100
7628,alumni,308,29709875,95.750765542,_100,6,>100
7629,windsor,308,29710183,95.7517581829,_100,7,>100
7630,melted,308,29710491,95.7527508237,_100,6,>100
7631,polling,308,29710799,95.7537434646,_100,7,>100
7632,overseeing,308,29711107,95.7547361055,_100,10,>100
7633,inmate,308,29711415,95.7557287463,_100,6,>100
7634,swings,308,29711723,95.7567213872,_100,6,>100
7635,uninsured,308,29712031,95.757714028,_100,9,>100
7636,surviving,307,29712338,95.758703446,_100,9,>100
7637,bleeding,307,29712645,95.759692864,_100,8,>100
7638,homeowner,307,29712952,95.760682282,_100,9,>100
7639,regulate,307,29713259,95.7616717,_100,8,>100
7640,redskins,307,29713566,95.762661118,_100,8,>100
7641,concerning,307,29713873,95.763650536,_100,10,>100
7642,transparent,307,29714180,95.764639954,_100,11,>100
7643,jackpot,307,29714487,95.765629372,_100,7,>100
7644,poster,307,29714794,95.76661879,_100,6,>100
7645,tasks,307,29715101,95.767608208,_100,5,>100
7646,beachwood,307,29715408,95.768597626,_100,9,>100
7647,betting,307,29715715,95.769587044,_100,7,>100
7648,goat,307,29716022,95.770576462,_100,4,>100
7649,tentative,307,29716329,95.77156588,_100,9,>100
7650,ex,307,29716636,95.772555298,_100,2,>100
7651,lieutenant,307,29716943,95.773544716,_100,10,>100
7652,katherine,307,29717250,95.774534134,_100,9,>100
7653,jill,307,29717557,95.775523552,_100,4,>100
7654,determining,307,29717864,95.77651297,_100,11,>100
7655,tales,307,29718171,95.777502388,_100,5,>100
7656,codes,306,29718477,95.7784885831,_100,5,>100
7657,excluding,306,29718783,95.7794747783,_100,9,>100
7658,lindbergh,306,29719089,95.7804609734,_100,9,>100
7659,bearing,306,29719395,95.7814471685,_100,7,>100
7660,carey,306,29719701,95.7824333637,_100,5,>100
7661,kidnapping,306,29720007,95.7834195588,_100,10,>100
7662,eaten,306,29720313,95.7844057539,_100,5,>100
7663,phenomenon,306,29720619,95.7853919491,_100,10,>100
7664,delight,306,29720925,95.7863781442,_100,7,>100
7665,seth,306,29721231,95.7873643394,_100,4,>100
7666,investigative,306,29721537,95.7883505345,_100,13,>100
7667,belly,306,29721843,95.7893367296,_100,5,>100
7668,prudential,306,29722149,95.7903229248,_100,10,>100
7669,magical,306,29722455,95.7913091199,_100,7,>100
7670,upheld,306,29722761,95.792295315,_100,6,>100
7671,sears,306,29723067,95.7932815102,_100,5,>100
7672,murdered,306,29723373,95.7942677053,_100,8,>100
7673,strictly,305,29723678,95.7952506776,_100,8,>100
7674,sedan,305,29723983,95.7962336499,_100,5,>100
7675,allison,305,29724288,95.7972166221,_100,7,>100
7676,ensuring,305,29724593,95.7981995944,_100,8,>100
7677,fireplace,305,29724898,95.7991825667,_100,9,>100
7678,forming,305,29725203,95.800165539,_100,7,>100
7679,enroll,305,29725508,95.8011485113,_100,6,>100
7680,moody,305,29725813,95.8021314835,_100,5,>100
7681,soviet,305,29726118,95.8031144558,_100,6,>100
7682,juicy,305,29726423,95.8040974281,_100,5,>100
7683,lacking,305,29726728,95.8050804004,_100,7,>100
7684,comparable,305,29727033,95.8060633726,_100,10,>100
7685,aisle,305,29727338,95.8070463449,_100,5,>100
7686,instrument,305,29727643,95.8080293172,_100,10,>100
7687,harbaugh,305,29727948,95.8090122895,_100,8,>100
7688,305,305,29728253,95.8099952618,_100,3,>100
7689,soared,305,29728558,95.810978234,_100,6,>100
7690,sidelined,305,29728863,95.8119612063,_100,9,>100
7691,ingredient,305,29729168,95.8129441786,_100,10,>100
7692,humble,304,29729472,95.813923928,_100,6,>100
7693,invite,304,29729776,95.8149036774,_100,6,>100
7694,grammy,304,29730080,95.8158834268,_100,6,>100
7695,buys,304,29730384,95.8168631763,_100,4,>100
7696,cared,304,29730688,95.8178429257,_100,5,>100
7697,hunters,304,29730992,95.8188226751,_100,7,>100
7698,extends,304,29731296,95.8198024245,_100,7,>100
7699,aldermen,304,29731600,95.8207821739,_100,8,>100
7700,persons,304,29731904,95.8217619233,_100,7,>100
7701,goodyear,304,29732208,95.8227416728,_100,8,>100
7702,vodka,304,29732512,95.8237214222,_100,5,>100
7703,deposit,304,29732816,95.8247011716,_100,7,>100
7704,hottest,304,29733120,95.825680921,_100,7,>100
7705,erupted,304,29733424,95.8266606704,_100,7,>100
7706,advances,304,29733728,95.8276404198,_100,8,>100
7707,gallagher,303,29734031,95.8286169464,_100,9,>100
7708,wedge,303,29734334,95.829593473,_100,5,>100
7709,bathrooms,303,29734637,95.8305699995,_100,9,>100
7710,fairness,303,29734940,95.8315465261,_100,8,>100
7711,rome,303,29735243,95.8325230526,_100,4,>100
7712,moss,303,29735546,95.8334995792,_100,4,>100
7713,stones,303,29735849,95.8344761057,_100,6,>100
7714,montclair,303,29736152,95.8354526323,_100,9,>100
7715,processed,303,29736455,95.8364291589,_100,9,>100
7716,exploration,303,29736758,95.8374056854,_100,11,>100
7717,exercises,303,29737061,95.838382212,_100,9,>100
7718,drake,303,29737364,95.8393587385,_100,5,>100
7719,hazelwood,303,29737667,95.8403352651,_100,9,>100
7720,kitzhaber,303,29737970,95.8413117917,_100,9,>100
7721,layup,303,29738273,95.8422883182,_100,5,>100
7722,additionally,303,29738576,95.8432648448,_100,12,>100
7723,bow,303,29738879,95.8442413713,_100,3,>100
7724,retreat,303,29739182,95.8452178979,_100,7,>100
7725,charities,303,29739485,95.8461944244,_100,9,>100
7726,steering,303,29739788,95.847170951,_100,8,>100
7727,sweetness,302,29740090,95.8481442547,_100,9,>100
7728,recreational,302,29740392,95.8491175584,_100,12,>100
7729,bump,302,29740694,95.8500908621,_100,4,>100
7730,grave,302,29740996,95.8510641658,_100,5,>100
7731,commuters,302,29741298,95.8520374695,_100,9,>100
7732,secrets,302,29741600,95.8530107732,_100,7,>100
7733,princess,302,29741902,95.8539840769,_100,8,>100
7734,runway,302,29742204,95.8549573806,_100,6,>100
7735,chagrin,302,29742506,95.8559306843,_100,7,>100
7736,anxious,302,29742808,95.856903988,_100,7,>100
7737,bare,302,29743110,95.8578772917,_100,4,>100
7738,stranger,302,29743412,95.8588505954,_100,8,>100
7739,grandparents,302,29743714,95.8598238991,_100,12,>100
7740,jamison,302,29744016,95.8607972028,_100,7,>100
7741,rescued,302,29744318,95.8617705065,_100,7,>100
7742,libraries,302,29744620,95.8627438102,_100,9,>100
7743,smartphones,302,29744922,95.8637171139,_100,11,>100
7744,rowan,302,29745224,95.8646904176,_100,5,>100
7745,existed,302,29745526,95.8656637213,_100,7,>100
7746,modified,302,29745828,95.8666370249,_100,8,>100
7747,connor,302,29746130,95.8676103286,_100,6,>100
7748,dipped,302,29746432,95.8685836323,_100,6,>100
7749,ounce,301,29746733,95.8695537132,_100,5,>100
7750,californians,301,29747034,95.870523794,_100,12,>100
7751,grounded,301,29747335,95.8714938749,_100,8,>100
7752,succeeded,301,29747636,95.8724639557,_100,9,>100
7753,marin,301,29747937,95.8734340365,_100,5,>100
7754,dense,301,29748238,95.8744041174,_100,5,>100
7755,punt,301,29748539,95.8753741982,_100,4,>100
7756,colonial,301,29748840,95.876344279,_100,8,>100
7757,prohibit,301,29749141,95.8773143599,_100,8,>100
7758,reps,301,29749442,95.8782844407,_100,4,>100
7759,overlooking,301,29749743,95.8792545216,_100,11,>100
7760,wellness,301,29750044,95.8802246024,_100,8,>100
7761,sherman,301,29750345,95.8811946832,_100,7,>100
7762,alter,301,29750646,95.8821647641,_100,5,>100
7763,fiat,300,29750946,95.8831316221,_100,4,>100
7764,watchdog,300,29751246,95.88409848,_100,8,>100
7765,regain,300,29751546,95.885065338,_100,6,>100
7766,nichols,300,29751846,95.886032196,_100,7,>100
7767,300,300,29752146,95.886999054,_100,3,>100
7768,wrapping,300,29752446,95.8879659119,_100,8,>100
7769,smallest,300,29752746,95.8889327699,_100,8,>100
7770,alameda,300,29753046,95.8898996279,_100,7,>100
7771,gras,300,29753346,95.8908664859,_100,4,>100
7772,averages,300,29753646,95.8918333439,_100,8,>100
7773,satisfy,300,29753946,95.8928002018,_100,7,>100
7774,mask,300,29754246,95.8937670598,_100,4,>100
7775,amateur,300,29754546,95.8947339178,_100,7,>100
7776,relying,300,29754846,95.8957007758,_100,7,>100
7777,offensively,300,29755146,95.8966676337,_100,11,>100
7778,privilege,299,29755445,95.8976312689,_100,9,>100
7779,whoever,299,29755744,95.898594904,_100,7,>100
7780,transfers,299,29756043,95.8995585391,_100,9,>100
7781,breakdown,299,29756342,95.9005221742,_100,9,>100
7782,fragile,299,29756641,95.9014858093,_100,7,>100
7783,savory,299,29756940,95.9024494444,_100,6,>100
7784,moreover,299,29757239,95.9034130796,_100,8,>100
7785,lied,299,29757538,95.9043767147,_100,4,>100
7786,asleep,299,29757837,95.9053403498,_100,6,>100
7787,earl,299,29758136,95.9063039849,_100,4,>100
7788,cooperate,299,29758435,95.90726762,_100,9,>100
7789,unusually,299,29758734,95.9082312552,_100,9,>100
7790,quarterfinals,299,29759033,95.9091948903,_100,13,>100
7791,shutdown,299,29759332,95.9101585254,_100,8,>100
7792,toasted,299,29759631,95.9111221605,_100,7,>100
7793,performer,299,29759930,95.9120857956,_100,9,>100
7794,depressed,298,29760228,95.9130462079,_100,9,>100
7795,whipped,298,29760526,95.9140066201,_100,7,>100
7796,anticipation,298,29760824,95.9149670324,_100,12,>100
7797,mickey,298,29761122,95.9159274447,_100,6,>100
7798,certification,298,29761420,95.9168878569,_100,13,>100
7799,minors,298,29761718,95.9178482692,_100,6,>100
7800,defensively,298,29762016,95.9188086814,_100,11,>100
7801,judiciary,298,29762314,95.9197690937,_100,9,>100
7802,bradford,298,29762612,95.9207295059,_100,8,>100
7803,owens,298,29762910,95.9216899182,_100,5,>100
7804,prescriptions,298,29763208,95.9226503305,_100,13,>100
7805,reflection,298,29763506,95.9236107427,_100,10,>100
7806,nerve,298,29763804,95.924571155,_100,5,>100
7807,huff,298,29764102,95.9255315672,_100,4,>100
7808,trimet,298,29764400,95.9264919795,_100,6,>100
7809,abilities,298,29764698,95.9274523918,_100,9,>100
7810,lamar,298,29764996,95.928412804,_100,5,>100
7811,cow,298,29765294,95.9293732163,_100,3,>100
7812,imposing,297,29765591,95.9303304057,_100,8,>100
7813,marketplace,297,29765888,95.9312875951,_100,11,>100
7814,carlson,297,29766185,95.9322447845,_100,7,>100
7815,magazines,297,29766482,95.9332019739,_100,9,>100
7816,recycled,297,29766779,95.9341591633,_100,8,>100
7817,convincing,297,29767076,95.9351163527,_100,10,>100
7818,shrinking,297,29767373,95.9360735421,_100,9,>100
7819,cookie,297,29767670,95.9370307315,_100,6,>100
7820,expressing,297,29767967,95.9379879208,_100,10,>100
7821,nypd,297,29768264,95.9389451102,_100,4,>100
7822,improper,297,29768561,95.9399022996,_100,8,>100
7823,acceptance,296,29768857,95.9408562662,_100,10,>100
7824,walton,296,29769153,95.9418102327,_100,6,>100
7825,conclude,296,29769449,95.9427641993,_100,8,>100
7826,reopened,296,29769745,95.9437181658,_100,8,>100
7827,stiff,296,29770041,95.9446721323,_100,5,>100
7828,introducing,296,29770337,95.9456260989,_100,11,>100
7829,famed,296,29770633,95.9465800654,_100,5,>100
7830,rainbow,296,29770929,95.947534032,_100,7,>100
7831,illustrated,296,29771225,95.9484879985,_100,11,>100
7832,leverage,296,29771521,95.949441965,_100,8,>100
7833,buckeye,296,29771817,95.9503959316,_100,7,>100
7834,fulton,296,29772113,95.9513498981,_100,6,>100
7835,buchanan,295,29772408,95.9523006418,_100,8,>100
7836,boutique,295,29772703,95.9532513855,_100,8,>100
7837,unidentified,295,29772998,95.9542021291,_100,12,>100
7838,highlands,295,29773293,95.9551528728,_100,9,>100
7839,pulls,295,29773588,95.9561036165,_100,5,>100
7840,patch,295,29773883,95.9570543602,_100,5,>100
7841,clarity,295,29774178,95.9580051038,_100,7,>100
7842,scare,295,29774473,95.9589558475,_100,5,>100
7843,jpmorgan,295,29774768,95.9599065912,_100,8,>100
7844,relate,295,29775063,95.9608573349,_100,6,>100
7845,motive,295,29775358,95.9618080786,_100,6,>100
7846,editors,295,29775653,95.9627588222,_100,7,>100
7847,expectation,295,29775948,95.9637095659,_100,11,>100
7848,memoir,295,29776243,95.9646603096,_100,6,>100
7849,goalkeeper,295,29776538,95.9656110533,_100,10,>100
7850,deli,294,29776832,95.9665585741,_100,4,>100
7851,fry,294,29777126,95.9675060949,_100,3,>100
7852,supervision,294,29777420,95.9684536157,_100,11,>100
7853,guilt,294,29777714,95.9694011365,_100,5,>100
7854,sliding,294,29778008,95.9703486574,_100,7,>100
7855,chelsea,294,29778302,95.9712961782,_100,7,>100
7856,seated,294,29778596,95.972243699,_100,6,>100
7857,inform,294,29778890,95.9731912198,_100,6,>100
7858,beckman,294,29779184,95.9741387406,_100,7,>100
7859,relentless,294,29779478,95.9750862615,_100,10,>100
7860,trademark,294,29779772,95.9760337823,_100,9,>100
7861,cozy,294,29780066,95.9769813031,_100,4,>100
7862,deployed,294,29780360,95.9779288239,_100,8,>100
7863,woodson,294,29780654,95.9788763447,_100,7,>100
7864,colon,294,29780948,95.9798238655,_100,5,>100
7865,shareholder,294,29781242,95.9807713864,_100,11,>100
7866,pumpkin,294,29781536,95.9817189072,_100,7,>100
7867,greenhouse,294,29781830,95.982666428,_100,10,>100
7868,dunk,294,29782124,95.9836139488,_100,4,>100
7869,boxer,294,29782418,95.9845614696,_100,5,>100
7870,answering,294,29782712,95.9855089905,_100,9,>100
7871,unanimous,293,29783005,95.9864532884,_100,9,>100
7872,aunt,293,29783298,95.9873975864,_100,4,>100
7873,abandon,293,29783591,95.9883418843,_100,7,>100
7874,diaz,293,29783884,95.9892861823,_100,4,>100
7875,berlin,293,29784177,95.9902304802,_100,6,>100
7876,evolution,293,29784470,95.9911747782,_100,9,>100
7877,partnerships,293,29784763,95.9921190762,_100,12,>100
7878,turmoil,293,29785056,95.9930633741,_100,7,>100
7879,bans,293,29785349,95.9940076721,_100,4,>100
7880,lush,293,29785642,95.99495197,_100,4,>100
7881,precinct,293,29785935,95.995896268,_100,8,>100
7882,flawed,293,29786228,95.996840566,_100,6,>100
7883,wang,293,29786521,95.9977848639,_100,4,>100
7884,centerpiece,293,29786814,95.9987291619,_100,11,>100
7885,bombs,293,29787107,95.9996734598,_100,5,>100
7886,renovated,293,29787400,96.0006177578,_100,9,>100
7887,lb,293,29787693,96.0015620557,_100,2,>100
7888,mccormick,292,29787985,96.0025031308,_100,9,>100
7889,educated,292,29788277,96.0034442059,_100,8,>100
7890,lightning,292,29788569,96.004385281,_100,9,>100
7891,cried,292,29788861,96.0053263561,_100,5,>100
7892,nightly,292,29789153,96.0062674312,_100,7,>100
7893,limitations,292,29789445,96.0072085063,_100,11,>100
7894,beats,292,29789737,96.0081495814,_100,5,>100
7895,strangers,292,29790029,96.0090906565,_100,9,>100
7896,forecasts,292,29790321,96.0100317316,_100,9,>100
7897,decor,292,29790613,96.0109728067,_100,5,>100
7898,aluminum,292,29790905,96.0119138818,_100,8,>100
7899,gown,291,29791196,96.0128517341,_100,4,>100
7900,schiano,291,29791487,96.0137895863,_100,7,>100
7901,delegation,291,29791778,96.0147274385,_100,10,>100
7902,taco,291,29792069,96.0156652908,_100,4,>100
7903,copper,291,29792360,96.016603143,_100,6,>100
7904,smiled,291,29792651,96.0175409953,_100,6,>100
7905,highs,291,29792942,96.0184788475,_100,5,>100
7906,essay,291,29793233,96.0194166997,_100,5,>100
7907,wheelchair,291,29793524,96.020354552,_100,10,>100
7908,substantially,291,29793815,96.0212924042,_100,13,>100
7909,wilsonville,291,29794106,96.0222302565,_100,11,>100
7910,formation,291,29794397,96.0231681087,_100,9,>100
7911,conductor,291,29794688,96.0241059609,_100,9,>100
7912,speeding,291,29794979,96.0250438132,_100,8,>100
7913,rochester,290,29795269,96.0259784425,_100,9,>100
7914,qaeda,290,29795559,96.0269130719,_100,5,>100
7915,billing,290,29795849,96.0278477013,_100,7,>100
7916,bloody,290,29796139,96.0287823307,_100,6,>100
7917,xavier,290,29796429,96.0297169601,_100,6,>100
7918,subscribers,290,29796719,96.0306515894,_100,11,>100
7919,dekalb,290,29797009,96.0315862188,_100,6,>100
7920,dooley,290,29797299,96.0325208482,_100,6,>100
7921,pale,290,29797589,96.0334554776,_100,4,>100
7922,devastated,290,29797879,96.034390107,_100,10,>100
7923,manslaughter,290,29798169,96.0353247363,_100,12,>100
7924,chased,290,29798459,96.0362593657,_100,6,>100
7925,aired,290,29798749,96.0371939951,_100,5,>100
7926,kong,290,29799039,96.0381286245,_100,4,>100
7927,dignity,290,29799329,96.0390632538,_100,7,>100
7928,disciplined,290,29799619,96.0399978832,_100,11,>100
7929,mounting,290,29799909,96.0409325126,_100,8,>100
7930,bruins,290,29800199,96.041867142,_100,6,>100
7931,stairs,290,29800489,96.0428017714,_100,6,>100
7932,cultures,290,29800779,96.0437364007,_100,8,>100
7933,portrayed,290,29801069,96.0446710301,_100,9,>100
7934,saucepan,290,29801359,96.0456056595,_100,8,>100
7935,breathe,290,29801649,96.0465402889,_100,7,>100
7936,heal,290,29801939,96.0474749183,_100,4,>100
7937,indy,290,29802229,96.0484095476,_100,4,>100
7938,haul,290,29802519,96.049344177,_100,4,>100
7939,debit,290,29802809,96.0502788064,_100,5,>100
7940,lamarcus,289,29803098,96.0512102129,_100,8,>100
7941,rb,289,29803387,96.0521416194,_100,2,>100
7942,profession,289,29803676,96.0530730259,_100,10,>100
7943,braun,289,29803965,96.0540044325,_100,5,>100
7944,rubio,289,29804254,96.054935839,_100,5,>100
7945,tanks,289,29804543,96.0558672455,_100,5,>100
7946,inspiring,289,29804832,96.056798652,_100,9,>100
7947,bankers,289,29805121,96.0577300585,_100,7,>100
7948,wildly,289,29805410,96.0586614651,_100,6,>100
7949,ramos,289,29805699,96.0595928716,_100,5,>100
7950,cooler,289,29805988,96.0605242781,_100,6,>100
7951,dolan,289,29806277,96.0614556846,_100,5,>100
7952,shorts,289,29806566,96.0623870911,_100,6,>100
7953,happily,289,29806855,96.0633184976,_100,7,>100
7954,raced,289,29807144,96.0642499042,_100,5,>100
7955,quicker,289,29807433,96.0651813107,_100,7,>100
7956,laundry,289,29807722,96.0661127172,_100,7,>100
7957,sullinger,289,29808011,96.0670441237,_100,9,>100
7958,conclusions,289,29808300,96.0679755302,_100,11,>100
7959,cheering,289,29808589,96.0689069368,_100,8,>100
7960,carolyn,288,29808877,96.0698351204,_100,7,>100
7961,preview,288,29809165,96.0707633041,_100,7,>100
7962,superb,288,29809453,96.0716914877,_100,6,>100
7963,wallet,288,29809741,96.0726196714,_100,6,>100
7964,montreal,288,29810029,96.0735478551,_100,8,>100
7965,paterson,288,29810317,96.0744760387,_100,8,>100
7966,peanut,288,29810605,96.0754042224,_100,6,>100
7967,lesser,288,29810893,96.076332406,_100,6,>100
7968,booking,288,29811181,96.0772605897,_100,7,>100
7969,nissan,288,29811469,96.0781887733,_100,6,>100
7970,sank,288,29811757,96.079116957,_100,4,>100
7971,dwek,288,29812045,96.0800451407,_100,4,>100
7972,clip,288,29812333,96.0809733243,_100,4,>100
7973,marched,288,29812621,96.081901508,_100,7,>100
7974,lori,288,29812909,96.0828296916,_100,4,>100
7975,revealing,288,29813197,96.0837578753,_100,9,>100
7976,hooked,288,29813485,96.084686059,_100,6,>100
7977,expires,288,29813773,96.0856142426,_100,7,>100
7978,villa,288,29814061,96.0865424263,_100,5,>100
7979,minimize,287,29814348,96.0874673871,_100,8,>100
7980,underlying,287,29814635,96.0883923479,_100,10,>100
7981,encountered,287,29814922,96.0893173087,_100,11,>100
7982,profound,287,29815209,96.0902422695,_100,8,>100
7983,throat,287,29815496,96.0911672303,_100,6,>100
7984,leslie,287,29815783,96.0920921911,_100,6,>100
7985,cracks,287,29816070,96.0930171519,_100,6,>100
7986,lingering,287,29816357,96.0939421127,_100,9,>100
7987,wasted,287,29816644,96.0948670735,_100,6,>100
7988,genetic,287,29816931,96.0957920343,_100,7,>100
7989,billed,287,29817218,96.0967169951,_100,6,>100
7990,umenyiora,287,29817505,96.0976419559,_100,9,>100
7991,amber,287,29817792,96.0985669167,_100,5,>100
7992,incorporate,287,29818079,96.0994918775,_100,11,>100
7993,barn,287,29818366,96.1004168383,_100,4,>100
7994,traders,287,29818653,96.1013417991,_100,7,>100
7995,presenting,286,29818939,96.102263537,_100,10,>100
7996,eclectic,286,29819225,96.1031852749,_100,8,>100
7997,sidelines,286,29819511,96.1041070129,_100,9,>100
7998,towson,286,29819797,96.1050287508,_100,6,>100
7999,torture,286,29820083,96.1059504887,_100,7,>100
8000,von,286,29820369,96.1068722267,_100,3,>100
8001,handing,286,29820655,96.1077939646,_100,7,>100
8002,exempt,286,29820941,96.1087157026,_100,6,>100
8003,lowe,286,29821227,96.1096374405,_100,4,>100
8004,backers,286,29821513,96.1105591784,_100,7,>100
8005,screenings,286,29821799,96.1114809164,_100,10,>100
8006,flown,286,29822085,96.1124026543,_100,5,>100
8007,curve,286,29822371,96.1133243923,_100,5,>100
8008,spoon,286,29822657,96.1142461302,_100,5,>100
8009,berea,286,29822943,96.1151678681,_100,5,>100
8010,randolph,286,29823229,96.1160896061,_100,8,>100
8011,fleming,286,29823515,96.117011344,_100,7,>100
8012,timeline,285,29823800,96.1179298591,_100,8,>100
8013,noah,285,29824085,96.1188483742,_100,4,>100
8014,rallies,285,29824370,96.1197668893,_100,7,>100
8015,misses,285,29824655,96.1206854043,_100,6,>100
8016,leo,285,29824940,96.1216039194,_100,3,>100
8017,bribes,285,29825225,96.1225224345,_100,6,>100
8018,bombing,285,29825510,96.1234409496,_100,7,>100
8019,confusing,285,29825795,96.1243594646,_100,9,>100
8020,affiliate,285,29826080,96.1252779797,_100,9,>100
8021,pursued,285,29826365,96.1261964948,_100,7,>100
8022,memorabilia,285,29826650,96.1271150099,_100,11,>100
8023,sadly,285,29826935,96.128033525,_100,5,>100
8024,sings,285,29827220,96.12895204,_100,5,>100
8025,characterized,285,29827505,96.1298705551,_100,13,>100
8026,haiti,284,29827789,96.1307858473,_100,5,>100
8027,festivals,284,29828073,96.1317011396,_100,9,>100
8028,inspectors,284,29828357,96.1326164318,_100,10,>100
8029,imported,284,29828641,96.133531724,_100,8,>100
8030,conceded,284,29828925,96.1344470162,_100,8,>100
8031,setback,284,29829209,96.1353623084,_100,7,>100
8032,accidentally,284,29829493,96.1362776007,_100,12,>100
8033,composite,284,29829777,96.1371928929,_100,9,>100
8034,mart,284,29830061,96.1381081851,_100,4,>100
8035,voluntarily,284,29830345,96.1390234773,_100,11,>100
8036,southbound,284,29830629,96.1399387695,_100,10,>100
8037,proving,284,29830913,96.1408540617,_100,7,>100
8038,thankful,284,29831197,96.141769354,_100,8,>100
8039,unchanged,284,29831481,96.1426846462,_100,9,>100
8040,newer,284,29831765,96.1435999384,_100,5,>100
8041,margins,284,29832049,96.1445152306,_100,7,>100
8042,refers,284,29832333,96.1454305228,_100,6,>100
8043,churchill,284,29832617,96.1463458151,_100,9,>100
8044,cabbage,283,29832900,96.1472578844,_100,7,>100
8045,borrowed,283,29833183,96.1481699538,_100,8,>100
8046,obstacles,283,29833466,96.1490820231,_100,9,>100
8047,yours,283,29833749,96.1499940925,_100,5,>100
8048,spouse,283,29834032,96.1509061619,_100,6,>100
8049,misleading,283,29834315,96.1518182312,_100,10,>100
8050,outcomes,283,29834598,96.1527303006,_100,8,>100
8051,rises,283,29834881,96.1536423699,_100,5,>100
8052,faded,283,29835164,96.1545544393,_100,5,>100
8053,reactor,283,29835447,96.1554665087,_100,7,>100
8054,denying,283,29835730,96.156378578,_100,7,>100
8055,colombia,283,29836013,96.1572906474,_100,8,>100
8056,pairs,283,29836296,96.1582027167,_100,5,>100
8057,finely,283,29836579,96.1591147861,_100,6,>100
8058,skies,283,29836862,96.1600268554,_100,5,>100
8059,photographers,282,29837144,96.1609357019,_100,13,>100
8060,obese,282,29837426,96.1618445484,_100,5,>100
8061,trusted,282,29837708,96.1627533949,_100,7,>100
8062,cooling,282,29837990,96.1636622414,_100,7,>100
8063,linebackers,282,29838272,96.1645710879,_100,11,>100
8064,lester,282,29838554,96.1654799344,_100,6,>100
8065,bedrooms,282,29838836,96.1663887809,_100,8,>100
8066,confront,282,29839118,96.1672976274,_100,8,>100
8067,ontario,282,29839400,96.1682064739,_100,7,>100
8068,specialized,282,29839682,96.1691153204,_100,11,>100
8069,weeden,282,29839964,96.1700241669,_100,6,>100
8070,references,282,29840246,96.1709330134,_100,10,>100
8071,settings,282,29840528,96.1718418599,_100,8,>100
8072,qualities,282,29840810,96.1727507064,_100,9,>100
8073,withdrawal,282,29841092,96.1736595529,_100,10,>100
8074,magnitude,282,29841374,96.1745683994,_100,9,>100
8075,overweight,282,29841656,96.1754772459,_100,10,>100
8076,innocence,282,29841938,96.1763860924,_100,9,>100
8077,exemption,282,29842220,96.1772949389,_100,9,>100
8078,asu,282,29842502,96.1782037854,_100,3,>100
8079,burlington,281,29842783,96.1791094091,_100,10,>100
8080,likelihood,281,29843064,96.1800150327,_100,10,>100
8081,yearly,281,29843345,96.1809206563,_100,6,>100
8082,summers,281,29843626,96.18182628,_100,7,>100
8083,proves,281,29843907,96.1827319036,_100,6,>100
8084,diplomatic,281,29844188,96.1836375273,_100,10,>100
8085,mater,281,29844469,96.1845431509,_100,5,>100
8086,filmmakers,281,29844750,96.1854487745,_100,10,>100
8087,rustic,281,29845031,96.1863543982,_100,6,>100
8088,needing,281,29845312,96.1872600218,_100,7,>100
8089,shaped,281,29845593,96.1881656455,_100,6,>100
8090,sidewalks,281,29845874,96.1890712691,_100,9,>100
8091,shotgun,281,29846155,96.1899768927,_100,7,>100
8092,renew,281,29846436,96.1908825164,_100,5,>100
8093,disputed,281,29846717,96.19178814,_100,8,>100
8094,hank,281,29846998,96.1926937637,_100,4,>100
8095,widow,281,29847279,96.1935993873,_100,5,>100
8096,unused,281,29847560,96.1945050109,_100,6,>100
8097,tvs,281,29847841,96.1954106346,_100,3,>100
8098,boarding,281,29848122,96.1963162582,_100,8,>100
8099,rebels,281,29848403,96.1972218819,_100,6,>100
8100,portman,281,29848684,96.1981275055,_100,7,>100
8101,280,280,29848964,96.1990299063,_100,3,>100
8102,commute,280,29849244,96.1999323071,_100,7,>100
8103,gubernatorial,280,29849524,96.2008347078,_100,13,>100
8104,adjustment,280,29849804,96.2017371086,_100,10,>100
8105,capitals,280,29850084,96.2026395094,_100,8,>100
8106,influences,280,29850364,96.2035419102,_100,10,>100
8107,tunes,280,29850644,96.2044443109,_100,5,>100
8108,uncovered,280,29850924,96.2053467117,_100,9,>100
8109,pouring,280,29851204,96.2062491125,_100,7,>100
8110,showdown,280,29851484,96.2071515133,_100,8,>100
8111,finalized,280,29851764,96.2080539141,_100,9,>100
8112,skyline,280,29852044,96.2089563148,_100,7,>100
8113,hillis,280,29852324,96.2098587156,_100,6,>100
8114,clearing,280,29852604,96.2107611164,_100,8,>100
8115,offshore,280,29852884,96.2116635172,_100,8,>100
8116,premature,280,29853164,96.212565918,_100,9,>100
8117,sergeant,280,29853444,96.2134683187,_100,8,>100
8118,northbound,280,29853724,96.2143707195,_100,10,>100
8119,shocking,280,29854004,96.2152731203,_100,8,>100
8120,composed,279,29854283,96.2161722982,_100,8,>100
8121,generic,279,29854562,96.2170714761,_100,7,>100
8122,artificial,279,29854841,96.2179706541,_100,10,>100
8123,void,279,29855120,96.218869832,_100,4,>100
8124,aurora,279,29855399,96.2197690099,_100,6,>100
8125,overwhelmingly,279,29855678,96.2206681878,_100,14,>100
8126,condo,279,29855957,96.2215673657,_100,5,>100
8127,illnesses,279,29856236,96.2224665437,_100,9,>100
8128,outright,279,29856515,96.2233657216,_100,8,>100
8129,marvin,279,29856794,96.2242648995,_100,6,>100
8130,sheer,279,29857073,96.2251640774,_100,5,>100
8131,weiss,279,29857352,96.2260632553,_100,5,>100
8132,soap,279,29857631,96.2269624332,_100,4,>100
8133,shale,279,29857910,96.2278616112,_100,5,>100
8134,surplus,279,29858189,96.2287607891,_100,7,>100
8135,organizer,279,29858468,96.229659967,_100,9,>100
8136,oaks,279,29858747,96.2305591449,_100,4,>100
8137,preschool,278,29859025,96.2314551,_100,9,>100
8138,disciplinary,278,29859303,96.232351055,_100,12,>100
8139,splash,278,29859581,96.2332470101,_100,6,>100
8140,gospel,278,29859859,96.2341429652,_100,6,>100
8141,prepares,278,29860137,96.2350389202,_100,8,>100
8142,psychology,278,29860415,96.2359348753,_100,10,>100
8143,clouds,278,29860693,96.2368308303,_100,6,>100
8144,tensions,278,29860971,96.2377267854,_100,8,>100
8145,carrie,278,29861249,96.2386227405,_100,6,>100
8146,chickens,278,29861527,96.2395186955,_100,8,>100
8147,zealand,278,29861805,96.2404146506,_100,7,>100
8148,intelligent,278,29862083,96.2413106056,_100,11,>100
8149,smiles,278,29862361,96.2422065607,_100,6,>100
8150,groves,278,29862639,96.2431025158,_100,6,>100
8151,tents,278,29862917,96.2439984708,_100,5,>100
8152,highways,278,29863195,96.2448944259,_100,8,>100
8153,dustin,278,29863473,96.2457903809,_100,6,>100
8154,propose,278,29863751,96.246686336,_100,7,>100
8155,accompanying,278,29864029,96.2475822911,_100,12,>100
8156,marching,278,29864307,96.2484782461,_100,8,>100
8157,grandson,278,29864585,96.2493742012,_100,8,>100
8158,cope,277,29864862,96.2502669334,_100,4,>100
8159,surrendered,277,29865139,96.2511596656,_100,11,>100
8160,mob,277,29865416,96.2520523978,_100,3,>100
8161,contrary,277,29865693,96.25294513,_100,8,>100
8162,prints,277,29865970,96.2538378622,_100,6,>100
8163,agreeing,277,29866247,96.2547305944,_100,8,>100
8164,boyle,277,29866524,96.2556233266,_100,5,>100
8165,cheeses,277,29866801,96.2565160588,_100,7,>100
8166,breach,277,29867078,96.257408791,_100,6,>100
8167,farming,277,29867355,96.2583015232,_100,7,>100
8168,adrian,277,29867632,96.2591942554,_100,6,>100
8169,creatures,277,29867909,96.2600869876,_100,9,>100
8170,tongue,277,29868186,96.2609797198,_100,6,>100
8171,foil,277,29868463,96.261872452,_100,4,>100
8172,postponed,277,29868740,96.2627651842,_100,9,>100
8173,cindy,277,29869017,96.2636579164,_100,5,>100
8174,recipient,277,29869294,96.2645506486,_100,9,>100
8175,servers,277,29869571,96.2654433808,_100,7,>100
8176,carnival,277,29869848,96.266336113,_100,8,>100
8177,trunk,277,29870125,96.2672288452,_100,5,>100
8178,advantages,277,29870402,96.2681215774,_100,10,>100
8179,fraction,277,29870679,96.2690143096,_100,8,>100
8180,hallway,277,29870956,96.2699070418,_100,7,>100
8181,growers,276,29871232,96.2707965511,_100,7,>100
8182,sonoma,276,29871508,96.2716860604,_100,6,>100
8183,mayoral,276,29871784,96.2725755698,_100,7,>100
8184,faithful,276,29872060,96.2734650791,_100,8,>100
8185,fusion,276,29872336,96.2743545885,_100,6,>100
8186,ranger,276,29872612,96.2752440978,_100,6,>100
8187,download,276,29872888,96.2761336071,_100,8,>100
8188,fold,276,29873164,96.2770231165,_100,4,>100
8189,lender,276,29873440,96.2779126258,_100,6,>100
8190,clause,276,29873716,96.2788021352,_100,6,>100
8191,attendees,276,29873992,96.2796916445,_100,9,>100
8192,aroma,276,29874268,96.2805811538,_100,5,>100
8193,objections,276,29874544,96.2814706632,_100,10,>100
8194,minus,275,29874819,96.2823569497,_100,5,>100
8195,appliances,275,29875094,96.2832432361,_100,10,>100
8196,server,275,29875369,96.2841295226,_100,6,>100
8197,debuted,275,29875644,96.2850158091,_100,7,>100
8198,medals,275,29875919,96.2859020956,_100,6,>100
8199,objective,275,29876194,96.2867883821,_100,9,>100
8200,concentration,275,29876469,96.2876746685,_100,13,>100
8201,uaw,275,29876744,96.288560955,_100,3,>100
8202,freshly,275,29877019,96.2894472415,_100,7,>100
8203,expenditures,275,29877294,96.290333528,_100,12,>100
8204,rex,275,29877569,96.2912198145,_100,3,>100
8205,275,275,29877844,96.2921061009,_100,3,>100
8206,absorb,274,29878118,96.2929891646,_100,6,>100
8207,angle,274,29878392,96.2938722282,_100,5,>100
8208,crispy,274,29878666,96.2947552918,_100,6,>100
8209,entrepreneur,274,29878940,96.2956383554,_100,12,>100
8210,revival,274,29879214,96.296521419,_100,7,>100
8211,optional,274,29879488,96.2974044827,_100,8,>100
8212,withdraw,274,29879762,96.2982875463,_100,8,>100
8213,overturn,274,29880036,96.2991706099,_100,8,>100
8214,hbo,274,29880310,96.3000536735,_100,3,>100
8215,stabbing,274,29880584,96.3009367371,_100,8,>100
8216,rosemary,274,29880858,96.3018198007,_100,8,>100
8217,suited,274,29881132,96.3027028644,_100,6,>100
8218,ours,274,29881406,96.303585928,_100,4,>100
8219,staging,274,29881680,96.3044689916,_100,7,>100
8220,simultaneously,274,29881954,96.3053520552,_100,14,>100
8221,peas,274,29882228,96.3062351188,_100,4,>100
8222,weaker,274,29882502,96.3071181825,_100,6,>100
8223,annapolis,274,29882776,96.3080012461,_100,9,>100
8224,infections,274,29883050,96.3088843097,_100,10,>100
8225,payton,274,29883324,96.3097673733,_100,6,>100
8226,tolls,274,29883598,96.3106504369,_100,5,>100
8227,preserved,273,29883871,96.3115302777,_100,9,>100
8228,disappear,273,29884144,96.3124101185,_100,9,>100
8229,emailed,273,29884417,96.3132899592,_100,7,>100
8230,profiling,273,29884690,96.3141698,_100,9,>100
8231,gotta,273,29884963,96.3150496407,_100,5,>100
8232,thrive,273,29885236,96.3159294815,_100,6,>100
8233,marilyn,273,29885509,96.3168093223,_100,7,>100
8234,faa,273,29885782,96.317689163,_100,3,>100
8235,incoming,273,29886055,96.3185690038,_100,8,>100
8236,inherited,273,29886328,96.3194488445,_100,9,>100
8237,abortions,273,29886601,96.3203286853,_100,9,>100
8238,wheeler,273,29886874,96.3212085261,_100,7,>100
8239,shelby,273,29887147,96.3220883668,_100,6,>100
8240,aquarium,273,29887420,96.3229682076,_100,8,>100
8241,contentious,273,29887693,96.3238480483,_100,11,>100
8242,lowering,273,29887966,96.3247278891,_100,8,>100
8243,banker,273,29888239,96.3256077299,_100,6,>100
8244,renovations,273,29888512,96.3264875706,_100,11,>100
8245,boxing,273,29888785,96.3273674114,_100,6,>100
8246,sinking,273,29889058,96.3282472521,_100,7,>100
8247,secretly,273,29889331,96.3291270929,_100,8,>100
8248,mud,272,29889603,96.3300037108,_100,3,>100
8249,rounded,272,29889875,96.3308803287,_100,7,>100
8250,portugal,272,29890147,96.3317569466,_100,8,>100
8251,spell,272,29890419,96.3326335645,_100,5,>100
8252,pros,272,29890691,96.3335101824,_100,4,>100
8253,elevator,272,29890963,96.3343868003,_100,8,>100
8254,residency,272,29891235,96.3352634182,_100,9,>100
8255,berth,272,29891507,96.3361400361,_100,5,>100
8256,upward,272,29891779,96.337016654,_100,6,>100
8257,caller,272,29892051,96.3378932719,_100,6,>100
8258,endangered,272,29892323,96.3387698898,_100,10,>100
8259,revive,272,29892595,96.3396465077,_100,6,>100
8260,emma,272,29892867,96.3405231256,_100,4,>100
8261,crunch,272,29893139,96.3413997435,_100,6,>100
8262,celebrates,272,29893411,96.3422763614,_100,10,>100
8263,scrap,272,29893683,96.3431529793,_100,5,>100
8264,triumph,272,29893955,96.3440295972,_100,7,>100
8265,caroline,272,29894227,96.3449062151,_100,8,>100
8266,comcast,272,29894499,96.345782833,_100,7,>100
8267,caf,272,29894771,96.3466594509,_100,3,>100
8268,abraham,272,29895043,96.3475360688,_100,7,>100
8269,benchmark,272,29895315,96.3484126867,_100,9,>100
8270,boosting,271,29895586,96.3492860817,_100,8,>100
8271,consists,271,29895857,96.3501594768,_100,8,>100
8272,midtown,271,29896128,96.3510328718,_100,7,>100
8273,santiago,271,29896399,96.3519062669,_100,8,>100
8274,survivor,271,29896670,96.3527796619,_100,8,>100
8275,sheila,271,29896941,96.3536530569,_100,6,>100
8276,pew,271,29897212,96.354526452,_100,3,>100
8277,translate,271,29897483,96.355399847,_100,9,>100
8278,rib,271,29897754,96.3562732421,_100,3,>100
8279,hug,271,29898025,96.3571466371,_100,3,>100
8280,naked,271,29898296,96.3580200321,_100,5,>100
8281,apparel,271,29898567,96.3588934272,_100,7,>100
8282,airplane,271,29898838,96.3597668222,_100,8,>100
8283,boot,271,29899109,96.3606402173,_100,4,>100
8284,dancer,271,29899380,96.3615136123,_100,6,>100
8285,pairing,271,29899651,96.3623870073,_100,7,>100
8286,recognizes,271,29899922,96.3632604024,_100,10,>100
8287,leaning,271,29900193,96.3641337974,_100,7,>100
8288,blair,271,29900464,96.3650071925,_100,5,>100
8289,informant,271,29900735,96.3658805875,_100,9,>100
8290,wow,271,29901006,96.3667539825,_100,3,>100
8291,basics,271,29901277,96.3676273776,_100,6,>100
8292,slashed,271,29901548,96.3685007726,_100,7,>100
8293,specialists,271,29901819,96.3693741677,_100,11,>100
8294,hawkins,271,29902090,96.3702475627,_100,7,>100
8295,retained,271,29902361,96.3711209577,_100,8,>100
8296,hacking,271,29902632,96.3719943528,_100,7,>100
8297,meadowlands,271,29902903,96.3728677478,_100,11,>100
8298,drafting,271,29903174,96.3737411429,_100,8,>100
8299,wineries,271,29903445,96.3746145379,_100,8,>100
8300,verbal,271,29903716,96.3754879329,_100,6,>100
8301,chops,271,29903987,96.376361328,_100,5,>100
8302,ltd,270,29904257,96.3772315002,_100,3,>100
8303,genius,270,29904527,96.3781016723,_100,6,>100
8304,measuring,270,29904797,96.3789718445,_100,9,>100
8305,portable,270,29905067,96.3798420167,_100,8,>100
8306,demolition,270,29905337,96.3807121889,_100,10,>100
8307,kaplan,270,29905607,96.3815823611,_100,6,>100
8308,tab,270,29905877,96.3824525332,_100,3,>100
8309,slaying,270,29906147,96.3833227054,_100,7,>100
8310,mounted,270,29906417,96.3841928776,_100,7,>100
8311,fullerton,270,29906687,96.3850630498,_100,9,>100
8312,pad,270,29906957,96.385933222,_100,3,>100
8313,podium,270,29907227,96.3868033941,_100,6,>100
8314,combinations,270,29907497,96.3876735663,_100,12,>100
8315,surgical,270,29907767,96.3885437385,_100,8,>100
8316,beltran,270,29908037,96.3894139107,_100,7,>100
8317,cb,270,29908307,96.3902840829,_100,2,>100
8318,mariners,270,29908577,96.391154255,_100,8,>100
8319,staple,270,29908847,96.3920244272,_100,6,>100
8320,underway,270,29909117,96.3928945994,_100,8,>100
8321,270,270,29909387,96.3937647716,_100,3,>100
8322,lindsay,270,29909657,96.3946349438,_100,7,>100
8323,vessels,270,29909927,96.3955051159,_100,7,>100
8324,openings,270,29910197,96.3963752881,_100,8,>100
8325,marker,270,29910467,96.3972454603,_100,6,>100
8326,commissioned,270,29910737,96.3981156325,_100,12,>100
8327,moran,269,29911006,96.3989825818,_100,5,>100
8328,fowler,269,29911275,96.3998495311,_100,6,>100
8329,serial,269,29911544,96.4007164804,_100,6,>100
8330,reunion,269,29911813,96.4015834298,_100,7,>100
8331,bolster,269,29912082,96.4024503791,_100,7,>100
8332,libya,269,29912351,96.4033173284,_100,5,>100
8333,cautioned,269,29912620,96.4041842777,_100,9,>100
8334,afc,269,29912889,96.405051227,_100,3,>100
8335,batted,269,29913158,96.4059181764,_100,6,>100
8336,pearce,269,29913427,96.4067851257,_100,6,>100
8337,declaring,269,29913696,96.407652075,_100,9,>100
8338,processor,269,29913965,96.4085190243,_100,9,>100
8339,honoring,269,29914234,96.4093859736,_100,8,>100
8340,incorporated,269,29914503,96.410252923,_100,12,>100
8341,considerably,269,29914772,96.4111198723,_100,12,>100
8342,smashed,269,29915041,96.4119868216,_100,7,>100
8343,canned,269,29915310,96.4128537709,_100,6,>100
8344,crops,269,29915579,96.4137207202,_100,5,>100
8345,interpretation,269,29915848,96.4145876696,_100,14,>100
8346,forwards,268,29916116,96.415451396,_100,8,>100
8347,harold,268,29916384,96.4163151225,_100,6,>100
8348,ritual,268,29916652,96.4171788489,_100,6,>100
8349,missions,268,29916920,96.4180425754,_100,8,>100
8350,jeep,268,29917188,96.4189063019,_100,4,>100
8351,ot,268,29917456,96.4197700283,_100,2,>100
8352,beverages,268,29917724,96.4206337548,_100,9,>100
8353,outrageous,268,29917992,96.4214974812,_100,10,>100
8354,crane,268,29918260,96.4223612077,_100,5,>100
8355,respects,268,29918528,96.4232249342,_100,8,>100
8356,soy,268,29918796,96.4240886606,_100,3,>100
8357,ivy,268,29919064,96.4249523871,_100,3,>100
8358,pike,268,29919332,96.4258161135,_100,4,>100
8359,gabriel,268,29919600,96.42667984,_100,7,>100
8360,distraction,268,29919868,96.4275435665,_100,11,>100
8361,savvy,268,29920136,96.4284072929,_100,5,>100
8362,hammond,268,29920404,96.4292710194,_100,7,>100
8363,starbucks,268,29920672,96.4301347458,_100,9,>100
8364,cigarettes,268,29920940,96.4309984723,_100,10,>100
8365,installing,268,29921208,96.4318621988,_100,10,>100
8366,tally,268,29921476,96.4327259252,_100,5,>100
8367,approving,268,29921744,96.4335896517,_100,9,>100
8368,enters,268,29922012,96.4344533781,_100,6,>100
8369,streams,268,29922280,96.4353171046,_100,7,>100
8370,lautenberg,268,29922548,96.4361808311,_100,10,>100
8371,pelosi,268,29922816,96.4370445575,_100,6,>100
8372,seahawks,267,29923083,96.4379050611,_100,8,>100
8373,fixing,267,29923350,96.4387655647,_100,6,>100
8374,surfaced,267,29923617,96.4396260683,_100,8,>100
8375,cnn,267,29923884,96.4404865719,_100,3,>100
8376,fannie,267,29924151,96.4413470755,_100,6,>100
8377,indicating,267,29924418,96.4422075791,_100,10,>100
8378,stats,267,29924685,96.4430680827,_100,5,>100
8379,daunting,267,29924952,96.4439285863,_100,8,>100
8380,appetizer,267,29925219,96.4447890899,_100,9,>100
8381,terrain,267,29925486,96.4456495935,_100,7,>100
8382,creator,267,29925753,96.4465100971,_100,7,>100
8383,stamps,267,29926020,96.4473706007,_100,6,>100
8384,subway,267,29926287,96.4482311043,_100,6,>100
8385,unacceptable,267,29926554,96.4490916079,_100,12,>100
8386,marriages,267,29926821,96.4499521115,_100,9,>100
8387,slate,266,29927087,96.4508093923,_100,5,>100
8388,imperial,266,29927353,96.451666673,_100,8,>100
8389,recordings,266,29927619,96.4525239537,_100,10,>100
8390,trump,266,29927885,96.4533812345,_100,5,>100
8391,rows,266,29928151,96.4542385152,_100,4,>100
8392,credible,266,29928417,96.455095796,_100,8,>100
8393,satisfaction,266,29928683,96.4559530767,_100,12,>100
8394,elder,266,29928949,96.4568103574,_100,5,>100
8395,archdiocese,266,29929215,96.4576676382,_100,11,>100
8396,likewise,266,29929481,96.4585249189,_100,8,>100
8397,quartet,266,29929747,96.4593821997,_100,7,>100
8398,bart,266,29930013,96.4602394804,_100,4,>100
8399,pianist,266,29930279,96.4610967611,_100,7,>100
8400,argentina,266,29930545,96.4619540419,_100,9,>100
8401,peggy,266,29930811,96.4628113226,_100,5,>100
8402,cherokee,266,29931077,96.4636686034,_100,8,>100
8403,feat,265,29931342,96.4645226612,_100,4,>100
8404,conn,265,29931607,96.4653767191,_100,4,>100
8405,alec,265,29931872,96.466230777,_100,4,>100
8406,gangs,265,29932137,96.4670848349,_100,5,>100
8407,acquisitions,265,29932402,96.4679388928,_100,12,>100
8408,plains,265,29932667,96.4687929507,_100,6,>100
8409,weakest,265,29932932,96.4696470085,_100,7,>100
8410,bengals,265,29933197,96.4705010664,_100,7,>100
8411,salazar,265,29933462,96.4713551243,_100,7,>100
8412,heisman,265,29933727,96.4722091822,_100,7,>100
8413,jesuit,265,29933992,96.4730632401,_100,6,>100
8414,vertical,265,29934257,96.4739172979,_100,8,>100
8415,rewarded,265,29934522,96.4747713558,_100,8,>100
8416,outgoing,265,29934787,96.4756254137,_100,8,>100
8417,outfit,265,29935052,96.4764794716,_100,6,>100
8418,prescribed,265,29935317,96.4773335295,_100,10,>100
8419,demographic,265,29935582,96.4781875873,_100,11,>100
8420,pin,265,29935847,96.4790416452,_100,3,>100
8421,keller,265,29936112,96.4798957031,_100,6,>100
8422,puzzle,265,29936377,96.480749761,_100,6,>100
8423,poe,265,29936642,96.4816038189,_100,3,>100
8424,fumble,264,29936906,96.4824546539,_100,6,>100
8425,dump,264,29937170,96.4833054889,_100,4,>100
8426,csu,264,29937434,96.4841563239,_100,3,>100
8427,denies,264,29937698,96.4850071589,_100,6,>100
8428,undefeated,264,29937962,96.485857994,_100,10,>100
8429,defenses,264,29938226,96.486708829,_100,8,>100
8430,centuries,264,29938490,96.487559664,_100,9,>100
8431,moscow,264,29938754,96.488410499,_100,6,>100
8432,threshold,264,29939018,96.489261334,_100,9,>100
8433,brodeur,264,29939282,96.4901121691,_100,7,>100
8434,inexpensive,264,29939546,96.4909630041,_100,11,>100
8435,complement,264,29939810,96.4918138391,_100,10,>100
8436,shepherd,264,29940074,96.4926646741,_100,8,>100
8437,drawings,264,29940338,96.4935155091,_100,8,>100
8438,dominic,264,29940602,96.4943663442,_100,7,>100
8439,fraudulent,264,29940866,96.4952171792,_100,10,>100
8440,technically,264,29941130,96.4960680142,_100,11,>100
8441,bothered,264,29941394,96.4969188492,_100,8,>100
8442,alton,264,29941658,96.4977696842,_100,5,>100
8443,strokes,264,29941922,96.4986205193,_100,7,>100
8444,sachs,264,29942186,96.4994713543,_100,5,>100
8445,cleaned,264,29942450,96.5003221893,_100,7,>100
8446,woody,264,29942714,96.5011730243,_100,5,>100
8447,powerhouse,263,29942977,96.5020206365,_100,10,>100
8448,replaces,263,29943240,96.5028682486,_100,8,>100
8449,sterling,263,29943503,96.5037158608,_100,8,>100
8450,wary,263,29943766,96.504563473,_100,4,>100
8451,enduring,263,29944029,96.5054110851,_100,8,>100
8452,finalist,263,29944292,96.5062586973,_100,8,>100
8453,congregation,263,29944555,96.5071063095,_100,12,>100
8454,youngsters,263,29944818,96.5079539216,_100,10,>100
8455,marty,263,29945081,96.5088015338,_100,5,>100
8456,sting,263,29945344,96.5096491459,_100,5,>100
8457,oyster,263,29945607,96.5104967581,_100,6,>100
8458,mueller,263,29945870,96.5113443703,_100,7,>100
8459,worship,263,29946133,96.5121919824,_100,7,>100
8460,jumps,263,29946396,96.5130395946,_100,5,>100
8461,gunman,263,29946659,96.5138872067,_100,6,>100
8462,predictable,262,29946921,96.514731596,_100,11,>100
8463,pressures,262,29947183,96.5155759853,_100,9,>100
8464,thumb,262,29947445,96.5164203746,_100,5,>100
8465,intensive,262,29947707,96.5172647639,_100,9,>100
8466,ind,262,29947969,96.5181091532,_100,3,>100
8467,kemp,262,29948231,96.5189535425,_100,4,>100
8468,dug,262,29948493,96.5197979318,_100,3,>100
8469,vault,262,29948755,96.5206423211,_100,5,>100
8470,vietnamese,262,29949017,96.5214867104,_100,10,>100
8471,claire,262,29949279,96.5223310997,_100,6,>100
8472,bracket,262,29949541,96.523175489,_100,7,>100
8473,ranged,262,29949803,96.5240198783,_100,6,>100
8474,tacos,262,29950065,96.5248642676,_100,5,>100
8475,psychiatric,262,29950327,96.5257086569,_100,11,>100
8476,berries,262,29950589,96.5265530462,_100,7,>100
8477,grizzlies,262,29950851,96.5273974355,_100,9,>100
8478,rosen,262,29951113,96.5282418248,_100,5,>100
8479,mate,262,29951375,96.5290862141,_100,4,>100
8480,rodney,262,29951637,96.5299306034,_100,6,>100
8481,champ,262,29951899,96.5307749927,_100,5,>100
8482,woke,262,29952161,96.531619382,_100,4,>100
8483,academics,262,29952423,96.5324637713,_100,9,>100
8484,augusta,262,29952685,96.5333081606,_100,7,>100
8485,bucket,261,29952946,96.5341493271,_100,6,>100
8486,vatican,261,29953207,96.5349904935,_100,7,>100
8487,proximity,261,29953468,96.53583166,_100,9,>100
8488,trimmed,261,29953729,96.5366728264,_100,7,>100
8489,herman,261,29953990,96.5375139929,_100,6,>100
8490,narrowly,261,29954251,96.5383551593,_100,8,>100
8491,stemming,261,29954512,96.5391963257,_100,8,>100
8492,bent,261,29954773,96.5400374922,_100,4,>100
8493,liberties,261,29955034,96.5408786586,_100,9,>100
8494,posing,261,29955295,96.5417198251,_100,6,>100
8495,battered,261,29955556,96.5425609915,_100,8,>100
8496,olives,261,29955817,96.5434021579,_100,6,>100
8497,batch,261,29956078,96.5442433244,_100,5,>100
8498,hefty,261,29956339,96.5450844908,_100,5,>100
8499,appoint,261,29956600,96.5459256573,_100,7,>100
8500,ignoring,261,29956861,96.5467668237,_100,8,>100
8501,undergoing,261,29957122,96.5476079901,_100,10,>100
8502,flows,261,29957383,96.5484491566,_100,5,>100
8503,missile,261,29957644,96.549290323,_100,7,>100
8504,manuel,261,29957905,96.5501314895,_100,6,>100
8505,lend,261,29958166,96.5509726559,_100,4,>100
8506,tribal,261,29958427,96.5518138223,_100,6,>100
8507,adaptation,261,29958688,96.5526549888,_100,10,>100
8508,zucchini,260,29958948,96.5534929324,_100,8,>100
8509,yankee,260,29959208,96.5543308759,_100,6,>100
8510,settling,260,29959468,96.5551688195,_100,8,>100
8511,seller,260,29959728,96.5560067631,_100,6,>100
8512,shelf,260,29959988,96.5568447067,_100,5,>100
8513,workshops,260,29960248,96.5576826503,_100,9,>100
8514,jaguars,260,29960508,96.5585205938,_100,7,>100
8515,diana,260,29960768,96.5593585374,_100,5,>100
8516,oysters,260,29961028,96.560196481,_100,7,>100
8517,pakistani,260,29961288,96.5610344246,_100,9,>100
8518,laps,260,29961548,96.5618723682,_100,4,>100
8519,sights,260,29961808,96.5627103118,_100,6,>100
8520,usage,260,29962068,96.5635482553,_100,5,>100
8521,bulldogs,260,29962328,96.5643861989,_100,8,>100
8522,envisioned,260,29962588,96.5652241425,_100,10,>100
8523,marco,260,29962848,96.5660620861,_100,5,>100
8524,publish,260,29963108,96.5669000297,_100,7,>100
8525,implementation,260,29963368,96.5677379732,_100,14,>100
8526,repaired,260,29963628,96.5685759168,_100,8,>100
8527,260,260,29963888,96.5694138604,_100,3,>100
8528,dependent,260,29964148,96.570251804,_100,9,>100
8529,wraps,260,29964408,96.5710897476,_100,5,>100
8530,abbott,260,29964668,96.5719276911,_100,6,>100
8531,durant,260,29964928,96.5727656347,_100,6,>100
8532,suzanne,260,29965188,96.5736035783,_100,7,>100
8533,bayonne,259,29965447,96.574438299,_100,7,>100
8534,laurel,259,29965706,96.5752730197,_100,6,>100
8535,urgent,259,29965965,96.5761077405,_100,6,>100
8536,manual,259,29966224,96.5769424612,_100,6,>100
8537,braised,259,29966483,96.5777771819,_100,7,>100
8538,halls,259,29966742,96.5786119026,_100,5,>100
8539,cheers,259,29967001,96.5794466233,_100,6,>100
8540,renowned,259,29967260,96.5802813441,_100,8,>100
8541,figuring,259,29967519,96.5811160648,_100,8,>100
8542,clue,259,29967778,96.5819507855,_100,4,>100
8543,wished,259,29968037,96.5827855062,_100,6,>100
8544,additions,259,29968296,96.583620227,_100,9,>100
8545,celery,259,29968555,96.5844549477,_100,6,>100
8546,chardonnay,259,29968814,96.5852896684,_100,10,>100
8547,nl,259,29969073,96.5861243891,_100,2,>100
8548,tyson,259,29969332,96.5869591098,_100,5,>100
8549,infected,259,29969591,96.5877938306,_100,8,>100
8550,ky,259,29969850,96.5886285513,_100,2,>100
8551,wiped,259,29970109,96.589463272,_100,5,>100
8552,stamp,259,29970368,96.5902979927,_100,5,>100
8553,roadway,258,29970626,96.5911294906,_100,7,>100
8554,nearest,258,29970884,96.5919609884,_100,7,>100
8555,outscored,258,29971142,96.5927924863,_100,9,>100
8556,withdrew,258,29971400,96.5936239842,_100,8,>100
8557,athleticism,258,29971658,96.594455482,_100,11,>100
8558,slid,258,29971916,96.5952869799,_100,4,>100
8559,luggage,258,29972174,96.5961184777,_100,7,>100
8560,uncommon,258,29972432,96.5969499756,_100,8,>100
8561,runoff,258,29972690,96.5977814735,_100,6,>100
8562,caramel,258,29972948,96.5986129713,_100,7,>100
8563,adapt,258,29973206,96.5994444692,_100,5,>100
8564,layoff,258,29973464,96.600275967,_100,6,>100
8565,microphone,258,29973722,96.6011074649,_100,10,>100
8566,biological,258,29973980,96.6019389628,_100,10,>100
8567,ample,258,29974238,96.6027704606,_100,5,>100
8568,decreased,258,29974496,96.6036019585,_100,9,>100
8569,balfour,258,29974754,96.6044334564,_100,7,>100
8570,treasure,258,29975012,96.6052649542,_100,8,>100
8571,frost,258,29975270,96.6060964521,_100,5,>100
8572,accuracy,258,29975528,96.6069279499,_100,8,>100
8573,cage,258,29975786,96.6077594478,_100,4,>100
8574,lesbian,257,29976043,96.6085877228,_100,7,>100
8575,overlooked,257,29976300,96.6094159978,_100,10,>100
8576,ladue,257,29976557,96.6102442728,_100,5,>100
8577,sustainability,257,29976814,96.6110725478,_100,14,>100
8578,gardening,257,29977071,96.6119008228,_100,9,>100
8579,doyle,257,29977328,96.6127290978,_100,5,>100
8580,contraception,257,29977585,96.6135573728,_100,13,>100
8581,fighters,257,29977842,96.6143856478,_100,8,>100
8582,gutierrez,257,29978099,96.6152139228,_100,9,>100
8583,prefers,257,29978356,96.6160421978,_100,7,>100
8584,milestone,257,29978613,96.6168704728,_100,9,>100
8585,ventures,257,29978870,96.6176987478,_100,8,>100
8586,fabulous,257,29979127,96.6185270228,_100,8,>100
8587,stack,257,29979384,96.6193552978,_100,5,>100
8588,representation,257,29979641,96.6201835728,_100,14,>100
8589,individually,256,29979897,96.621008625,_100,12,>100
8590,mars,256,29980153,96.6218336771,_100,4,>100
8591,ceremonies,256,29980409,96.6226587292,_100,10,>100
8592,burroughs,256,29980665,96.6234837814,_100,9,>100
8593,fatigue,256,29980921,96.6243088335,_100,7,>100
8594,camino,256,29981177,96.6251338857,_100,6,>100
8595,segments,256,29981433,96.6259589378,_100,8,>100
8596,sutter,256,29981689,96.6267839899,_100,6,>100
8597,vermont,256,29981945,96.6276090421,_100,7,>100
8598,sequence,256,29982201,96.6284340942,_100,8,>100
8599,dividends,256,29982457,96.6292591464,_100,9,>100
8600,receipts,256,29982713,96.6300841985,_100,8,>100
8601,centre,256,29982969,96.6309092506,_100,6,>100
8602,batteries,256,29983225,96.6317343028,_100,9,>100
8603,respective,256,29983481,96.6325593549,_100,10,>100
8604,stating,256,29983737,96.6333844071,_100,7,>100
8605,log,255,29983992,96.6342062363,_100,3,>100
8606,slept,255,29984247,96.6350280656,_100,5,>100
8607,prohibits,255,29984502,96.6358498949,_100,9,>100
8608,spinning,255,29984757,96.6366717242,_100,8,>100
8609,breakthrough,255,29985012,96.6374935535,_100,12,>100
8610,abuses,255,29985267,96.6383153828,_100,6,>100
8611,vendor,255,29985522,96.639137212,_100,6,>100
8612,semester,255,29985777,96.6399590413,_100,8,>100
8613,spy,255,29986032,96.6407808706,_100,3,>100
8614,harmful,255,29986287,96.6416026999,_100,7,>100
8615,kit,255,29986542,96.6424245292,_100,3,>100
8616,kristen,255,29986797,96.6432463584,_100,7,>100
8617,shiny,255,29987052,96.6440681877,_100,5,>100
8618,blanc,255,29987307,96.644890017,_100,5,>100
8619,rudy,255,29987562,96.6457118463,_100,4,>100
8620,offender,255,29987817,96.6465336756,_100,8,>100
8621,mushroom,255,29988072,96.6473555048,_100,8,>100
8622,readily,254,29988326,96.6481741113,_100,7,>100
8623,persuaded,254,29988580,96.6489927177,_100,9,>100
8624,ventura,254,29988834,96.6498113241,_100,7,>100
8625,fills,254,29989088,96.6506299305,_100,5,>100
8626,kerry,254,29989342,96.651448537,_100,5,>100
8627,commentary,254,29989596,96.6522671434,_100,10,>100
8628,asthma,254,29989850,96.6530857498,_100,6,>100
8629,carved,254,29990104,96.6539043562,_100,6,>100
8630,vince,254,29990358,96.6547229626,_100,5,>100
8631,objected,254,29990612,96.6555415691,_100,8,>100
8632,ethical,254,29990866,96.6563601755,_100,7,>100
8633,hollow,254,29991120,96.6571787819,_100,6,>100
8634,gasol,254,29991374,96.6579973883,_100,5,>100
8635,promotes,254,29991628,96.6588159947,_100,8,>100
8636,justified,254,29991882,96.6596346012,_100,9,>100
8637,darkness,254,29992136,96.6604532076,_100,8,>100
8638,contested,254,29992390,96.661271814,_100,9,>100
8639,famously,254,29992644,96.6620904204,_100,8,>100
8640,vague,254,29992898,96.6629090269,_100,5,>100
8641,altered,254,29993152,96.6637276333,_100,7,>100
8642,kan,254,29993406,96.6645462397,_100,3,>100
8643,cho,253,29993659,96.6653616233,_100,3,>100
8644,grid,253,29993912,96.6661770068,_100,4,>100
8645,rapids,253,29994165,96.6669923904,_100,6,>100
8646,oxford,253,29994418,96.6678077739,_100,6,>100
8647,washed,253,29994671,96.6686231575,_100,6,>100
8648,lover,253,29994924,96.6694385411,_100,5,>100
8649,conway,253,29995177,96.6702539246,_100,6,>100
8650,combining,253,29995430,96.6710693082,_100,9,>100
8651,ricky,253,29995683,96.6718846917,_100,5,>100
8652,stacked,253,29995936,96.6727000753,_100,7,>100
8653,subsequently,253,29996189,96.6735154589,_100,12,>100
8654,mold,253,29996442,96.6743308424,_100,4,>100
8655,clooney,253,29996695,96.675146226,_100,7,>100
8656,parsley,253,29996948,96.6759616096,_100,7,>100
8657,les,253,29997201,96.6767769931,_100,3,>100
8658,flooded,253,29997454,96.6775923767,_100,7,>100
8659,startup,253,29997707,96.6784077602,_100,7,>100
8660,blacks,253,29997960,96.6792231438,_100,6,>100
8661,forgot,253,29998213,96.6800385274,_100,6,>100
8662,professors,253,29998466,96.6808539109,_100,10,>100
8663,reflecting,253,29998719,96.6816692945,_100,10,>100
8664,towel,253,29998972,96.682484678,_100,5,>100
8665,patrols,253,29999225,96.6833000616,_100,7,>100
8666,synthetic,252,29999477,96.6841122223,_100,9,>100
8667,bmw,252,29999729,96.684924383,_100,3,>100
8668,volunteered,252,29999981,96.6857365437,_100,11,>100
8669,ipod,252,30000233,96.6865487044,_100,4,>100
8670,gill,252,30000485,96.6873608651,_100,4,>100
8671,moist,252,30000737,96.6881730258,_100,5,>100
8672,execute,252,30000989,96.6889851865,_100,7,>100
8673,dispatched,252,30001241,96.6897973472,_100,10,>100
8674,strongsville,252,30001493,96.6906095079,_100,12,>100
8675,upgraded,252,30001745,96.6914216686,_100,8,>100
8676,jo,252,30001997,96.6922338293,_100,2,>100
8677,vinaigrette,252,30002249,96.69304599,_100,11,>100
8678,cab,252,30002501,96.6938581507,_100,3,>100
8679,thursdays,252,30002753,96.6946703114,_100,9,>100
8680,selecting,252,30003005,96.6954824721,_100,9,>100
8681,whopping,252,30003257,96.6962946328,_100,8,>100
8682,winding,251,30003508,96.6971035707,_100,7,>100
8683,endorse,251,30003759,96.6979125085,_100,7,>100
8684,poet,251,30004010,96.6987214463,_100,4,>100
8685,reiterated,251,30004261,96.6995303842,_100,10,>100
8686,scenic,251,30004512,96.700339322,_100,6,>100
8687,pause,251,30004763,96.7011482599,_100,5,>100
8688,billionaire,251,30005014,96.7019571977,_100,11,>100
8689,rancho,251,30005265,96.7027661356,_100,6,>100
8690,felton,251,30005516,96.7035750734,_100,6,>100
8691,blasted,251,30005767,96.7043840112,_100,7,>100
8692,halted,251,30006018,96.7051929491,_100,6,>100
8693,tense,251,30006269,96.7060018869,_100,5,>100
8694,complexity,251,30006520,96.7068108248,_100,10,>100
8695,vivid,251,30006771,96.7076197626,_100,5,>100
8696,tuesdays,251,30007022,96.7084287004,_100,8,>100
8697,solon,251,30007273,96.7092376383,_100,5,>100
8698,lambert,251,30007524,96.7100465761,_100,7,>100
8699,restoring,251,30007775,96.710855514,_100,9,>100
8700,westbound,251,30008026,96.7116644518,_100,9,>100
8701,coveted,250,30008276,96.7124701668,_100,7,>100
8702,energetic,250,30008526,96.7132758818,_100,9,>100
8703,advancing,250,30008776,96.7140815968,_100,9,>100
8704,cougars,250,30009026,96.7148873117,_100,7,>100
8705,landscaping,250,30009276,96.7156930267,_100,11,>100
8706,hanson,250,30009526,96.7164987417,_100,6,>100
8707,miracle,250,30009776,96.7173044567,_100,7,>100
8708,reggie,250,30010026,96.7181101717,_100,6,>100
8709,fulfill,250,30010276,96.7189158866,_100,7,>100
8710,stylish,250,30010526,96.7197216016,_100,7,>100
8711,dreamed,250,30010776,96.7205273166,_100,7,>100
8712,rosa,250,30011026,96.7213330316,_100,4,>100
8713,queens,250,30011276,96.7221387466,_100,6,>100
8714,surrender,250,30011526,96.7229444616,_100,9,>100
8715,inconsistent,250,30011776,96.7237501765,_100,12,>100
8716,vegan,250,30012026,96.7245558915,_100,5,>100
8717,250,250,30012276,96.7253616065,_100,3,>100
8718,personalities,250,30012526,96.7261673215,_100,13,>100
8719,shrink,250,30012776,96.7269730365,_100,6,>100
8720,texting,250,30013026,96.7277787514,_100,7,>100
8721,ballard,250,30013276,96.7285844664,_100,7,>100
8722,sensation,250,30013526,96.7293901814,_100,9,>100
8723,contaminated,250,30013776,96.7301958964,_100,12,>100
8724,milwaukie,250,30014026,96.7310016114,_100,9,>100
8725,paste,250,30014276,96.7318073263,_100,5,>100
8726,shirley,250,30014526,96.7326130413,_100,7,>100
8727,equality,250,30014776,96.7334187563,_100,8,>100
8728,drained,250,30015026,96.7342244713,_100,7,>100
8729,ramon,250,30015276,96.7350301863,_100,5,>100
8730,securing,250,30015526,96.7358359013,_100,8,>100
8731,meter,250,30015776,96.7366416162,_100,5,>100
8732,sewage,250,30016026,96.7374473312,_100,6,>100
8733,coordinated,249,30016275,96.7382498233,_100,11,>100
8734,nonpartisan,249,30016524,96.7390523155,_100,11,>100
8735,becker,249,30016773,96.7398548076,_100,6,>100
8736,prairie,249,30017022,96.7406572997,_100,7,>100
8737,yale,249,30017271,96.7414597918,_100,4,>100
8738,busiest,249,30017520,96.7422622839,_100,7,>100
8739,aiming,249,30017769,96.7430647761,_100,6,>100
8740,pharmaceutical,249,30018018,96.7438672682,_100,14,>100
8741,stationed,249,30018267,96.7446697603,_100,9,>100
8742,diesel,249,30018516,96.7454722524,_100,6,>100
8743,darren,249,30018765,96.7462747446,_100,6,>100
8744,fiery,249,30019014,96.7470772367,_100,5,>100
8745,formidable,249,30019263,96.7478797288,_100,10,>100
8746,homered,249,30019512,96.7486822209,_100,7,>100
8747,threatens,249,30019761,96.749484713,_100,9,>100
8748,edged,249,30020010,96.7502872052,_100,5,>100
8749,brazilian,249,30020259,96.7510896973,_100,9,>100
8750,exhausted,249,30020508,96.7518921894,_100,9,>100
8751,accomplishment,249,30020757,96.7526946815,_100,14,>100
8752,kane,249,30021006,96.7534971736,_100,4,>100
8753,ipads,249,30021255,96.7542996658,_100,5,>100
8754,ficano,249,30021504,96.7551021579,_100,6,>100
8755,goodbye,249,30021753,96.75590465,_100,7,>100
8756,sailing,249,30022002,96.7567071421,_100,7,>100
8757,positioned,249,30022251,96.7575096343,_100,10,>100
8758,sunrise,248,30022499,96.7583089035,_100,7,>100
8759,versatile,248,30022747,96.7591081728,_100,9,>100
8760,sluggish,248,30022995,96.759907442,_100,8,>100
8761,voiced,248,30023243,96.7607067113,_100,6,>100
8762,sally,248,30023491,96.7615059806,_100,5,>100
8763,watches,248,30023739,96.7623052498,_100,7,>100
8764,brave,248,30023987,96.7631045191,_100,5,>100
8765,regulars,248,30024235,96.7639037883,_100,8,>100
8766,sony,248,30024483,96.7647030576,_100,4,>100
8767,flies,248,30024731,96.7655023269,_100,5,>100
8768,peeled,248,30024979,96.7663015961,_100,6,>100
8769,annie,248,30025227,96.7671008654,_100,5,>100
8770,shea,248,30025475,96.7679001347,_100,4,>100
8771,bon,248,30025723,96.7686994039,_100,3,>100
8772,gesture,248,30025971,96.7694986732,_100,7,>100
8773,suing,248,30026219,96.7702979424,_100,5,>100
8774,rico,248,30026467,96.7710972117,_100,4,>100
8775,federally,248,30026715,96.771896481,_100,9,>100
8776,commuter,248,30026963,96.7726957502,_100,8,>100
8777,tina,248,30027211,96.7734950195,_100,4,>100
8778,baggage,248,30027459,96.7742942888,_100,7,>100
8779,scripts,248,30027707,96.775093558,_100,7,>100
8780,candles,248,30027955,96.7758928273,_100,7,>100
8781,islam,248,30028203,96.7766920965,_100,5,>100
8782,oscars,248,30028451,96.7774913658,_100,6,>100
8783,interact,248,30028699,96.7782906351,_100,8,>100
8784,cooperating,247,30028946,96.7790866815,_100,11,>100
8785,catholics,247,30029193,96.7798827279,_100,9,>100
8786,preserving,247,30029440,96.7806787743,_100,10,>100
8787,looming,247,30029687,96.7814748207,_100,7,>100
8788,appellate,247,30029934,96.7822708671,_100,9,>100
8789,economically,247,30030181,96.7830669135,_100,12,>100
8790,straightforward,247,30030428,96.7838629599,_100,15,>100
8791,solomon,247,30030675,96.7846590063,_100,7,>100
8792,strings,247,30030922,96.7854550527,_100,7,>100
8793,instrumental,247,30031169,96.7862510991,_100,12,>100
8794,wi,247,30031416,96.7870471455,_100,2,>100
8795,marriott,247,30031663,96.7878431919,_100,8,>100
8796,kiss,247,30031910,96.7886392383,_100,4,>100
8797,bernie,247,30032157,96.7894352847,_100,6,>100
8798,supermarket,247,30032404,96.7902313311,_100,11,>100
8799,digging,247,30032651,96.7910273775,_100,7,>100
8800,tricks,247,30032898,96.7918234239,_100,6,>100
8801,substances,247,30033145,96.7926194703,_100,10,>100
8802,thailand,247,30033392,96.7934155167,_100,8,>100
8803,accommodations,247,30033639,96.7942115631,_100,14,>100
8804,cheered,247,30033886,96.7950076095,_100,7,>100
8805,crackdown,247,30034133,96.7958036559,_100,9,>100
8806,fractured,247,30034380,96.7965997023,_100,9,>100
8807,relays,246,30034626,96.7973925258,_100,6,>100
8808,starred,246,30034872,96.7981853494,_100,7,>100
8809,platter,246,30035118,96.7989781729,_100,7,>100
8810,operational,246,30035364,96.7997709965,_100,11,>100
8811,parallel,246,30035610,96.80056382,_100,8,>100
8812,signaled,246,30035856,96.8013566435,_100,8,>100
8813,rupp,246,30036102,96.8021494671,_100,4,>100
8814,persistent,246,30036348,96.8029422906,_100,10,>100
8815,quo,246,30036594,96.8037351142,_100,3,>100
8816,sauvignon,246,30036840,96.8045279377,_100,9,>100
8817,cruze,246,30037086,96.8053207613,_100,5,>100
8818,calipari,246,30037332,96.8061135848,_100,8,>100
8819,tequila,246,30037578,96.8069064083,_100,7,>100
8820,waiver,246,30037824,96.8076992319,_100,6,>100
8821,lebanon,246,30038070,96.8084920554,_100,7,>100
8822,cilantro,246,30038316,96.809284879,_100,8,>100
8823,compares,246,30038562,96.8100777025,_100,8,>100
8824,avid,246,30038808,96.8108705261,_100,4,>100
8825,purdue,245,30039053,96.8116601267,_100,6,>100
8826,disorders,245,30039298,96.8124497274,_100,9,>100
8827,cease,245,30039543,96.8132393281,_100,5,>100
8828,plum,245,30039788,96.8140289288,_100,4,>100
8829,confirmation,245,30040033,96.8148185295,_100,12,>100
8830,antique,245,30040278,96.8156081301,_100,7,>100
8831,madrid,245,30040523,96.8163977308,_100,6,>100
8832,critically,245,30040768,96.8171873315,_100,10,>100
8833,pumped,245,30041013,96.8179769322,_100,6,>100
8834,boring,245,30041258,96.8187665329,_100,6,>100
8835,pizzas,245,30041503,96.8195561336,_100,6,>100
8836,militants,245,30041748,96.8203457342,_100,9,>100
8837,thriving,245,30041993,96.8211353349,_100,8,>100
8838,forensic,245,30042238,96.8219249356,_100,8,>100
8839,schemes,245,30042483,96.8227145363,_100,7,>100
8840,huskies,245,30042728,96.823504137,_100,7,>100
8841,almonds,245,30042973,96.8242937376,_100,7,>100
8842,tahoe,245,30043218,96.8250833383,_100,5,>100
8843,timely,245,30043463,96.825872939,_100,6,>100
8844,resting,245,30043708,96.8266625397,_100,7,>100
8845,teaspoons,245,30043953,96.8274521404,_100,9,>100
8846,shoots,245,30044198,96.8282417411,_100,6,>100
8847,contestants,245,30044443,96.8290313417,_100,11,>100
8848,elect,245,30044688,96.8298209424,_100,5,>100
8849,pig,244,30044932,96.8306073202,_100,3,>100
8850,undisclosed,244,30045176,96.8313936981,_100,11,>100
8851,grip,244,30045420,96.8321800759,_100,4,>100
8852,twp,244,30045664,96.8329664537,_100,3,>100
8853,cinco,244,30045908,96.8337528315,_100,5,>100
8854,contamination,244,30046152,96.8345392093,_100,13,>100
8855,proudly,244,30046396,96.8353255872,_100,7,>100
8856,cloudy,244,30046640,96.836111965,_100,6,>100
8857,violates,244,30046884,96.8368983428,_100,8,>100
8858,tweets,244,30047128,96.8376847206,_100,6,>100
8859,mini,244,30047372,96.8384710985,_100,4,>100
8860,attributes,244,30047616,96.8392574763,_100,10,>100
8861,troopers,244,30047860,96.8400438541,_100,8,>100
8862,kendall,244,30048104,96.8408302319,_100,7,>100
8863,interrupted,244,30048348,96.8416166097,_100,11,>100
8864,surfing,244,30048592,96.8424029876,_100,7,>100
8865,tumor,244,30048836,96.8431893654,_100,5,>100
8866,ovation,244,30049080,96.8439757432,_100,7,>100
8867,pudding,244,30049324,96.844762121,_100,7,>100
8868,undergraduate,244,30049568,96.8455484989,_100,13,>100
8869,babeu,244,30049812,96.8463348767,_100,5,>100
8870,exchanged,244,30050056,96.8471212545,_100,9,>100
8871,cornell,244,30050300,96.8479076323,_100,7,>100
8872,kindle,244,30050544,96.8486940101,_100,6,>100
8873,shapes,244,30050788,96.849480388,_100,6,>100
8874,lows,243,30051031,96.8502635429,_100,4,>100
8875,attracts,243,30051274,96.8510466979,_100,8,>100
8876,collectively,243,30051517,96.8518298528,_100,12,>100
8877,accent,243,30051760,96.8526130078,_100,6,>100
8878,protects,243,30052003,96.8533961628,_100,8,>100
8879,mormon,243,30052246,96.8541793177,_100,6,>100
8880,mayweather,243,30052489,96.8549624727,_100,10,>100
8881,concludes,243,30052732,96.8557456277,_100,9,>100
8882,suspensions,243,30052975,96.8565287826,_100,11,>100
8883,sutton,243,30053218,96.8573119376,_100,6,>100
8884,observation,243,30053461,96.8580950925,_100,11,>100
8885,guillen,243,30053704,96.8588782475,_100,7,>100
8886,kean,243,30053947,96.8596614025,_100,4,>100
8887,rewarding,243,30054190,96.8604445574,_100,9,>100
8888,financed,243,30054433,96.8612277124,_100,8,>100
8889,halak,243,30054676,96.8620108674,_100,5,>100
8890,maurice,243,30054919,96.8627940223,_100,7,>100
8891,marking,243,30055162,96.8635771773,_100,7,>100
8892,putin,243,30055405,96.8643603322,_100,5,>100
8893,pioneers,243,30055648,96.8651434872,_100,8,>100
8894,arsenal,243,30055891,96.8659266422,_100,7,>100
8895,curator,242,30056133,96.8667065743,_100,7,>100
8896,imports,242,30056375,96.8674865064,_100,7,>100
8897,stafford,242,30056617,96.8682664385,_100,8,>100
8898,bosses,242,30056859,96.8690463706,_100,6,>100
8899,newsom,242,30057101,96.8698263027,_100,6,>100
8900,problematic,242,30057343,96.8706062348,_100,11,>100
8901,sympathy,242,30057585,96.8713861669,_100,8,>100
8902,diced,242,30057827,96.872166099,_100,5,>100
8903,guides,242,30058069,96.8729460311,_100,6,>100
8904,coupled,242,30058311,96.8737259632,_100,7,>100
8905,holmgren,242,30058553,96.8745058953,_100,8,>100
8906,dementia,242,30058795,96.8752858274,_100,8,>100
8907,arrange,242,30059037,96.8760657595,_100,7,>100
8908,congestion,242,30059279,96.8768456916,_100,10,>100
8909,combines,242,30059521,96.8776256237,_100,8,>100
8910,conversion,242,30059763,96.8784055558,_100,10,>100
8911,melvin,242,30060005,96.8791854879,_100,6,>100
8912,westfield,241,30060246,96.8799621971,_100,9,>100
8913,dire,241,30060487,96.8807389064,_100,4,>100
8914,severance,241,30060728,96.8815156156,_100,9,>100
8915,happiness,241,30060969,96.8822923249,_100,9,>100
8916,pnc,241,30061210,96.8830690341,_100,3,>100
8917,dillon,241,30061451,96.8838457434,_100,6,>100
8918,undermine,241,30061692,96.8846224526,_100,9,>100
8919,enlisted,241,30061933,96.8853991618,_100,8,>100
8920,admissions,241,30062174,96.8861758711,_100,10,>100
8921,breed,241,30062415,96.8869525803,_100,5,>100
8922,rider,241,30062656,96.8877292896,_100,5,>100
8923,hanna,241,30062897,96.8885059988,_100,5,>100
8924,blockbuster,241,30063138,96.889282708,_100,11,>100
8925,invented,241,30063379,96.8900594173,_100,8,>100
8926,plainfield,241,30063620,96.8908361265,_100,10,>100
8927,arlington,241,30063861,96.8916128358,_100,9,>100
8928,natalie,241,30064102,96.892389545,_100,7,>100
8929,concentrated,241,30064343,96.8931662543,_100,12,>100
8930,excuses,241,30064584,96.8939429635,_100,7,>100
8931,sectors,241,30064825,96.8947196727,_100,7,>100
8932,billboard,241,30065066,96.895496382,_100,9,>100
8933,appropriately,241,30065307,96.8962730912,_100,13,>100
8934,dipping,241,30065548,96.8970498005,_100,7,>100
8935,booths,240,30065788,96.8978232869,_100,6,>100
8936,villages,240,30066028,96.8985967732,_100,8,>100
8937,pam,240,30066268,96.8993702596,_100,3,>100
8938,unofficial,240,30066508,96.900143746,_100,10,>100
8939,cuomo,240,30066748,96.9009172324,_100,5,>100
8940,riot,240,30066988,96.9016907188,_100,4,>100
8941,carney,240,30067228,96.9024642051,_100,6,>100
8942,unsure,240,30067468,96.9032376915,_100,6,>100
8943,haley,240,30067708,96.9040111779,_100,5,>100
8944,exemptions,240,30067948,96.9047846643,_100,10,>100
8945,hints,240,30068188,96.9055581507,_100,5,>100
8946,preference,240,30068428,96.9063316371,_100,10,>100
8947,ousted,240,30068668,96.9071051234,_100,6,>100
8948,developmental,240,30068908,96.9078786098,_100,13,>100
8949,orientation,240,30069148,96.9086520962,_100,11,>100
8950,perks,240,30069388,96.9094255826,_100,5,>100
8951,poses,240,30069628,96.910199069,_100,5,>100
8952,planner,240,30069868,96.9109725553,_100,7,>100
8953,rapper,240,30070108,96.9117460417,_100,6,>100
8954,potent,240,30070348,96.9125195281,_100,6,>100
8955,240,240,30070588,96.9132930145,_100,3,>100
8956,mckenzie,240,30070828,96.9140665009,_100,8,>100
8957,cobb,240,30071068,96.9148399873,_100,4,>100
8958,shaken,240,30071308,96.9156134736,_100,6,>100
8959,lefty,240,30071548,96.91638696,_100,5,>100
8960,enemies,240,30071788,96.9171604464,_100,7,>100
8961,herald,240,30072028,96.9179339328,_100,6,>100
8962,rifle,240,30072268,96.9187074192,_100,5,>100
8963,evacuation,239,30072507,96.9194776827,_100,10,>100
8964,hostile,239,30072746,96.9202479462,_100,7,>100
8965,tenant,239,30072985,96.9210182097,_100,6,>100
8966,independents,239,30073224,96.9217884733,_100,12,>100
8967,saunders,239,30073463,96.9225587368,_100,8,>100
8968,dugout,239,30073702,96.9233290003,_100,6,>100
8969,martini,239,30073941,96.9240992638,_100,7,>100
8970,pleading,239,30074180,96.9248695274,_100,8,>100
8971,colo,239,30074419,96.9256397909,_100,4,>100
8972,patton,239,30074658,96.9264100544,_100,6,>100
8973,worrying,239,30074897,96.9271803179,_100,8,>100
8974,bites,239,30075136,96.9279505814,_100,5,>100
8975,riverside,239,30075375,96.928720845,_100,9,>100
8976,wreck,239,30075614,96.9294911085,_100,5,>100
8977,intoxicated,239,30075853,96.930261372,_100,11,>100
8978,cadillac,239,30076092,96.9310316355,_100,8,>100
8979,brakes,239,30076331,96.9318018991,_100,6,>100
8980,evacuated,239,30076570,96.9325721626,_100,9,>100
8981,designing,239,30076809,96.9333424261,_100,9,>100
8982,crashing,239,30077048,96.9341126896,_100,8,>100
8983,minorities,239,30077287,96.9348829531,_100,10,>100
8984,jeter,239,30077526,96.9356532167,_100,5,>100
8985,beatles,239,30077765,96.9364234802,_100,7,>100
8986,concealed,239,30078004,96.9371937437,_100,9,>100
8987,staring,239,30078243,96.9379640072,_100,7,>100
8988,ink,239,30078482,96.9387342708,_100,3,>100
8989,moratorium,239,30078721,96.9395045343,_100,10,>100
8990,quirky,239,30078960,96.9402747978,_100,6,>100
8991,pushes,239,30079199,96.9410450613,_100,6,>100
8992,punished,238,30079437,96.941812102,_100,8,>100
8993,lethal,238,30079675,96.9425791426,_100,6,>100
8994,maxwell,238,30079913,96.9433461833,_100,7,>100
8995,countered,238,30080151,96.944113224,_100,9,>100
8996,steer,238,30080389,96.9448802646,_100,5,>100
8997,tattoo,238,30080627,96.9456473053,_100,6,>100
8998,di,238,30080865,96.946414346,_100,2,>100
8999,float,238,30081103,96.9471813866,_100,5,>100
9000,slogan,238,30081341,96.9479484273,_100,6,>100
9001,advertised,238,30081579,96.9487154679,_100,10,>100
9002,brussels,238,30081817,96.9494825086,_100,8,>100
9003,loyola,238,30082055,96.9502495493,_100,6,>100
9004,happier,238,30082293,96.9510165899,_100,7,>100
9005,mock,238,30082531,96.9517836306,_100,4,>100
9006,reactions,238,30082769,96.9525506713,_100,9,>100
9007,cartoon,238,30083007,96.9533177119,_100,7,>100
9008,backward,238,30083245,96.9540847526,_100,8,>100
9009,theodore,238,30083483,96.9548517932,_100,8,>100
9010,crunchy,238,30083721,96.9556188339,_100,7,>100
9011,katrina,238,30083959,96.9563858746,_100,7,>100
9012,sleek,238,30084197,96.9571529152,_100,5,>100
9013,phillip,238,30084435,96.9579199559,_100,7,>100
9014,scenarios,238,30084673,96.9586869966,_100,9,>100
9015,dies,238,30084911,96.9594540372,_100,4,>100
9016,switching,238,30085149,96.9602210779,_100,9,>100
9017,presumably,238,30085387,96.9609881185,_100,10,>100
9018,tiffany,238,30085625,96.9617551592,_100,7,>100
9019,cafeteria,237,30085862,96.962518977,_100,9,>100
9020,obstacle,237,30086099,96.9632827948,_100,8,>100
9021,stanton,237,30086336,96.9640466126,_100,7,>100
9022,tile,237,30086573,96.9648104304,_100,4,>100
9023,waiter,237,30086810,96.9655742482,_100,6,>100
9024,nonprofits,237,30087047,96.966338066,_100,10,>100
9025,advise,237,30087284,96.9671018838,_100,6,>100
9026,processes,237,30087521,96.9678657016,_100,9,>100
9027,methodist,237,30087758,96.9686295194,_100,9,>100
9028,dot,237,30087995,96.9693933372,_100,3,>100
9029,respondents,237,30088232,96.970157155,_100,11,>100
9030,kicker,237,30088469,96.9709209728,_100,6,>100
9031,independently,237,30088706,96.9716847906,_100,13,>100
9032,expose,237,30088943,96.9724486084,_100,6,>100
9033,chester,237,30089180,96.9732124262,_100,7,>100
9034,warmer,237,30089417,96.973976244,_100,6,>100
9035,beneficial,237,30089654,96.9747400618,_100,10,>100
9036,meadows,237,30089891,96.9755038796,_100,7,>100
9037,outer,237,30090128,96.9762676974,_100,5,>100
9038,standardized,237,30090365,96.9770315153,_100,12,>100
9039,priests,237,30090602,96.9777953331,_100,7,>100
9040,salty,237,30090839,96.9785591509,_100,5,>100
9041,festivities,237,30091076,96.9793229687,_100,11,>100
9042,avocado,237,30091313,96.9800867865,_100,7,>100
9043,col,237,30091550,96.9808506043,_100,3,>100
9044,teamed,237,30091787,96.9816144221,_100,6,>100
9045,abruptly,237,30092024,96.9823782399,_100,8,>100
9046,ge,237,30092261,96.9831420577,_100,2,>100
9047,helicopters,237,30092498,96.9839058755,_100,11,>100
9048,vanecko,236,30092734,96.9846664704,_100,7,>100
9049,spun,236,30092970,96.9854270654,_100,4,>100
9050,shanghai,236,30093206,96.9861876603,_100,8,>100
9051,firearms,236,30093442,96.9869482552,_100,8,>100
9052,cleaner,236,30093678,96.9877088502,_100,7,>100
9053,commodity,236,30093914,96.9884694451,_100,9,>100
9054,hurry,236,30094150,96.9892300401,_100,5,>100
9055,productivity,236,30094386,96.989990635,_100,12,>100
9056,limbaugh,236,30094622,96.99075123,_100,8,>100
9057,comparing,236,30094858,96.9915118249,_100,9,>100
9058,shaky,236,30095094,96.9922724198,_100,5,>100
9059,mandates,236,30095330,96.9930330148,_100,8,>100
9060,franchises,236,30095566,96.9937936097,_100,10,>100
9061,discounted,236,30095802,96.9945542047,_100,10,>100
9062,verify,236,30096038,96.9953147996,_100,6,>100
9063,slowdown,236,30096274,96.9960753946,_100,8,>100
9064,trainers,236,30096510,96.9968359895,_100,8,>100
9065,awhile,236,30096746,96.9975965844,_100,6,>100
9066,jerseys,235,30096981,96.9983539565,_100,7,>100
9067,mandated,235,30097216,96.9991113286,_100,8,>100
9068,legislator,235,30097451,96.9998687007,_100,10,>100
9069,netherlands,235,30097686,97.0006260728,_100,11,>100
9070,floral,235,30097921,97.0013834449,_100,6,>100
9071,departed,235,30098156,97.0021408169,_100,8,>100
9072,depot,235,30098391,97.002898189,_100,5,>100
9073,achievements,235,30098626,97.0036555611,_100,12,>100
9074,symbolic,235,30098861,97.0044129332,_100,8,>100
9075,brokers,235,30099096,97.0051703053,_100,7,>100
9076,strawberries,235,30099331,97.0059276773,_100,12,>100
9077,minn,235,30099566,97.0066850494,_100,4,>100
9078,235,235,30099801,97.0074424215,_100,3,>100
9079,gresham,235,30100036,97.0081997936,_100,7,>100
9080,coaster,235,30100271,97.0089571657,_100,7,>100
9081,pads,235,30100506,97.0097145378,_100,4,>100
9082,roller,235,30100741,97.0104719098,_100,6,>100
9083,subsidy,235,30100976,97.0112292819,_100,7,>100
9084,slim,235,30101211,97.011986654,_100,4,>100
9085,cardiac,235,30101446,97.0127440261,_100,7,>100
9086,freely,235,30101681,97.0135013982,_100,6,>100
9087,denial,235,30101916,97.0142587703,_100,6,>100
9088,receptions,235,30102151,97.0150161423,_100,10,>100
9089,warmth,235,30102386,97.0157735144,_100,6,>100
9090,mega,234,30102620,97.0165276636,_100,4,>100
9091,confessed,234,30102854,97.0172818129,_100,9,>100
9092,junction,234,30103088,97.0180359621,_100,8,>100
9093,amendments,234,30103322,97.0187901113,_100,10,>100
9094,mashed,234,30103556,97.0195442605,_100,6,>100
9095,examining,234,30103790,97.0202984098,_100,9,>100
9096,spectators,234,30104024,97.021052559,_100,10,>100
9097,pulitzer,234,30104258,97.0218067082,_100,8,>100
9098,trace,234,30104492,97.0225608574,_100,5,>100
9099,owen,234,30104726,97.0233150066,_100,4,>100
9100,indoors,234,30104960,97.0240691559,_100,7,>100
9101,sw,234,30105194,97.0248233051,_100,2,>100
9102,niche,234,30105428,97.0255774543,_100,5,>100
9103,grabbing,234,30105662,97.0263316035,_100,8,>100
9104,realizing,234,30105896,97.0270857528,_100,9,>100
9105,bachmann,234,30106130,97.027839902,_100,8,>100
9106,presentations,234,30106364,97.0285940512,_100,13,>100
9107,debated,233,30106597,97.0293449776,_100,7,>100
9108,eastbound,233,30106830,97.0300959039,_100,9,>100
9109,palestinian,233,30107063,97.0308468303,_100,11,>100
9110,marina,233,30107296,97.0315977567,_100,6,>100
9111,nielsen,233,30107529,97.032348683,_100,7,>100
9112,relocated,233,30107762,97.0330996094,_100,9,>100
9113,interaction,233,30107995,97.0338505357,_100,11,>100
9114,leases,233,30108228,97.0346014621,_100,6,>100
9115,disc,233,30108461,97.0353523885,_100,4,>100
9116,improperly,233,30108694,97.0361033148,_100,10,>100
9117,merchants,233,30108927,97.0368542412,_100,9,>100
9118,grains,233,30109160,97.0376051676,_100,6,>100
9119,pen,233,30109393,97.0383560939,_100,3,>100
9120,disposal,233,30109626,97.0391070203,_100,8,>100
9121,smoothly,233,30109859,97.0398579466,_100,8,>100
9122,notify,233,30110092,97.040608873,_100,6,>100
9123,cynthia,233,30110325,97.0413597994,_100,7,>100
9124,altman,233,30110558,97.0421107257,_100,6,>100
9125,zest,233,30110791,97.0428616521,_100,4,>100
9126,poker,233,30111024,97.0436125785,_100,5,>100
9127,md,233,30111257,97.0443635048,_100,2,>100
9128,planners,233,30111490,97.0451144312,_100,8,>100
9129,tubes,232,30111722,97.0458621347,_100,5,>100
9130,junk,232,30111954,97.0466098382,_100,4,>100
9131,groceries,232,30112186,97.0473575417,_100,9,>100
9132,cutler,232,30112418,97.0481052452,_100,6,>100
9133,dewine,232,30112650,97.0488529487,_100,6,>100
9134,nightclub,232,30112882,97.0496006522,_100,9,>100
9135,wis,232,30113114,97.0503483557,_100,3,>100
9136,cows,232,30113346,97.0510960592,_100,4,>100
9137,patent,232,30113578,97.0518437627,_100,6,>100
9138,invasive,232,30113810,97.0525914662,_100,8,>100
9139,refunds,232,30114042,97.0533391697,_100,7,>100
9140,weekdays,232,30114274,97.0540868732,_100,8,>100
9141,yielded,232,30114506,97.0548345767,_100,7,>100
9142,grasp,232,30114738,97.0555822802,_100,5,>100
9143,fremont,232,30114970,97.0563299837,_100,7,>100
9144,suspend,232,30115202,97.0570776872,_100,7,>100
9145,evaluated,232,30115434,97.0578253907,_100,9,>100
9146,promptly,232,30115666,97.0585730942,_100,8,>100
9147,spurred,232,30115898,97.0593207977,_100,7,>100
9148,canvas,232,30116130,97.0600685012,_100,6,>100
9149,clutch,232,30116362,97.0608162047,_100,6,>100
9150,packing,232,30116594,97.0615639082,_100,7,>100
9151,mullen,232,30116826,97.0623116118,_100,6,>100
9152,gravy,232,30117058,97.0630593153,_100,5,>100
9153,walters,232,30117290,97.0638070188,_100,7,>100
9154,fortunes,231,30117521,97.0645514994,_100,8,>100
9155,albany,231,30117752,97.06529598,_100,6,>100
9156,macy,231,30117983,97.0660404607,_100,4,>100
9157,pavement,231,30118214,97.0667849413,_100,8,>100
9158,banning,231,30118445,97.067529422,_100,7,>100
9159,ligament,231,30118676,97.0682739026,_100,8,>100
9160,pitt,231,30118907,97.0690183833,_100,4,>100
9161,surged,231,30119138,97.0697628639,_100,6,>100
9162,judged,231,30119369,97.0705073445,_100,6,>100
9163,fleeing,231,30119600,97.0712518252,_100,7,>100
9164,unsuccessfully,231,30119831,97.0719963058,_100,14,>100
9165,briefing,231,30120062,97.0727407865,_100,8,>100
9166,egyptian,231,30120293,97.0734852671,_100,8,>100
9167,preheat,231,30120524,97.0742297478,_100,7,>100
9168,banana,231,30120755,97.0749742284,_100,6,>100
9169,manufactured,231,30120986,97.075718709,_100,12,>100
9170,weights,231,30121217,97.0764631897,_100,7,>100
9171,tattoos,231,30121448,97.0772076703,_100,7,>100
9172,meltdown,231,30121679,97.077952151,_100,8,>100
9173,emphasize,231,30121910,97.0786966316,_100,9,>100
9174,corrupt,231,30122141,97.0794411123,_100,7,>100
9175,hospitality,231,30122372,97.0801855929,_100,11,>100
9176,flavored,231,30122603,97.0809300735,_100,8,>100
9177,kimberly,231,30122834,97.0816745542,_100,8,>100
9178,swung,231,30123065,97.0824190348,_100,5,>100
9179,whale,231,30123296,97.0831635155,_100,5,>100
9180,sandoval,231,30123527,97.0839079961,_100,8,>100
9181,appropriations,231,30123758,97.0846524768,_100,14,>100
9182,sanctuary,230,30123988,97.0853937345,_100,9,>100
9183,grim,230,30124218,97.0861349923,_100,4,>100
9184,governance,230,30124448,97.0868762501,_100,10,>100
9185,males,230,30124678,97.0876175079,_100,5,>100
9186,frontier,230,30124908,97.0883587657,_100,8,>100
9187,backes,230,30125138,97.0891000235,_100,6,>100
9188,inquiries,230,30125368,97.0898412812,_100,9,>100
9189,albeit,230,30125598,97.090582539,_100,6,>100
9190,campaigned,230,30125828,97.0913237968,_100,10,>100
9191,baron,230,30126058,97.0920650546,_100,5,>100
9192,230,230,30126288,97.0928063124,_100,3,>100
9193,expansive,230,30126518,97.0935475702,_100,9,>100
9194,startups,230,30126748,97.0942888279,_100,8,>100
9195,stranded,230,30126978,97.0950300857,_100,8,>100
9196,cycling,230,30127208,97.0957713435,_100,7,>100
9197,bankrupt,230,30127438,97.0965126013,_100,8,>100
9198,listeners,230,30127668,97.0972538591,_100,9,>100
9199,scotland,230,30127898,97.0979951169,_100,8,>100
9200,doubling,230,30128128,97.0987363746,_100,8,>100
9201,stuffing,230,30128358,97.0994776324,_100,8,>100
9202,jurisdiction,229,30128587,97.1002156673,_100,12,>100
9203,allegation,229,30128816,97.1009537023,_100,10,>100
9204,rhode,229,30129045,97.1016917372,_100,5,>100
9205,reasonably,229,30129274,97.1024297721,_100,10,>100
9206,timetable,229,30129503,97.103167807,_100,9,>100
9207,volt,229,30129732,97.103905842,_100,4,>100
9208,balances,229,30129961,97.1046438769,_100,8,>100
9209,racketeering,229,30130190,97.1053819118,_100,12,>100
9210,revelations,229,30130419,97.1061199467,_100,11,>100
9211,pineapple,229,30130648,97.1068579816,_100,9,>100
9212,cactus,229,30130877,97.1075960166,_100,6,>100
9213,fouls,229,30131106,97.1083340515,_100,5,>100
9214,wednesdays,229,30131335,97.1090720864,_100,10,>100
9215,superintendents,229,30131564,97.1098101213,_100,15,>100
9216,spokesperson,229,30131793,97.1105481563,_100,12,>100
9217,fallout,229,30132022,97.1112861912,_100,7,>100
9218,populated,229,30132251,97.1120242261,_100,9,>100
9219,detect,229,30132480,97.112762261,_100,6,>100
9220,ala,229,30132709,97.113500296,_100,3,>100
9221,daly,229,30132938,97.1142383309,_100,4,>100
9222,levin,229,30133167,97.1149763658,_100,5,>100
9223,indycar,229,30133396,97.1157144007,_100,7,>100
9224,mirrors,229,30133625,97.1164524356,_100,7,>100
9225,shootout,229,30133854,97.1171904706,_100,8,>100
9226,pasadena,228,30134082,97.1179252826,_100,8,>100
9227,environmentalists,228,30134310,97.1186600947,_100,17,>100
9228,ppg,228,30134538,97.1193949068,_100,3,>100
9229,clemente,228,30134766,97.1201297188,_100,8,>100
9230,gore,228,30134994,97.1208645309,_100,4,>100
9231,foam,228,30135222,97.1215993429,_100,4,>100
9232,fellowship,228,30135450,97.122334155,_100,10,>100
9233,extract,228,30135678,97.1230689671,_100,7,>100
9234,resisting,228,30135906,97.1238037791,_100,9,>100
9235,maggie,228,30136134,97.1245385912,_100,6,>100
9236,endure,228,30136362,97.1252734033,_100,6,>100
9237,distracted,228,30136590,97.1260082153,_100,10,>100
9238,mae,228,30136818,97.1267430274,_100,3,>100
9239,mourdock,228,30137046,97.1274778395,_100,8,>100
9240,drums,227,30137273,97.1282094287,_100,5,>100
9241,efficiently,227,30137500,97.1289410179,_100,11,>100
9242,holocaust,227,30137727,97.1296726071,_100,9,>100
9243,chairwoman,227,30137954,97.1304041963,_100,10,>100
9244,luncheon,227,30138181,97.1311357855,_100,8,>100
9245,uphill,227,30138408,97.1318673747,_100,6,>100
9246,requesting,227,30138635,97.1325989639,_100,10,>100
9247,inge,227,30138862,97.1333305531,_100,4,>100
9248,chill,227,30139089,97.1340621423,_100,5,>100
9249,enjoyable,227,30139316,97.1347937315,_100,9,>100
9250,paved,227,30139543,97.1355253207,_100,5,>100
9251,hillside,227,30139770,97.1362569099,_100,8,>100
9252,shells,227,30139997,97.1369884991,_100,6,>100
9253,squeezed,227,30140224,97.1377200883,_100,8,>100
9254,packs,227,30140451,97.1384516775,_100,5,>100
9255,pivotal,227,30140678,97.1391832667,_100,7,>100
9256,frazier,227,30140905,97.1399148559,_100,7,>100
9257,lehman,227,30141132,97.1406464451,_100,6,>100
9258,bloomfield,227,30141359,97.1413780343,_100,10,>100
9259,insider,227,30141586,97.1421096235,_100,7,>100
9260,tanning,227,30141813,97.1428412127,_100,7,>100
9261,evaluating,227,30142040,97.1435728019,_100,10,>100
9262,oregonians,226,30142266,97.1443011683,_100,10,>100
9263,rope,226,30142492,97.1450295346,_100,4,>100
9264,sauces,226,30142718,97.145757901,_100,6,>100
9265,weighs,226,30142944,97.1464862673,_100,6,>100
9266,tee,226,30143170,97.1472146336,_100,3,>100
9267,detected,226,30143396,97.147943,_100,8,>100
9268,framework,226,30143622,97.1486713663,_100,9,>100
9269,dominican,226,30143848,97.1493997327,_100,9,>100
9270,switzerland,226,30144074,97.150128099,_100,11,>100
9271,preparations,226,30144300,97.1508564654,_100,12,>100
9272,handy,226,30144526,97.1515848317,_100,5,>100
9273,precedent,226,30144752,97.152313198,_100,9,>100
9274,tuned,226,30144978,97.1530415644,_100,5,>100
9275,ceilings,226,30145204,97.1537699307,_100,8,>100
9276,coroner,226,30145430,97.1544982971,_100,7,>100
9277,suppose,226,30145656,97.1552266634,_100,7,>100
9278,dragon,226,30145882,97.1559550298,_100,6,>100
9279,fracking,226,30146108,97.1566833961,_100,8,>100
9280,rugged,226,30146334,97.1574117624,_100,6,>100
9281,cites,226,30146560,97.1581401288,_100,5,>100
9282,miserable,226,30146786,97.1588684951,_100,9,>100
9283,edgar,226,30147012,97.1595968615,_100,5,>100
9284,shades,226,30147238,97.1603252278,_100,6,>100
9285,concepts,226,30147464,97.1610535942,_100,8,>100
9286,bubbles,226,30147690,97.1617819605,_100,7,>100
9287,nova,226,30147916,97.1625103268,_100,4,>100
9288,disasters,226,30148142,97.1632386932,_100,9,>100
9289,observe,226,30148368,97.1639670595,_100,7,>100
9290,lang,226,30148594,97.1646954259,_100,4,>100
9291,initiated,226,30148820,97.1654237922,_100,9,>100
9292,blended,226,30149046,97.1661521586,_100,7,>100
9293,infamous,226,30149272,97.1668805249,_100,8,>100
9294,criticizing,226,30149498,97.1676088913,_100,11,>100
9295,defining,226,30149724,97.1683372576,_100,8,>100
9296,trinity,226,30149950,97.1690656239,_100,7,>100
9297,broccoli,226,30150176,97.1697939903,_100,8,>100
9298,predicts,226,30150402,97.1705223566,_100,8,>100
9299,popcorn,226,30150628,97.171250723,_100,7,>100
9300,aa,226,30150854,97.1719790893,_100,2,>100
9301,redshirt,226,30151080,97.1727074557,_100,8,>100
9302,fictional,225,30151305,97.1734325991,_100,9,>100
9303,informal,225,30151530,97.1741577426,_100,8,>100
9304,instructed,225,30151755,97.1748828861,_100,10,>100
9305,advises,225,30151980,97.1756080296,_100,7,>100
9306,hailed,225,30152205,97.1763331731,_100,6,>100
9307,watering,225,30152430,97.1770583166,_100,8,>100
9308,verge,225,30152655,97.17778346,_100,5,>100
9309,rhodes,225,30152880,97.1785086035,_100,6,>100
9310,vitamin,225,30153105,97.179233747,_100,7,>100
9311,pornography,225,30153330,97.1799588905,_100,11,>100
9312,earns,225,30153555,97.180684034,_100,5,>100
9313,swap,225,30153780,97.1814091775,_100,4,>100
9314,rebates,225,30154005,97.1821343209,_100,7,>100
9315,fog,225,30154230,97.1828594644,_100,3,>100
9316,toughness,225,30154455,97.1835846079,_100,9,>100
9317,mouse,225,30154680,97.1843097514,_100,5,>100
9318,225,225,30154905,97.1850348949,_100,3,>100
9319,intimidation,225,30155130,97.1857600384,_100,12,>100
9320,yen,225,30155355,97.1864851818,_100,3,>100
9321,placement,225,30155580,97.1872103253,_100,9,>100
9322,anita,225,30155805,97.1879354688,_100,5,>100
9323,councilwoman,225,30156030,97.1886606123,_100,12,>100
9324,impacted,225,30156255,97.1893857558,_100,8,>100
9325,promotions,225,30156480,97.1901108993,_100,10,>100
9326,capabilities,225,30156705,97.1908360427,_100,12,>100
9327,founders,225,30156930,97.1915611862,_100,8,>100
9328,juices,225,30157155,97.1922863297,_100,6,>100
9329,rains,225,30157380,97.1930114732,_100,5,>100
9330,discretion,225,30157605,97.1937366167,_100,10,>100
9331,downey,225,30157830,97.1944617602,_100,6,>100
9332,shutting,224,30158054,97.1951836808,_100,8,>100
9333,subsidized,224,30158278,97.1959056014,_100,10,>100
9334,grande,224,30158502,97.196627522,_100,6,>100
9335,logic,224,30158726,97.1973494426,_100,5,>100
9336,athens,224,30158950,97.1980713633,_100,6,>100
9337,chemotherapy,224,30159174,97.1987932839,_100,12,>100
9338,electorate,224,30159398,97.1995152045,_100,10,>100
9339,cellphones,224,30159622,97.2002371251,_100,10,>100
9340,pratt,224,30159846,97.2009590458,_100,5,>100
9341,encounters,224,30160070,97.2016809664,_100,10,>100
9342,contingent,224,30160294,97.202402887,_100,10,>100
9343,wendy,224,30160518,97.2031248076,_100,5,>100
9344,vocals,224,30160742,97.2038467283,_100,6,>100
9345,sticky,224,30160966,97.2045686489,_100,6,>100
9346,backgrounds,224,30161190,97.2052905695,_100,11,>100
9347,rents,224,30161414,97.2060124901,_100,5,>100
9348,flesh,224,30161638,97.2067344108,_100,5,>100
9349,origin,224,30161862,97.2074563314,_100,6,>100
9350,denise,224,30162086,97.208178252,_100,6,>100
9351,connects,224,30162310,97.2089001726,_100,8,>100
9352,restraining,224,30162534,97.2096220932,_100,11,>100
9353,scrambling,224,30162758,97.2103440139,_100,10,>100
9354,statistical,224,30162982,97.2110659345,_100,11,>100
9355,pumping,224,30163206,97.2117878551,_100,7,>100
9356,decisive,224,30163430,97.2125097757,_100,8,>100
9357,seminar,224,30163654,97.2132316964,_100,7,>100
9358,reuters,224,30163878,97.213953617,_100,7,>100
9359,piled,224,30164102,97.2146755376,_100,5,>100
9360,collector,224,30164326,97.2153974582,_100,9,>100
9361,ladder,223,30164549,97.216116156,_100,6,>100
9362,rookies,223,30164772,97.2168348538,_100,7,>100
9363,prosperity,223,30164995,97.2175535515,_100,10,>100
9364,prohibition,223,30165218,97.2182722493,_100,11,>100
9365,du,223,30165441,97.2189909471,_100,2,>100
9366,gut,223,30165664,97.2197096448,_100,3,>100
9367,blank,223,30165887,97.2204283426,_100,5,>100
9368,goldberg,223,30166110,97.2211470403,_100,8,>100
9369,suitable,223,30166333,97.2218657381,_100,8,>100
9370,leaks,223,30166556,97.2225844359,_100,5,>100
9371,damascus,223,30166779,97.2233031336,_100,8,>100
9372,rigorous,223,30167002,97.2240218314,_100,8,>100
9373,folded,223,30167225,97.2247405292,_100,6,>100
9374,refined,223,30167448,97.2254592269,_100,7,>100
9375,conjunction,223,30167671,97.2261779247,_100,11,>100
9376,sprained,223,30167894,97.2268966224,_100,8,>100
9377,commissions,223,30168117,97.2276153202,_100,11,>100
9378,lodging,223,30168340,97.228334018,_100,7,>100
9379,towels,223,30168563,97.2290527157,_100,6,>100
9380,psychologist,223,30168786,97.2297714135,_100,12,>100
9381,regis,223,30169009,97.2304901113,_100,5,>100
9382,paulson,223,30169232,97.231208809,_100,7,>100
9383,nail,223,30169455,97.2319275068,_100,4,>100
9384,hangs,223,30169678,97.2326462046,_100,5,>100
9385,ext,223,30169901,97.2333649023,_100,3,>100
9386,waved,223,30170124,97.2340836001,_100,5,>100
9387,fugitive,223,30170347,97.2348022978,_100,8,>100
9388,arch,223,30170570,97.2355209956,_100,4,>100
9389,transferring,223,30170793,97.2362396934,_100,12,>100
9390,rainy,222,30171015,97.2369551683,_100,5,>100
9391,allege,222,30171237,97.2376706432,_100,6,>100
9392,kleem,222,30171459,97.2383861181,_100,5,>100
9393,bio,222,30171681,97.239101593,_100,3,>100
9394,politifact,222,30171903,97.2398170679,_100,10,>100
9395,victorian,222,30172125,97.2405325428,_100,9,>100
9396,cubic,222,30172347,97.2412480177,_100,5,>100
9397,accurately,222,30172569,97.2419634926,_100,10,>100
9398,underwear,222,30172791,97.2426789675,_100,9,>100
9399,dismissal,222,30173013,97.2433944424,_100,9,>100
9400,interference,222,30173235,97.2441099173,_100,12,>100
9401,byron,222,30173457,97.2448253922,_100,5,>100
9402,minced,222,30173679,97.2455408671,_100,6,>100
9403,poland,222,30173901,97.246256342,_100,6,>100
9404,lilly,222,30174123,97.2469718169,_100,5,>100
9405,terribly,222,30174345,97.2476872918,_100,8,>100
9406,cabinets,222,30174567,97.2484027667,_100,8,>100
9407,irony,222,30174789,97.2491182416,_100,5,>100
9408,newcomers,222,30175011,97.2498337165,_100,9,>100
9409,famer,222,30175233,97.2505491914,_100,5,>100
9410,solved,222,30175455,97.2512646663,_100,6,>100
9411,logical,222,30175677,97.2519801413,_100,7,>100
9412,conscious,222,30175899,97.2526956162,_100,9,>100
9413,freezing,222,30176121,97.2534110911,_100,8,>100
9414,alerted,221,30176342,97.2541233431,_100,7,>100
9415,magnet,221,30176563,97.2548355951,_100,6,>100
9416,acquiring,221,30176784,97.2555478472,_100,9,>100
9417,verlander,221,30177005,97.2562600992,_100,9,>100
9418,norton,221,30177226,97.2569723513,_100,6,>100
9419,mri,221,30177447,97.2576846033,_100,3,>100
9420,daytona,221,30177668,97.2583968554,_100,7,>100
9421,mcilroy,221,30177889,97.2591091074,_100,7,>100
9422,shield,221,30178110,97.2598213595,_100,6,>100
9423,friedman,221,30178331,97.2605336115,_100,8,>100
9424,strawberry,221,30178552,97.2612458635,_100,10,>100
9425,consume,221,30178773,97.2619581156,_100,7,>100
9426,frames,221,30178994,97.2626703676,_100,6,>100
9427,prostate,221,30179215,97.2633826197,_100,8,>100
9428,scheduling,221,30179436,97.2640948717,_100,10,>100
9429,laughter,221,30179657,97.2648071238,_100,8,>100
9430,publishers,221,30179878,97.2655193758,_100,10,>100
9431,hale,221,30180099,97.2662316278,_100,4,>100
9432,skipped,221,30180320,97.2669438799,_100,7,>100
9433,tuck,221,30180541,97.2676561319,_100,4,>100
9434,bauer,221,30180762,97.268368384,_100,5,>100
9435,farmington,221,30180983,97.269080636,_100,10,>100
9436,bonnie,221,30181204,97.2697928881,_100,6,>100
9437,absorbed,221,30181425,97.2705051401,_100,8,>100
9438,birdie,221,30181646,97.2712173922,_100,6,>100
9439,diamondbacks,221,30181867,97.2719296442,_100,12,>100
9440,occurring,221,30182088,97.2726418962,_100,9,>100
9441,balancing,220,30182308,97.2733509254,_100,9,>100
9442,resemble,220,30182528,97.2740599546,_100,8,>100
9443,delightful,220,30182748,97.2747689838,_100,10,>100
9444,quotes,220,30182968,97.275478013,_100,6,>100
9445,mtv,220,30183188,97.2761870422,_100,3,>100
9446,220,220,30183408,97.2768960713,_100,3,>100
9447,resumed,220,30183628,97.2776051005,_100,7,>100
9448,applauded,220,30183848,97.2783141297,_100,9,>100
9449,wreckage,220,30184068,97.2790231589,_100,8,>100
9450,bros,220,30184288,97.2797321881,_100,4,>100
9451,petrino,220,30184508,97.2804412173,_100,7,>100
9452,seasonally,220,30184728,97.2811502464,_100,10,>100
9453,accidental,220,30184948,97.2818592756,_100,10,>100
9454,lucy,220,30185168,97.2825683048,_100,4,>100
9455,thrill,220,30185388,97.283277334,_100,6,>100
9456,administered,220,30185608,97.2839863632,_100,12,>100
9457,prone,220,30185828,97.2846953924,_100,5,>100
9458,explosives,220,30186048,97.2854044215,_100,10,>100
9459,firstenergy,220,30186268,97.2861134507,_100,11,>100
9460,suffers,220,30186488,97.2868224799,_100,7,>100
9461,refuses,220,30186708,97.2875315091,_100,7,>100
9462,litter,220,30186928,97.2882405383,_100,6,>100
9463,underwater,220,30187148,97.2889495675,_100,10,>100
9464,acclaimed,220,30187368,97.2896585966,_100,9,>100
9465,unwanted,220,30187588,97.2903676258,_100,8,>100
9466,kaiser,219,30187807,97.2910734322,_100,6,>100
9467,accustomed,219,30188026,97.2917792385,_100,10,>100
9468,manzo,219,30188245,97.2924850448,_100,5,>100
9469,celebrations,219,30188464,97.2931908511,_100,12,>100
9470,flaws,219,30188683,97.2938966574,_100,5,>100
9471,straw,219,30188902,97.2946024638,_100,5,>100
9472,pc,219,30189121,97.2953082701,_100,2,>100
9473,sack,219,30189340,97.2960140764,_100,4,>100
9474,indefinitely,219,30189559,97.2967198827,_100,12,>100
9475,ranges,219,30189778,97.2974256891,_100,6,>100
9476,acl,219,30189997,97.2981314954,_100,3,>100
9477,tweet,219,30190216,97.2988373017,_100,5,>100
9478,pietrangelo,219,30190435,97.299543108,_100,11,>100
9479,reconsider,219,30190654,97.3002489144,_100,10,>100
9480,specify,219,30190873,97.3009547207,_100,7,>100
9481,nest,219,30191092,97.301660527,_100,4,>100
9482,woodbridge,219,30191311,97.3023663333,_100,10,>100
9483,feast,219,30191530,97.3030721397,_100,5,>100
9484,proponents,219,30191749,97.303777946,_100,10,>100
9485,distinguished,219,30191968,97.3044837523,_100,13,>100
9486,muhammad,219,30192187,97.3051895586,_100,8,>100
9487,imminent,219,30192406,97.305895365,_100,8,>100
9488,fennel,219,30192625,97.3066011713,_100,6,>100
9489,preceded,219,30192844,97.3073069776,_100,8,>100
9490,dock,219,30193063,97.3080127839,_100,4,>100
9491,geauga,218,30193281,97.3087153674,_100,6,>100
9492,sprouts,218,30193499,97.3094179509,_100,7,>100
9493,taxi,218,30193717,97.3101205343,_100,4,>100
9494,wyoming,218,30193935,97.3108231178,_100,7,>100
9495,skirt,218,30194153,97.3115257012,_100,5,>100
9496,fundraisers,218,30194371,97.3122282847,_100,11,>100
9497,paycheck,218,30194589,97.3129308682,_100,8,>100
9498,technician,218,30194807,97.3136334516,_100,10,>100
9499,dime,218,30195025,97.3143360351,_100,4,>100
9500,ortiz,218,30195243,97.3150386186,_100,5,>100
9501,slu,218,30195461,97.315741202,_100,3,>100
9502,spectacle,218,30195679,97.3164437855,_100,9,>100
9503,tearing,218,30195897,97.317146369,_100,7,>100
9504,hurdle,218,30196115,97.3178489524,_100,6,>100
9505,continually,218,30196333,97.3185515359,_100,11,>100
9506,hearty,218,30196551,97.3192541193,_100,6,>100
9507,compensate,218,30196769,97.3199567028,_100,10,>100
9508,harrington,218,30196987,97.3206592863,_100,10,>100
9509,inclined,218,30197205,97.3213618697,_100,8,>100
9510,rubin,218,30197423,97.3220644532,_100,5,>100
9511,audition,218,30197641,97.3227670367,_100,8,>100
9512,norm,218,30197859,97.3234696201,_100,4,>100
9513,waived,218,30198077,97.3241722036,_100,6,>100
9514,bobcats,218,30198295,97.3248747871,_100,7,>100
9515,ameren,218,30198513,97.3255773705,_100,6,>100
9516,hop,218,30198731,97.326279954,_100,3,>100
9517,ty,218,30198949,97.3269825374,_100,2,>100
9518,undrafted,217,30199166,97.3276818981,_100,9,>100
9519,phenomenal,217,30199383,97.3283812587,_100,10,>100
9520,playful,217,30199600,97.3290806193,_100,7,>100
9521,probable,217,30199817,97.3297799799,_100,8,>100
9522,mosque,217,30200034,97.3304793405,_100,6,>100
9523,liberals,217,30200251,97.3311787011,_100,8,>100
9524,revenge,217,30200468,97.3318780617,_100,7,>100
9525,pistons,217,30200685,97.3325774223,_100,7,>100
9526,petersburg,217,30200902,97.3332767829,_100,10,>100
9527,washing,217,30201119,97.3339761435,_100,7,>100
9528,integrated,217,30201336,97.3346755041,_100,10,>100
9529,gundy,217,30201553,97.3353748647,_100,5,>100
9530,lecture,217,30201770,97.3360742253,_100,7,>100
9531,staggering,217,30201987,97.3367735859,_100,10,>100
9532,groundbreaking,217,30202204,97.3374729465,_100,14,>100
9533,obtaining,217,30202421,97.3381723071,_100,9,>100
9534,tipped,217,30202638,97.3388716677,_100,6,>100
9535,lavish,217,30202855,97.3395710283,_100,6,>100
9536,homage,217,30203072,97.3402703889,_100,6,>100
9537,malls,217,30203289,97.3409697495,_100,5,>100
9538,bartender,217,30203506,97.3416691101,_100,9,>100
9539,vogel,217,30203723,97.3423684707,_100,5,>100
9540,jays,217,30203940,97.3430678313,_100,4,>100
9541,contents,217,30204157,97.3437671919,_100,8,>100
9542,leasing,217,30204374,97.3444665525,_100,7,>100
9543,nobel,217,30204591,97.3451659132,_100,5,>100
9544,admire,217,30204808,97.3458652738,_100,6,>100
9545,sherrod,217,30205025,97.3465646344,_100,7,>100
9546,smarter,217,30205242,97.347263995,_100,7,>100
9547,stroll,217,30205459,97.3479633556,_100,6,>100
9548,pedestrians,216,30205675,97.3486594933,_100,11,>100
9549,moines,216,30205891,97.3493556311,_100,6,>100
9550,boomers,216,30206107,97.3500517688,_100,7,>100
9551,chevy,216,30206323,97.3507479065,_100,5,>100
9552,hype,216,30206539,97.3514440443,_100,4,>100
9553,hicks,216,30206755,97.352140182,_100,5,>100
9554,merged,216,30206971,97.3528363198,_100,6,>100
9555,glow,216,30207187,97.3535324575,_100,4,>100
9556,restrict,216,30207403,97.3542285953,_100,8,>100
9557,booming,216,30207619,97.354924733,_100,7,>100
9558,lid,216,30207835,97.3556208708,_100,3,>100
9559,maplewood,216,30208051,97.3563170085,_100,9,>100
9560,barcelona,216,30208267,97.3570131462,_100,9,>100
9561,shattered,215,30208482,97.3577060611,_100,9,>100
9562,chooses,215,30208697,97.358398976,_100,7,>100
9563,bella,215,30208912,97.3590918909,_100,5,>100
9564,stew,215,30209127,97.3597848058,_100,4,>100
9565,seldom,215,30209342,97.3604777207,_100,6,>100
9566,brokerage,215,30209557,97.3611706355,_100,9,>100
9567,cancers,215,30209772,97.3618635504,_100,7,>100
9568,predicting,215,30209987,97.3625564653,_100,10,>100
9569,brink,215,30210202,97.3632493802,_100,5,>100
9570,educator,215,30210417,97.3639422951,_100,8,>100
9571,popping,215,30210632,97.36463521,_100,7,>100
9572,bosh,215,30210847,97.3653281248,_100,4,>100
9573,homestead,215,30211062,97.3660210397,_100,9,>100
9574,varying,215,30211277,97.3667139546,_100,7,>100
9575,oath,215,30211492,97.3674068695,_100,4,>100
9576,contributors,215,30211707,97.3680997844,_100,12,>100
9577,wizards,215,30211922,97.3687926993,_100,7,>100
9578,randall,215,30212137,97.3694856142,_100,7,>100
9579,huron,215,30212352,97.370178529,_100,5,>100
9580,waiters,215,30212567,97.3708714439,_100,7,>100
9581,combo,215,30212782,97.3715643588,_100,5,>100
9582,responds,215,30212997,97.3722572737,_100,8,>100
9583,madonna,215,30213212,97.3729501886,_100,7,>100
9584,shouting,215,30213427,97.3736431035,_100,8,>100
9585,blows,215,30213642,97.3743360183,_100,5,>100
9586,necessity,215,30213857,97.3750289332,_100,9,>100
9587,mindset,215,30214072,97.3757218481,_100,7,>100
9588,grounder,215,30214287,97.376414763,_100,8,>100
9589,215,215,30214502,97.3771076779,_100,3,>100
9590,beckham,215,30214717,97.3778005928,_100,7,>100
9591,skate,215,30214932,97.3784935076,_100,5,>100
9592,freestyle,214,30215146,97.3791831997,_100,9,>100
9593,renting,214,30215360,97.3798728917,_100,7,>100
9594,clues,214,30215574,97.3805625837,_100,5,>100
9595,peel,214,30215788,97.3812522757,_100,4,>100
9596,diner,214,30216002,97.3819419678,_100,5,>100
9597,chop,214,30216216,97.3826316598,_100,4,>100
9598,develops,214,30216430,97.3833213518,_100,8,>100
9599,reminiscent,214,30216644,97.3840110438,_100,11,>100
9600,fuels,214,30216858,97.3847007359,_100,5,>100
9601,skating,214,30217072,97.3853904279,_100,7,>100
9602,schwarzenegger,214,30217286,97.3860801199,_100,14,>100
9603,marble,214,30217500,97.3867698119,_100,6,>100
9604,pies,214,30217714,97.387459504,_100,4,>100
9605,epidemic,214,30217928,97.388149196,_100,8,>100
9606,lonely,214,30218142,97.388838888,_100,6,>100
9607,jerome,214,30218356,97.38952858,_100,6,>100
9608,okay,214,30218570,97.3902182721,_100,4,>100
9609,tabloid,214,30218784,97.3909079641,_100,7,>100
9610,pots,214,30218998,97.3915976561,_100,4,>100
9611,declaration,214,30219212,97.3922873481,_100,11,>100
9612,reactors,214,30219426,97.3929770402,_100,8,>100
9613,russ,214,30219640,97.3936667322,_100,4,>100
9614,jayhawks,214,30219854,97.3943564242,_100,8,>100
9615,pirate,214,30220068,97.3950461162,_100,6,>100
9616,designation,213,30220281,97.3957325854,_100,11,>100
9617,sneak,213,30220494,97.3964190546,_100,5,>100
9618,mel,213,30220707,97.3971055237,_100,3,>100
9619,predictions,213,30220920,97.3977919929,_100,11,>100
9620,admired,213,30221133,97.398478462,_100,7,>100
9621,singapore,213,30221346,97.3991649312,_100,9,>100
9622,pickled,213,30221559,97.3998514004,_100,7,>100
9623,plagued,213,30221772,97.4005378695,_100,7,>100
9624,retiree,213,30221985,97.4012243387,_100,7,>100
9625,devil,213,30222198,97.4019108079,_100,5,>100
9626,fernando,213,30222411,97.402597277,_100,8,>100
9627,scenery,213,30222624,97.4032837462,_100,7,>100
9628,supplement,213,30222837,97.4039702154,_100,10,>100
9629,firearm,213,30223050,97.4046566845,_100,7,>100
9630,unconscious,213,30223263,97.4053431537,_100,11,>100
9631,jailed,213,30223476,97.4060296229,_100,6,>100
9632,twisted,213,30223689,97.406716092,_100,7,>100
9633,schultz,213,30223902,97.4074025612,_100,7,>100
9634,iraqi,213,30224115,97.4080890303,_100,5,>100
9635,discourage,213,30224328,97.4087754995,_100,10,>100
9636,contracted,213,30224541,97.4094619687,_100,10,>100
9637,tualatin,213,30224754,97.4101484378,_100,8,>100
9638,painter,213,30224967,97.410834907,_100,7,>100
9639,lengths,213,30225180,97.4115213762,_100,7,>100
9640,tannehill,213,30225393,97.4122078453,_100,9,>100
9641,evaluations,212,30225605,97.4128910916,_100,11,>100
9642,bounds,212,30225817,97.4135743379,_100,6,>100
9643,212,212,30226029,97.4142575842,_100,3,>100
9644,dorothy,212,30226241,97.4149408305,_100,7,>100
9645,mileage,212,30226453,97.4156240769,_100,7,>100
9646,lips,212,30226665,97.4163073232,_100,4,>100
9647,mondays,212,30226877,97.4169905695,_100,7,>100
9648,sympathetic,212,30227089,97.4176738158,_100,11,>100
9649,premise,212,30227301,97.4183570621,_100,7,>100
9650,dances,212,30227513,97.4190403084,_100,6,>100
9651,platinum,212,30227725,97.4197235547,_100,8,>100
9652,fouled,212,30227937,97.420406801,_100,6,>100
9653,reduces,212,30228149,97.4210900473,_100,7,>100
9654,forbes,212,30228361,97.4217732936,_100,6,>100
9655,lananna,212,30228573,97.4224565399,_100,7,>100
9656,lohse,212,30228785,97.4231397862,_100,5,>100
9657,counselors,212,30228997,97.4238230325,_100,10,>100
9658,bain,212,30229209,97.4245062788,_100,4,>100
9659,uprising,212,30229421,97.4251895251,_100,8,>100
9660,texts,212,30229633,97.4258727714,_100,5,>100
9661,ministers,212,30229845,97.4265560177,_100,9,>100
9662,sweden,212,30230057,97.427239264,_100,6,>100
9663,arc,212,30230269,97.4279225103,_100,3,>100
9664,flipped,212,30230481,97.4286057566,_100,7,>100
9665,pierre,212,30230693,97.4292890029,_100,6,>100
9666,cite,212,30230905,97.4299722492,_100,4,>100
9667,birmingham,212,30231117,97.4306554955,_100,10,>100
9668,lax,212,30231329,97.4313387419,_100,3,>100
9669,roadside,212,30231541,97.4320219882,_100,8,>100
9670,fudge,212,30231753,97.4327052345,_100,5,>100
9671,chamberlain,211,30231964,97.4333852579,_100,11,>100
9672,evolving,211,30232175,97.4340652813,_100,8,>100
9673,revelation,211,30232386,97.4347453048,_100,10,>100
9674,linking,211,30232597,97.4354253282,_100,7,>100
9675,goldstein,211,30232808,97.4361053517,_100,9,>100
9676,nerves,211,30233019,97.4367853751,_100,6,>100
9677,mohammed,211,30233230,97.4374653986,_100,8,>100
9678,dioxide,211,30233441,97.438145422,_100,7,>100
9679,livingston,211,30233652,97.4388254455,_100,10,>100
9680,notorious,211,30233863,97.4395054689,_100,9,>100
9681,unsafe,211,30234074,97.4401854923,_100,6,>100
9682,screened,211,30234285,97.4408655158,_100,8,>100
9683,flee,211,30234496,97.4415455392,_100,4,>100
9684,advisor,211,30234707,97.4422255627,_100,7,>100
9685,whitaker,211,30234918,97.4429055861,_100,8,>100
9686,bullets,211,30235129,97.4435856096,_100,7,>100
9687,relocate,211,30235340,97.444265633,_100,8,>100
9688,211,211,30235551,97.4449456565,_100,3,>100
9689,proposes,211,30235762,97.4456256799,_100,8,>100
9690,rusty,211,30235973,97.4463057033,_100,5,>100
9691,pueblo,210,30236183,97.4469825039,_100,6,>100
9692,fishermen,210,30236393,97.4476593045,_100,9,>100
9693,supervised,210,30236603,97.4483361051,_100,10,>100
9694,pointe,210,30236813,97.4490129057,_100,6,>100
9695,strauss,210,30237023,97.4496897063,_100,7,>100
9696,punish,210,30237233,97.4503665069,_100,6,>100
9697,digs,210,30237443,97.4510433074,_100,4,>100
9698,stein,210,30237653,97.451720108,_100,5,>100
9699,remake,210,30237863,97.4523969086,_100,6,>100
9700,baxter,210,30238073,97.4530737092,_100,6,>100
9701,paso,210,30238283,97.4537505098,_100,4,>100
9702,smoky,210,30238493,97.4544273104,_100,5,>100
9703,cowboy,210,30238703,97.4551041109,_100,6,>100
9704,granddaughter,210,30238913,97.4557809115,_100,13,>100
9705,delighted,210,30239123,97.4564577121,_100,9,>100
9706,oversaw,210,30239333,97.4571345127,_100,7,>100
9707,refusal,210,30239543,97.4578113133,_100,7,>100
9708,weakened,210,30239753,97.4584881139,_100,8,>100
9709,demonstrates,210,30239963,97.4591649145,_100,12,>100
9710,soundtrack,210,30240173,97.459841715,_100,10,>100
9711,rooted,210,30240383,97.4605185156,_100,6,>100
9712,drafts,210,30240593,97.4611953162,_100,6,>100
9713,210,210,30240803,97.4618721168,_100,3,>100
9714,mayes,210,30241013,97.4625489174,_100,5,>100
9715,ambrose,209,30241222,97.4632224951,_100,7,>100
9716,greer,209,30241431,97.4638960728,_100,5,>100
9717,edited,209,30241640,97.4645696505,_100,6,>100
9718,attends,209,30241849,97.4652432283,_100,7,>100
9719,comparisons,209,30242058,97.465916806,_100,11,>100
9720,comics,209,30242267,97.4665903837,_100,6,>100
9721,alfred,209,30242476,97.4672639614,_100,6,>100
9722,palate,209,30242685,97.4679375392,_100,6,>100
9723,fixtures,209,30242894,97.4686111169,_100,8,>100
9724,dentist,209,30243103,97.4692846946,_100,7,>100
9725,implementing,209,30243312,97.4699582723,_100,12,>100
9726,da,209,30243521,97.4706318501,_100,2,>100
9727,punk,209,30243730,97.4713054278,_100,4,>100
9728,ne,209,30243939,97.4719790055,_100,2,>100
9729,virgin,209,30244148,97.4726525832,_100,6,>100
9730,casa,209,30244357,97.473326161,_100,4,>100
9731,carnegie,209,30244566,97.4739997387,_100,8,>100
9732,storytelling,209,30244775,97.4746733164,_100,12,>100
9733,cabernet,209,30244984,97.4753468941,_100,8,>100
9734,karzai,209,30245193,97.4760204719,_100,6,>100
9735,experimental,209,30245402,97.4766940496,_100,12,>100
9736,directs,209,30245611,97.4773676273,_100,7,>100
9737,hispanics,209,30245820,97.478041205,_100,9,>100
9738,ymca,209,30246029,97.4787147828,_100,4,>100
9739,merits,209,30246238,97.4793883605,_100,6,>100
9740,byrd,209,30246447,97.4800619382,_100,4,>100
9741,ammunition,209,30246656,97.4807355159,_100,10,>100
9742,contracting,209,30246865,97.4814090937,_100,11,>100
9743,roberto,208,30247073,97.4820794485,_100,7,>100
9744,bees,208,30247281,97.4827498034,_100,4,>100
9745,pepsi,208,30247489,97.4834201583,_100,5,>100
9746,neat,208,30247697,97.4840905131,_100,4,>100
9747,plunge,208,30247905,97.484760868,_100,6,>100
9748,medicines,208,30248113,97.4854312228,_100,9,>100
9749,millionaires,208,30248321,97.4861015777,_100,12,>100
9750,outfits,208,30248529,97.4867719326,_100,7,>100
9751,clips,208,30248737,97.4874422874,_100,5,>100
9752,waivers,208,30248945,97.4881126423,_100,7,>100
9753,biography,208,30249153,97.4887829972,_100,9,>100
9754,adopting,208,30249361,97.489453352,_100,8,>100
9755,fresno,208,30249569,97.4901237069,_100,6,>100
9756,crosses,208,30249777,97.4907940618,_100,7,>100
9757,printing,208,30249985,97.4914644166,_100,8,>100
9758,conscience,208,30250193,97.4921347715,_100,10,>100
9759,concussions,208,30250401,97.4928051264,_100,11,>100
9760,contributor,208,30250609,97.4934754812,_100,11,>100
9761,coins,207,30250816,97.4941426132,_100,5,>100
9762,gays,207,30251023,97.4948097452,_100,4,>100
9763,brains,207,30251230,97.4954768772,_100,6,>100
9764,lunches,207,30251437,97.4961440092,_100,7,>100
9765,rebuilt,207,30251644,97.4968111412,_100,7,>100
9766,steele,207,30251851,97.4974782733,_100,6,>100
9767,rub,207,30252058,97.4981454053,_100,3,>100
9768,lasts,207,30252265,97.4988125373,_100,5,>100
9769,scoop,207,30252472,97.4994796693,_100,5,>100
9770,socks,207,30252679,97.5001468013,_100,5,>100
9771,hazardous,207,30252886,97.5008139333,_100,9,>100
9772,kabul,207,30253093,97.5014810653,_100,5,>100
9773,pipelines,207,30253300,97.5021481973,_100,9,>100
9774,chiles,207,30253507,97.5028153293,_100,6,>100
9775,astros,207,30253714,97.5034824613,_100,6,>100
9776,dt,207,30253921,97.5041495933,_100,2,>100
9777,wastewater,207,30254128,97.5048167253,_100,10,>100
9778,forged,207,30254335,97.5054838573,_100,6,>100
9779,bunt,207,30254542,97.5061509893,_100,4,>100
9780,shadows,207,30254749,97.5068181213,_100,7,>100
9781,rang,207,30254956,97.5074852533,_100,4,>100
9782,discharge,207,30255163,97.5081523853,_100,9,>100
9783,presbyterian,207,30255370,97.5088195173,_100,12,>100
9784,dalton,207,30255577,97.5094866493,_100,6,>100
9785,acknowledging,207,30255784,97.5101537813,_100,13,>100
9786,unwilling,207,30255991,97.5108209133,_100,9,>100
9787,wentzville,207,30256198,97.5114880453,_100,10,>100
9788,dl,207,30256405,97.5121551774,_100,2,>100
9789,trek,207,30256612,97.5128223094,_100,4,>100
9790,swelling,207,30256819,97.5134894414,_100,8,>100
9791,outings,207,30257026,97.5141565734,_100,7,>100
9792,sectional,207,30257233,97.5148237054,_100,9,>100
9793,indicator,207,30257440,97.5154908374,_100,9,>100
9794,distress,207,30257647,97.5161579694,_100,8,>100
9795,patty,207,30257854,97.5168251014,_100,5,>100
9796,slap,207,30258061,97.5174922334,_100,4,>100
9797,hornets,207,30258268,97.5181593654,_100,7,>100
9798,batchelder,207,30258475,97.5188264974,_100,10,>100
9799,drilled,207,30258682,97.5194936294,_100,7,>100
9800,greet,207,30258889,97.5201607614,_100,5,>100
9801,rutherford,207,30259096,97.5208278934,_100,10,>100
9802,eurozone,206,30259302,97.5214918026,_100,8,>100
9803,reigning,206,30259508,97.5221557117,_100,8,>100
9804,vet,206,30259714,97.5228196208,_100,3,>100
9805,wolfe,206,30259920,97.52348353,_100,5,>100
9806,roland,206,30260126,97.5241474391,_100,6,>100
9807,chilled,206,30260332,97.5248113483,_100,7,>100
9808,fever,206,30260538,97.5254752574,_100,5,>100
9809,consolidation,206,30260744,97.5261391666,_100,13,>100
9810,buddies,206,30260950,97.5268030757,_100,7,>100
9811,sherwood,206,30261156,97.5274669849,_100,8,>100
9812,206,206,30261362,97.528130894,_100,3,>100
9813,ronnie,206,30261568,97.5287948032,_100,6,>100
9814,arabia,206,30261774,97.5294587123,_100,6,>100
9815,jorge,206,30261980,97.5301226214,_100,5,>100
9816,cheryl,206,30262186,97.5307865306,_100,6,>100
9817,hyatt,206,30262392,97.5314504397,_100,5,>100
9818,stevenson,206,30262598,97.5321143489,_100,9,>100
9819,induction,206,30262804,97.532778258,_100,9,>100
9820,complimentary,206,30263010,97.5334421672,_100,13,>100
9821,brittany,206,30263216,97.5341060763,_100,8,>100
9822,setup,206,30263422,97.5347699855,_100,5,>100
9823,samantha,206,30263628,97.5354338946,_100,8,>100
9824,absurd,206,30263834,97.5360978037,_100,6,>100
9825,scan,206,30264040,97.5367617129,_100,4,>100
9826,timber,206,30264246,97.537425622,_100,6,>100
9827,compromised,206,30264452,97.5380895312,_100,11,>100
9828,brooke,206,30264658,97.5387534403,_100,6,>100
9829,external,206,30264864,97.5394173495,_100,8,>100
9830,pharmacies,206,30265070,97.5400812586,_100,10,>100
9831,carts,206,30265276,97.5407451678,_100,5,>100
9832,jacqueline,206,30265482,97.5414090769,_100,10,>100
9833,sponsorship,205,30265687,97.5420697632,_100,11,>100
9834,behavioral,205,30265892,97.5427304495,_100,10,>100
9835,ernie,205,30266097,97.5433911358,_100,5,>100
9836,weeds,205,30266302,97.544051822,_100,5,>100
9837,advertisers,205,30266507,97.5447125083,_100,11,>100
9838,blackberry,205,30266712,97.5453731946,_100,10,>100
9839,turkish,205,30266917,97.5460338809,_100,7,>100
9840,powered,205,30267122,97.5466945672,_100,7,>100
9841,winfrey,205,30267327,97.5473552535,_100,7,>100
9842,responders,205,30267532,97.5480159397,_100,10,>100
9843,koch,205,30267737,97.548676626,_100,4,>100
9844,forgive,205,30267942,97.5493373123,_100,7,>100
9845,vaughn,205,30268147,97.5499979986,_100,6,>100
9846,stumbled,205,30268352,97.5506586849,_100,8,>100
9847,perch,205,30268557,97.5513193712,_100,5,>100
9848,sunlight,205,30268762,97.5519800575,_100,8,>100
9849,tunnels,205,30268967,97.5526407437,_100,7,>100
9850,tighter,205,30269172,97.55330143,_100,7,>100
9851,madness,205,30269377,97.5539621163,_100,7,>100
9852,hardy,205,30269582,97.5546228026,_100,5,>100
9853,fiesta,205,30269787,97.5552834889,_100,6,>100
9854,peaked,205,30269992,97.5559441752,_100,6,>100
9855,grabs,205,30270197,97.5566048615,_100,5,>100
9856,205,205,30270402,97.5572655477,_100,3,>100
9857,moisture,205,30270607,97.557926234,_100,8,>100
9858,aclu,205,30270812,97.5585869203,_100,4,>100
9859,makeover,205,30271017,97.5592476066,_100,8,>100
9860,heckert,205,30271222,97.5599082929,_100,7,>100
9861,scallops,205,30271427,97.5605689792,_100,8,>100
9862,coordinate,205,30271632,97.5612296654,_100,10,>100
9863,catering,205,30271837,97.5618903517,_100,8,>100
9864,wong,204,30272041,97.5625478152,_100,4,>100
9865,drastic,204,30272245,97.5632052786,_100,7,>100
9866,accompany,204,30272449,97.563862742,_100,9,>100
9867,alexis,204,30272653,97.5645202054,_100,6,>100
9868,outbreak,204,30272857,97.5651776689,_100,8,>100
9869,goaltender,204,30273061,97.5658351323,_100,10,>100
9870,hyundai,204,30273265,97.5664925957,_100,7,>100
9871,decorative,204,30273469,97.5671500591,_100,10,>100
9872,calvin,204,30273673,97.5678075226,_100,6,>100
9873,fixture,204,30273877,97.568464986,_100,7,>100
9874,racist,204,30274081,97.5691224494,_100,6,>100
9875,dispatcher,204,30274285,97.5697799128,_100,10,>100
9876,adequately,204,30274489,97.5704373763,_100,10,>100
9877,remarkably,204,30274693,97.5710948397,_100,10,>100
9878,monitored,204,30274897,97.5717523031,_100,9,>100
9879,soups,204,30275101,97.5724097665,_100,5,>100
9880,gabor,204,30275305,97.57306723,_100,5,>100
9881,motel,204,30275509,97.5737246934,_100,5,>100
9882,diminished,204,30275713,97.5743821568,_100,10,>100
9883,zack,204,30275917,97.5750396202,_100,4,>100
9884,sheldon,204,30276121,97.5756970837,_100,7,>100
9885,hated,204,30276325,97.5763545471,_100,5,>100
9886,evangelical,204,30276529,97.5770120105,_100,11,>100
9887,ruin,204,30276733,97.5776694739,_100,4,>100
9888,admitting,204,30276937,97.5783269374,_100,9,>100
9889,tub,204,30277141,97.5789844008,_100,3,>100
9890,streaming,204,30277345,97.5796418642,_100,9,>100
9891,danced,204,30277549,97.5802993276,_100,6,>100
9892,refrigerate,204,30277753,97.5809567911,_100,11,>100
9893,hayden,204,30277957,97.5816142545,_100,6,>100
9894,mickelson,204,30278161,97.5822717179,_100,9,>100
9895,greeting,204,30278365,97.5829291813,_100,8,>100
9896,pistol,204,30278569,97.5835866448,_100,6,>100
9897,nonstop,204,30278773,97.5842441082,_100,7,>100
9898,installment,204,30278977,97.5849015716,_100,11,>100
9899,woodward,204,30279181,97.585559035,_100,8,>100
9900,improves,204,30279385,97.5862164985,_100,8,>100
9901,proportion,204,30279589,97.5868739619,_100,10,>100
9902,taped,204,30279793,97.5875314253,_100,5,>100
9903,recruitment,204,30279997,97.5881888887,_100,11,>100
9904,tds,203,30280200,97.5888431293,_100,3,>100
9905,literacy,203,30280403,97.5894973699,_100,8,>100
9906,towering,203,30280606,97.5901516104,_100,8,>100
9907,ash,203,30280809,97.590805851,_100,3,>100
9908,mpg,203,30281012,97.5914600916,_100,3,>100
9909,shaved,203,30281215,97.5921143321,_100,6,>100
9910,downward,203,30281418,97.5927685727,_100,8,>100
9911,puree,203,30281621,97.5934228132,_100,5,>100
9912,drone,203,30281824,97.5940770538,_100,5,>100
9913,incomplete,203,30282027,97.5947312944,_100,10,>100
9914,defines,203,30282230,97.5953855349,_100,7,>100
9915,construct,203,30282433,97.5960397755,_100,9,>100
9916,dumb,203,30282636,97.5966940161,_100,4,>100
9917,eats,203,30282839,97.5973482566,_100,4,>100
9918,enabled,203,30283042,97.5980024972,_100,7,>100
9919,supplied,203,30283245,97.5986567378,_100,8,>100
9920,summary,203,30283448,97.5993109783,_100,7,>100
9921,hammered,203,30283651,97.5999652189,_100,8,>100
9922,awaits,203,30283854,97.6006194595,_100,6,>100
9923,moyer,203,30284057,97.6012737,_100,5,>100
9924,overshadowed,203,30284260,97.6019279406,_100,12,>100
9925,griffith,203,30284463,97.6025821812,_100,8,>100
9926,surreal,203,30284666,97.6032364217,_100,7,>100
9927,thrilling,203,30284869,97.6038906623,_100,9,>100
9928,footprint,203,30285072,97.6045449029,_100,9,>100
9929,senser,203,30285275,97.6051991434,_100,6,>100
9930,bailouts,203,30285478,97.605853384,_100,8,>100
9931,amended,203,30285681,97.6065076245,_100,7,>100
9932,vip,203,30285884,97.6071618651,_100,3,>100
9933,facial,203,30286087,97.6078161057,_100,6,>100
9934,benches,203,30286290,97.6084703462,_100,7,>100
9935,arraigned,203,30286493,97.6091245868,_100,9,>100
9936,flagship,203,30286696,97.6097788274,_100,8,>100
9937,backlash,203,30286899,97.6104330679,_100,8,>100
9938,creations,202,30287101,97.6110840856,_100,9,>100
9939,wires,202,30287303,97.6117351033,_100,5,>100
9940,enact,202,30287505,97.6123861211,_100,5,>100
9941,electoral,202,30287707,97.6130371388,_100,9,>100
9942,cdc,202,30287909,97.6136881565,_100,3,>100
9943,merrill,202,30288111,97.6143391742,_100,7,>100
9944,peer,202,30288313,97.6149901919,_100,4,>100
9945,toe,202,30288515,97.6156412096,_100,3,>100
9946,georgetown,202,30288717,97.6162922273,_100,10,>100
9947,payday,202,30288919,97.616943245,_100,6,>100
9948,piles,202,30289121,97.6175942627,_100,5,>100
9949,tended,202,30289323,97.6182452804,_100,6,>100
9950,202,202,30289525,97.6188962981,_100,3,>100
9951,hugh,202,30289727,97.6195473158,_100,4,>100
9952,comedian,202,30289929,97.6201983335,_100,8,>100
9953,ailing,202,30290131,97.6208493512,_100,6,>100
9954,pains,202,30290333,97.6215003689,_100,5,>100
9955,pounding,202,30290535,97.6221513866,_100,8,>100
9956,ejected,202,30290737,97.6228024043,_100,7,>100
9957,monte,202,30290939,97.623453422,_100,5,>100
9958,manor,202,30291141,97.6241044397,_100,5,>100
9959,mcgee,202,30291343,97.6247554574,_100,5,>100
9960,flock,202,30291545,97.6254064752,_100,5,>100
9961,devin,202,30291747,97.6260574929,_100,5,>100
9962,lyons,202,30291949,97.6267085106,_100,5,>100
9963,arundel,202,30292151,97.6273595283,_100,7,>100
9964,201,201,30292352,97.6280073231,_100,3,>100
9965,overcame,201,30292553,97.628655118,_100,8,>100
9966,sentinel,201,30292754,97.6293029128,_100,8,>100
9967,seize,201,30292955,97.6299507076,_100,5,>100
9968,insiders,201,30293156,97.6305985025,_100,8,>100
9969,cushion,201,30293357,97.6312462973,_100,7,>100
9970,reacted,201,30293558,97.6318940922,_100,7,>100
9971,condemned,201,30293759,97.632541887,_100,9,>100
9972,maya,201,30293960,97.6331896819,_100,4,>100
9973,cathy,201,30294161,97.6338374767,_100,5,>100
9974,controller,201,30294362,97.6344852716,_100,10,>100
9975,regulated,201,30294563,97.6351330664,_100,9,>100
9976,refuge,201,30294764,97.6357808613,_100,6,>100
9977,cruel,201,30294965,97.6364286561,_100,5,>100
9978,interviewing,201,30295166,97.6370764509,_100,12,>100
9979,deceased,201,30295367,97.6377242458,_100,8,>100
9980,coupons,201,30295568,97.6383720406,_100,7,>100
9981,easing,201,30295769,97.6390198355,_100,6,>100
9982,landfill,201,30295970,97.6396676303,_100,8,>100
9983,cooperative,201,30296171,97.6403154252,_100,11,>100
9984,landlord,201,30296372,97.64096322,_100,8,>100
9985,enforcing,201,30296573,97.6416110149,_100,9,>100
9986,medley,201,30296774,97.6422588097,_100,6,>100
9987,kovalchuk,201,30296975,97.6429066045,_100,9,>100
9988,cement,201,30297176,97.6435543994,_100,6,>100
9989,sway,201,30297377,97.6442021942,_100,4,>100
9990,successes,201,30297578,97.6448499891,_100,9,>100
9991,miniature,201,30297779,97.6454977839,_100,9,>100
9992,airing,201,30297980,97.6461455788,_100,6,>100
9993,payouts,201,30298181,97.6467933736,_100,7,>100
9994,toddler,201,30298382,97.6474411685,_100,7,>100
9995,unexpectedly,200,30298582,97.6480857404,_100,12,>100
9996,rendered,200,30298782,97.6487303124,_100,8,>100
9997,gina,200,30298982,97.6493748844,_100,4,>100
9998,levine,200,30299182,97.6500194564,_100,6,>100
9999,medalist,200,30299382,97.6506640284,_100,8,>100
10000,safeway,200,30299582,97.6513086004,_100,7,>100
10001,easiest,200,30299782,97.6519531724,_100,7,>100
10002,200,200,30299982,97.6525977443,_100,3,>100
10003,playwright,200,30300182,97.6532423163,_100,10,>100
10004,lungs,200,30300382,97.6538868883,_100,5,>100
10005,slash,200,30300582,97.6545314603,_100,5,>100
10006,beings,200,30300782,97.6551760323,_100,6,>100
10007,praying,200,30300982,97.6558206043,_100,7,>100
10008,heightened,200,30301182,97.6564651763,_100,10,>100
10009,tossing,200,30301382,97.6571097482,_100,7,>100
10010,trojans,200,30301582,97.6577543202,_100,7,>100
10011,courtyard,200,30301782,97.6583988922,_100,9,>100
10012,skepticism,200,30301982,97.6590434642,_100,10,>100
10013,arden,200,30302182,97.6596880362,_100,5,>100
10014,gunfire,200,30302382,97.6603326082,_100,7,>100
10015,fischer,200,30302582,97.6609771802,_100,7,>100
10016,resisted,200,30302782,97.6616217521,_100,8,>100
10017,presumptive,200,30302982,97.6622663241,_100,11,>100
10018,outraged,200,30303182,97.6629108961,_100,8,>100
10019,youthful,200,30303382,97.6635554681,_100,8,>100
10020,languages,200,30303582,97.6642000401,_100,9,>100
10021,honorable,200,30303782,97.6648446121,_100,9,>100
10022,robbins,200,30303982,97.665489184,_100,7,>100
10023,adjusting,200,30304182,97.666133756,_100,9,>100
10024,loads,199,30304381,97.6667751052,_100,5,>100
10025,clearance,199,30304580,97.6674164543,_100,9,>100
10026,scam,199,30304779,97.6680578034,_100,4,>100
10027,doses,199,30304978,97.6686991525,_100,5,>100
10028,envelope,199,30305177,97.6693405017,_100,8,>100
10029,entertain,199,30305376,97.6699818508,_100,9,>100
10030,ebay,199,30305575,97.6706231999,_100,4,>100
10031,ensuing,199,30305774,97.671264549,_100,7,>100
10032,crossover,199,30305973,97.6719058982,_100,9,>100
10033,foundations,199,30306172,97.6725472473,_100,11,>100
10034,enthusiasts,199,30306371,97.6731885964,_100,11,>100
10035,readings,199,30306570,97.6738299455,_100,8,>100
10036,partnered,199,30306769,97.6744712947,_100,9,>100
10037,prevents,199,30306968,97.6751126438,_100,8,>100
10038,profiles,199,30307167,97.6757539929,_100,8,>100
10039,amazed,199,30307366,97.676395342,_100,6,>100
10040,claiborne,199,30307565,97.6770366912,_100,9,>100
10041,erickson,199,30307764,97.6776780403,_100,8,>100
10042,arraignment,199,30307963,97.6783193894,_100,11,>100
10043,hickenlooper,199,30308162,97.6789607385,_100,12,>100
10044,vigorous,199,30308361,97.6796020877,_100,8,>100
10045,bottled,199,30308560,97.6802434368,_100,7,>100
10046,platforms,199,30308759,97.6808847859,_100,9,>100
10047,discomfort,199,30308958,97.681526135,_100,10,>100
10048,frances,199,30309157,97.6821674842,_100,7,>100
10049,cracking,199,30309356,97.6828088333,_100,8,>100
10050,hikers,198,30309554,97.6834469596,_100,6,>100
10051,dominance,198,30309752,97.6840850858,_100,9,>100
10052,cannon,198,30309950,97.6847232121,_100,6,>100
10053,elias,198,30310148,97.6853613384,_100,5,>100
10054,nina,198,30310346,97.6859994646,_100,4,>100
10055,sturdy,198,30310544,97.6866375909,_100,6,>100
10056,pretend,198,30310742,97.6872757171,_100,7,>100
10057,newcomer,198,30310940,97.6879138434,_100,8,>100
10058,pedro,198,30311138,97.6885519697,_100,5,>100
10059,outdated,198,30311336,97.6891900959,_100,8,>100
10060,niece,198,30311534,97.6898282222,_100,5,>100
10061,bets,198,30311732,97.6904663485,_100,4,>100
10062,paramedics,198,30311930,97.6911044747,_100,10,>100
10063,gaga,198,30312128,97.691742601,_100,4,>100
10064,spacious,198,30312326,97.6923807273,_100,8,>100
10065,showalter,198,30312524,97.6930188535,_100,9,>100
10066,contacts,198,30312722,97.6936569798,_100,8,>100
10067,glorious,198,30312920,97.6942951061,_100,8,>100
10068,elusive,198,30313118,97.6949332323,_100,7,>100
10069,abby,198,30313316,97.6955713586,_100,4,>100
10070,remedy,198,30313514,97.6962094849,_100,6,>100
10071,adidas,198,30313712,97.6968476111,_100,6,>100
10072,miranda,198,30313910,97.6974857374,_100,7,>100
10073,achieving,198,30314108,97.6981238637,_100,9,>100
10074,grind,198,30314306,97.6987619899,_100,5,>100
10075,unfamiliar,198,30314504,97.6994001162,_100,10,>100
10076,prosecute,198,30314702,97.7000382425,_100,9,>100
10077,obsession,198,30314900,97.7006763687,_100,9,>100
10078,abundance,198,30315098,97.701314495,_100,9,>100
10079,worlds,198,30315296,97.7019526213,_100,6,>100
10080,sculptures,198,30315494,97.7025907475,_100,10,>100
10081,favre,198,30315692,97.7032288738,_100,5,>100
10082,confined,198,30315890,97.703867,_100,8,>100
10083,horton,197,30316087,97.7045019035,_100,6,>100
10084,conceived,197,30316284,97.7051368069,_100,9,>100
10085,parmesan,197,30316481,97.7057717103,_100,8,>100
10086,bradshaw,197,30316678,97.7064066137,_100,8,>100
10087,deportation,197,30316875,97.7070415171,_100,11,>100
10088,traumatic,197,30317072,97.7076764205,_100,9,>100
10089,editing,197,30317269,97.7083113239,_100,7,>100
10090,swallow,197,30317466,97.7089462273,_100,7,>100
10091,shapiro,197,30317663,97.7095811307,_100,7,>100
10092,insisting,197,30317860,97.7102160341,_100,9,>100
10093,saga,197,30318057,97.7108509375,_100,4,>100
10094,morrow,197,30318254,97.7114858409,_100,6,>100
10095,realm,197,30318451,97.7121207443,_100,5,>100
10096,conventions,197,30318648,97.7127556477,_100,11,>100
10097,kitchens,197,30318845,97.7133905511,_100,8,>100
10098,timeout,197,30319042,97.7140254545,_100,7,>100
10099,tolerance,197,30319239,97.7146603579,_100,9,>100
10100,marketed,197,30319436,97.7152952613,_100,8,>100
10101,trendy,197,30319633,97.7159301648,_100,6,>100
10102,boycott,197,30319830,97.7165650682,_100,7,>100
10103,attendant,197,30320027,97.7171999716,_100,9,>100
10104,homicides,197,30320224,97.717834875,_100,9,>100
10105,bryce,197,30320421,97.7184697784,_100,5,>100
10106,internationally,197,30320618,97.7191046818,_100,15,>100
10107,skiing,197,30320815,97.7197395852,_100,6,>100
10108,remembering,197,30321012,97.7203744886,_100,11,>100
10109,gritty,197,30321209,97.721009392,_100,6,>100
10110,chatham,197,30321406,97.7216442954,_100,7,>100
10111,abstract,197,30321603,97.7222791988,_100,8,>100
10112,mozzarella,196,30321799,97.7229108794,_100,10,>100
10113,shelton,196,30321995,97.7235425599,_100,7,>100
10114,socialist,196,30322191,97.7241742404,_100,9,>100
10115,dams,196,30322387,97.724805921,_100,4,>100
10116,circulation,196,30322583,97.7254376015,_100,11,>100
10117,anchored,196,30322779,97.7260692821,_100,8,>100
10118,bishops,196,30322975,97.7267009626,_100,7,>100
10119,domain,196,30323171,97.7273326432,_100,6,>100
10120,clarke,196,30323367,97.7279643237,_100,6,>100
10121,traction,196,30323563,97.7285960043,_100,8,>100
10122,flavorful,196,30323759,97.7292276848,_100,9,>100
10123,slipping,196,30323955,97.7298593654,_100,8,>100
10124,detailing,196,30324151,97.7304910459,_100,9,>100
10125,hail,196,30324347,97.7311227264,_100,4,>100
10126,omaha,196,30324543,97.731754407,_100,5,>100
10127,loudly,196,30324739,97.7323860875,_100,6,>100
10128,hoover,196,30324935,97.7330177681,_100,6,>100
10129,breakout,196,30325131,97.7336494486,_100,8,>100
10130,panama,196,30325327,97.7342811292,_100,6,>100
10131,thyme,196,30325523,97.7349128097,_100,5,>100
10132,calculations,196,30325719,97.7355444903,_100,12,>100
10133,unavailable,196,30325915,97.7361761708,_100,11,>100
10134,demeanor,196,30326111,97.7368078514,_100,8,>100
10135,cds,196,30326307,97.7374395319,_100,3,>100
10136,geared,196,30326503,97.7380712124,_100,6,>100
10137,polite,196,30326699,97.738702893,_100,6,>100
10138,bales,196,30326895,97.7393345735,_100,5,>100
10139,injunction,196,30327091,97.7399662541,_100,10,>100
10140,jerusalem,196,30327287,97.7405979346,_100,9,>100
10141,magnificent,196,30327483,97.7412296152,_100,11,>100
10142,custard,196,30327679,97.7418612957,_100,7,>100
10143,revoked,196,30327875,97.7424929763,_100,7,>100
10144,salesman,196,30328071,97.7431246568,_100,8,>100
10145,weinstein,196,30328267,97.7437563374,_100,9,>100
10146,mural,196,30328463,97.7443880179,_100,5,>100
10147,omar,196,30328659,97.7450196984,_100,4,>100
10148,appointees,196,30328855,97.745651379,_100,10,>100
10149,theirs,196,30329051,97.7462830595,_100,6,>100
10150,cult,196,30329247,97.7469147401,_100,4,>100
10151,captures,195,30329442,97.7475431978,_100,8,>100
10152,flurry,195,30329637,97.7481716554,_100,6,>100
10153,realities,195,30329832,97.7488001131,_100,9,>100
10154,cbc,195,30330027,97.7494285708,_100,3,>100
10155,195,195,30330222,97.7500570285,_100,3,>100
10156,buyout,195,30330417,97.7506854862,_100,6,>100
10157,acquitted,195,30330612,97.7513139439,_100,9,>100
10158,realizes,195,30330807,97.7519424016,_100,8,>100
10159,messy,195,30331002,97.7525708592,_100,5,>100
10160,creve,195,30331197,97.7531993169,_100,5,>100
10161,speedway,195,30331392,97.7538277746,_100,8,>100
10162,embracing,195,30331587,97.7544562323,_100,9,>100
10163,bolton,195,30331782,97.75508469,_100,6,>100
10164,browned,195,30331977,97.7557131477,_100,7,>100
10165,carbohydrates,195,30332172,97.7563416054,_100,13,>100
10166,dominating,195,30332367,97.756970063,_100,10,>100
10167,durable,195,30332562,97.7575985207,_100,7,>100
10168,maes,195,30332757,97.7582269784,_100,4,>100
10169,bouncing,195,30332952,97.7588554361,_100,8,>100
10170,redwood,195,30333147,97.7594838938,_100,7,>100
10171,footing,195,30333342,97.7601123515,_100,7,>100
10172,donating,195,30333537,97.7607408092,_100,8,>100
10173,lifts,195,30333732,97.7613692668,_100,5,>100
10174,myriad,195,30333927,97.7619977245,_100,6,>100
10175,graves,195,30334122,97.7626261822,_100,6,>100
10176,laurie,195,30334317,97.7632546399,_100,6,>100
10177,bowman,195,30334512,97.7638830976,_100,6,>100
10178,kits,195,30334707,97.7645115553,_100,4,>100
10179,scrambled,195,30334902,97.765140013,_100,9,>100
10180,mornings,195,30335097,97.7657684706,_100,8,>100
10181,sixers,195,30335292,97.7663969283,_100,6,>100
10182,prompt,195,30335487,97.767025386,_100,6,>100
10183,packaging,195,30335682,97.7676538437,_100,9,>100
10184,cove,195,30335877,97.7682823014,_100,4,>100
10185,speedy,194,30336071,97.7689075362,_100,6,>100
10186,professionally,194,30336265,97.769532771,_100,14,>100
10187,photographed,194,30336459,97.7701580059,_100,12,>100
10188,reorganization,194,30336653,97.7707832407,_100,14,>100
10189,riots,194,30336847,97.7714084755,_100,5,>100
10190,194,194,30337041,97.7720337103,_100,3,>100
10191,bedford,194,30337235,97.7726589452,_100,7,>100
10192,tallied,194,30337429,97.77328418,_100,7,>100
10193,iv,194,30337623,97.7739094148,_100,2,>100
10194,delegate,194,30337817,97.7745346496,_100,8,>100
10195,pancakes,194,30338011,97.7751598845,_100,8,>100
10196,interfere,194,30338205,97.7757851193,_100,9,>100
10197,waist,194,30338399,97.7764103541,_100,5,>100
10198,liz,194,30338593,97.7770355889,_100,3,>100
10199,marcia,194,30338787,97.7776608238,_100,6,>100
10200,recognizing,194,30338981,97.7782860586,_100,11,>100
10201,warfare,194,30339175,97.7789112934,_100,7,>100
10202,cordova,194,30339369,97.7795365282,_100,7,>100
10203,weekday,194,30339563,97.7801617631,_100,7,>100
10204,tones,194,30339757,97.7807869979,_100,5,>100
10205,environmentally,194,30339951,97.7814122327,_100,15,>100
10206,sudan,194,30340145,97.7820374676,_100,5,>100
10207,arpaio,194,30340339,97.7826627024,_100,6,>100
10208,obscure,194,30340533,97.7832879372,_100,7,>100
10209,encouragement,194,30340727,97.783913172,_100,13,>100
10210,unity,194,30340921,97.7845384069,_100,5,>100
10211,hawthorne,194,30341115,97.7851636417,_100,9,>100
10212,przybilla,193,30341308,97.7857856536,_100,9,>100
10213,intentional,193,30341501,97.7864076656,_100,11,>100
10214,pricey,193,30341694,97.7870296776,_100,6,>100
10215,deliberately,193,30341887,97.7876516895,_100,12,>100
10216,unspecified,193,30342080,97.7882737015,_100,11,>100
10217,steaks,193,30342273,97.7888957135,_100,6,>100
10218,charters,193,30342466,97.7895177254,_100,8,>100
10219,fcc,193,30342659,97.7901397374,_100,3,>100
10220,pablo,193,30342852,97.7907617494,_100,5,>100
10221,prolific,193,30343045,97.7913837613,_100,8,>100
10222,felix,193,30343238,97.7920057733,_100,5,>100
10223,carmelo,193,30343431,97.7926277853,_100,7,>100
10224,kathryn,193,30343624,97.7932497972,_100,7,>100
10225,unfairly,193,30343817,97.7938718092,_100,8,>100
10226,gee,193,30344010,97.7944938212,_100,3,>100
10227,leaned,193,30344203,97.7951158331,_100,6,>100
10228,briefed,193,30344396,97.7957378451,_100,7,>100
10229,refugees,193,30344589,97.7963598571,_100,8,>100
10230,descriptions,193,30344782,97.796981869,_100,12,>100
10231,lansing,193,30344975,97.797603881,_100,7,>100
10232,moses,193,30345168,97.798225893,_100,5,>100
10233,gloria,193,30345361,97.7988479049,_100,6,>100
10234,tripled,193,30345554,97.7994699169,_100,7,>100
10235,speculate,193,30345747,97.8000919289,_100,9,>100
10236,surfaces,193,30345940,97.8007139408,_100,8,>100
10237,corvallis,193,30346133,97.8013359528,_100,9,>100
10238,feliciano,193,30346326,97.8019579648,_100,9,>100
10239,understandable,193,30346519,97.8025799767,_100,14,>100
10240,estates,193,30346712,97.8032019887,_100,7,>100
10241,ambitions,193,30346905,97.8038240007,_100,9,>100
10242,elliot,193,30347098,97.8044460126,_100,6,>100
10243,mechanism,193,30347291,97.8050680246,_100,9,>100
10244,dictate,192,30347483,97.8056868137,_100,7,>100
10245,antibiotics,192,30347675,97.8063056028,_100,11,>100
10246,polled,192,30347867,97.8069243919,_100,6,>100
10247,precision,192,30348059,97.807543181,_100,9,>100
10248,ethan,192,30348251,97.8081619701,_100,5,>100
10249,reply,192,30348443,97.8087807592,_100,5,>100
10250,clash,192,30348635,97.8093995483,_100,5,>100
10251,generates,192,30348827,97.8100183374,_100,9,>100
10252,preventive,192,30349019,97.8106371265,_100,10,>100
10253,pulse,192,30349211,97.8112559156,_100,5,>100
10254,mantra,192,30349403,97.8118747047,_100,6,>100
10255,jockey,192,30349595,97.8124934939,_100,6,>100
10256,import,192,30349787,97.813112283,_100,6,>100
10257,sums,192,30349979,97.8137310721,_100,4,>100
10258,olivia,192,30350171,97.8143498612,_100,6,>100
10259,mclaughlin,192,30350363,97.8149686503,_100,10,>100
10260,contended,192,30350555,97.8155874394,_100,9,>100
10261,crosby,192,30350747,97.8162062285,_100,6,>100
10262,groin,192,30350939,97.8168250176,_100,5,>100
10263,theories,192,30351131,97.8174438067,_100,8,>100
10264,citigroup,192,30351323,97.8180625958,_100,9,>100
10265,scoreboard,192,30351515,97.8186813849,_100,10,>100
10266,psal,192,30351707,97.819300174,_100,4,>100
10267,morales,192,30351899,97.8199189631,_100,7,>100
10268,pinned,192,30352091,97.8205377522,_100,6,>100
10269,kardashian,192,30352283,97.8211565413,_100,10,>100
10270,putt,192,30352475,97.8217753304,_100,4,>100
10271,discharged,192,30352667,97.8223941195,_100,10,>100
10272,angelo,192,30352859,97.8230129086,_100,6,>100
10273,impress,192,30353051,97.8236316978,_100,7,>100
10274,downstairs,192,30353243,97.8242504869,_100,10,>100
10275,cardboard,191,30353434,97.8248660531,_100,9,>100
10276,alicia,191,30353625,97.8254816194,_100,6,>100
10277,crush,191,30353816,97.8260971856,_100,5,>100
10278,freed,191,30354007,97.8267127518,_100,5,>100
10279,parliamentary,191,30354198,97.8273283181,_100,13,>100
10280,discovering,191,30354389,97.8279438843,_100,11,>100
10281,commanding,191,30354580,97.8285594506,_100,10,>100
10282,badge,191,30354771,97.8291750168,_100,5,>100
10283,sequel,191,30354962,97.8297905831,_100,6,>100
10284,sizable,191,30355153,97.8304061493,_100,7,>100
10285,nazi,191,30355344,97.8310217156,_100,4,>100
10286,seasoning,191,30355535,97.8316372818,_100,9,>100
10287,daytime,191,30355726,97.8322528481,_100,7,>100
10288,bates,191,30355917,97.8328684143,_100,5,>100
10289,warns,191,30356108,97.8334839805,_100,5,>100
10290,certainty,191,30356299,97.8340995468,_100,9,>100
10291,patents,191,30356490,97.834715113,_100,7,>100
10292,skull,191,30356681,97.8353306793,_100,5,>100
10293,dealership,191,30356872,97.8359462455,_100,10,>100
10294,micds,191,30357063,97.8365618118,_100,5,>100
10295,nicholson,191,30357254,97.837177378,_100,9,>100
10296,superhero,191,30357445,97.8377929443,_100,9,>100
10297,guessing,191,30357636,97.8384085105,_100,8,>100
10298,merge,191,30357827,97.8390240768,_100,5,>100
10299,unpredictable,191,30358018,97.839639643,_100,13,>100
10300,barber,191,30358209,97.8402552093,_100,6,>100
10301,disorderly,191,30358400,97.8408707755,_100,10,>100
10302,acre,191,30358591,97.8414863417,_100,4,>100
10303,amounted,190,30358781,97.8420986851,_100,8,>100
10304,terminated,190,30358971,97.8427110285,_100,10,>100
10305,reelection,190,30359161,97.8433233719,_100,10,>100
10306,calcium,190,30359351,97.8439357153,_100,7,>100
10307,freelance,190,30359541,97.8445480587,_100,9,>100
10308,tendency,190,30359731,97.8451604021,_100,8,>100
10309,binding,190,30359921,97.8457727454,_100,7,>100
10310,floated,190,30360111,97.8463850888,_100,7,>100
10311,190,190,30360301,97.8469974322,_100,3,>100
10312,starr,190,30360491,97.8476097756,_100,5,>100
10313,caramelized,190,30360681,97.848222119,_100,11,>100
10314,healy,190,30360871,97.8488344624,_100,5,>100
10315,terrace,190,30361061,97.8494468058,_100,7,>100
10316,rallying,190,30361251,97.8500591491,_100,8,>100
10317,youngstown,190,30361441,97.8506714925,_100,10,>100
10318,dispatch,190,30361631,97.8512838359,_100,8,>100
10319,criticize,190,30361821,97.8518961793,_100,9,>100
10320,eggplant,190,30362011,97.8525085227,_100,8,>100
10321,outspoken,190,30362201,97.8531208661,_100,9,>100
10322,morton,190,30362391,97.8537332095,_100,6,>100
10323,toppings,190,30362581,97.8543455528,_100,8,>100
10324,accountant,190,30362771,97.8549578962,_100,10,>100
10325,avery,190,30362961,97.8555702396,_100,5,>100
10326,withstand,190,30363151,97.856182583,_100,9,>100
10327,imf,190,30363341,97.8567949264,_100,3,>100
10328,plead,190,30363531,97.8574072698,_100,5,>100
10329,till,190,30363721,97.8580196132,_100,4,>100
10330,drank,190,30363911,97.8586319566,_100,5,>100
10331,spinal,190,30364101,97.8592442999,_100,6,>100
10332,animation,190,30364291,97.8598566433,_100,9,>100
10333,parcel,190,30364481,97.8604689867,_100,6,>100
10334,peaks,190,30364671,97.8610813301,_100,5,>100
10335,rebounded,190,30364861,97.8616936735,_100,9,>100
10336,advocating,190,30365051,97.8623060169,_100,10,>100
10337,stride,190,30365241,97.8629183603,_100,6,>100
10338,tolerate,190,30365431,97.8635307036,_100,8,>100
10339,resembles,190,30365621,97.864143047,_100,9,>100
10340,edwin,190,30365811,97.8647553904,_100,5,>100
10341,laptops,190,30366001,97.8653677338,_100,7,>100
10342,rehearsal,190,30366191,97.8659800772,_100,9,>100
10343,lump,190,30366381,97.8665924206,_100,4,>100
10344,servings,189,30366570,97.8672015411,_100,8,>100
10345,invisible,189,30366759,97.8678106616,_100,9,>100
10346,jeopardy,189,30366948,97.8684197821,_100,8,>100
10347,relaxing,189,30367137,97.8690289027,_100,8,>100
10348,defeating,189,30367326,97.8696380232,_100,9,>100
10349,collided,189,30367515,97.8702471437,_100,8,>100
10350,lohan,189,30367704,97.8708562643,_100,5,>100
10351,iphones,189,30367893,97.8714653848,_100,7,>100
10352,thinly,189,30368082,97.8720745053,_100,6,>100
10353,indie,189,30368271,97.8726836258,_100,5,>100
10354,baffert,189,30368460,97.8732927464,_100,7,>100
10355,jails,189,30368649,97.8739018669,_100,5,>100
10356,solving,189,30368838,97.8745109874,_100,7,>100
10357,philly,189,30369027,97.8751201079,_100,6,>100
10358,lip,189,30369216,97.8757292285,_100,3,>100
10359,bout,189,30369405,97.876338349,_100,4,>100
10360,geithner,189,30369594,97.8769474695,_100,8,>100
10361,commented,189,30369783,97.87755659,_100,9,>100
10362,biology,189,30369972,97.8781657106,_100,7,>100
10363,possess,189,30370161,97.8787748311,_100,7,>100
10364,oracle,189,30370350,97.8793839516,_100,6,>100
10365,injection,189,30370539,97.8799930721,_100,9,>100
10366,infielder,189,30370728,97.8806021927,_100,9,>100
10367,perfection,189,30370917,97.8812113132,_100,10,>100
10368,tumbled,189,30371106,97.8818204337,_100,7,>100
10369,leased,189,30371295,97.8824295542,_100,6,>100
10370,mccluer,189,30371484,97.8830386748,_100,7,>100
10371,lobbied,189,30371673,97.8836477953,_100,7,>100
10372,kristin,189,30371862,97.8842569158,_100,7,>100
10373,maximize,189,30372051,97.8848660363,_100,8,>100
10374,scholars,188,30372239,97.885471934,_100,8,>100
10375,postgame,188,30372427,97.8860778317,_100,8,>100
10376,machinery,188,30372615,97.8866837293,_100,9,>100
10377,capitalize,188,30372803,97.887289627,_100,10,>100
10378,envision,188,30372991,97.8878955247,_100,8,>100
10379,behaviors,188,30373179,97.8885014223,_100,9,>100
10380,withheld,188,30373367,97.88910732,_100,8,>100
10381,funk,188,30373555,97.8897132177,_100,4,>100
10382,destined,188,30373743,97.8903191153,_100,8,>100
10383,allan,188,30373931,97.890925013,_100,5,>100
10384,rematch,188,30374119,97.8915309107,_100,7,>100
10385,ineffective,188,30374307,97.8921368083,_100,11,>100
10386,softened,188,30374495,97.892742706,_100,8,>100
10387,steamed,188,30374683,97.8933486037,_100,7,>100
10388,cubes,188,30374871,97.8939545013,_100,5,>100
10389,insane,188,30375059,97.894560399,_100,6,>100
10390,midday,188,30375247,97.8951662967,_100,6,>100
10391,jar,188,30375435,97.8957721943,_100,3,>100
10392,wolverines,188,30375623,97.896378092,_100,10,>100
10393,subcommittee,188,30375811,97.8969839897,_100,12,>100
10394,surroundings,188,30375999,97.8975898873,_100,12,>100
10395,detainees,188,30376187,97.898195785,_100,9,>100
10396,racism,188,30376375,97.8988016827,_100,6,>100
10397,harden,188,30376563,97.8994075803,_100,6,>100
10398,wyatt,188,30376751,97.900013478,_100,5,>100
10399,scholar,188,30376939,97.9006193757,_100,7,>100
10400,netted,188,30377127,97.9012252733,_100,6,>100
10401,rein,188,30377315,97.901831171,_100,4,>100
10402,dazzling,188,30377503,97.9024370687,_100,8,>100
10403,meatballs,188,30377691,97.9030429663,_100,9,>100
10404,waterloo,188,30377879,97.903648864,_100,8,>100
10405,lightweight,188,30378067,97.9042547617,_100,11,>100
10406,hazard,188,30378255,97.9048606593,_100,6,>100
10407,pedal,188,30378443,97.905466557,_100,5,>100
10408,observations,187,30378630,97.9060692318,_100,12,>100
10409,bugs,187,30378817,97.9066719066,_100,4,>100
10410,characteristics,187,30379004,97.9072745814,_100,15,>100
10411,waving,187,30379191,97.9078772562,_100,6,>100
10412,caregivers,187,30379378,97.908479931,_100,10,>100
10413,digits,187,30379565,97.9090826058,_100,6,>100
10414,vacations,187,30379752,97.9096852806,_100,9,>100
10415,philippines,187,30379939,97.9102879554,_100,11,>100
10416,unarmed,187,30380126,97.9108906303,_100,7,>100
10417,milan,187,30380313,97.9114933051,_100,5,>100
10418,drewniak,187,30380500,97.9120959799,_100,8,>100
10419,annoying,187,30380687,97.9126986547,_100,8,>100
10420,oakville,187,30380874,97.9133013295,_100,8,>100
10421,rentals,187,30381061,97.9139040043,_100,7,>100
10422,fond,187,30381248,97.9145066791,_100,4,>100
10423,worthwhile,187,30381435,97.9151093539,_100,10,>100
10424,vicious,187,30381622,97.9157120287,_100,7,>100
10425,honesty,187,30381809,97.9163147035,_100,7,>100
10426,hr,187,30381996,97.9169173783,_100,2,>100
10427,explored,187,30382183,97.9175200531,_100,8,>100
10428,doomed,187,30382370,97.9181227279,_100,6,>100
10429,inserted,187,30382557,97.9187254027,_100,8,>100
10430,prius,187,30382744,97.9193280775,_100,5,>100
10431,henson,187,30382931,97.9199307523,_100,6,>100
10432,ingram,187,30383118,97.9205334271,_100,6,>100
10433,vacancy,187,30383305,97.921136102,_100,7,>100
10434,stimulate,187,30383492,97.9217387768,_100,9,>100
10435,indexes,187,30383679,97.9223414516,_100,7,>100
10436,tactic,187,30383866,97.9229441264,_100,6,>100
10437,handmade,187,30384053,97.9235468012,_100,8,>100
10438,wonderfully,187,30384240,97.924149476,_100,11,>100
10439,shortages,187,30384427,97.9247521508,_100,9,>100
10440,alcoholic,187,30384614,97.9253548256,_100,9,>100
10441,sadness,187,30384801,97.9259575004,_100,7,>100
10442,darrell,187,30384988,97.9265601752,_100,7,>100
10443,umbrella,187,30385175,97.92716285,_100,8,>100
10444,locks,187,30385362,97.9277655248,_100,5,>100
10445,joking,186,30385548,97.9283649768,_100,6,>100
10446,exposing,186,30385734,97.9289644287,_100,8,>100
10447,keyboard,186,30385920,97.9295638807,_100,8,>100
10448,bumps,186,30386106,97.9301633326,_100,5,>100
10449,walgreens,186,30386292,97.9307627846,_100,9,>100
10450,resumes,186,30386478,97.9313622365,_100,7,>100
10451,entree,186,30386664,97.9319616884,_100,6,>100
10452,pact,186,30386850,97.9325611404,_100,4,>100
10453,lennon,186,30387036,97.9331605923,_100,6,>100
10454,novak,186,30387222,97.9337600443,_100,5,>100
10455,choo,186,30387408,97.9343594962,_100,4,>100
10456,ain,186,30387594,97.9349589482,_100,3,>100
10457,haunted,186,30387780,97.9355584001,_100,7,>100
10458,keystone,186,30387966,97.9361578521,_100,8,>100
10459,prosecuted,186,30388152,97.936757304,_100,10,>100
10460,spine,186,30388338,97.937356756,_100,5,>100
10461,belichick,186,30388524,97.9379562079,_100,9,>100
10462,brock,186,30388710,97.9385556599,_100,5,>100
10463,norris,186,30388896,97.9391551118,_100,6,>100
10464,nutritional,186,30389082,97.9397545637,_100,11,>100
10465,prolonged,186,30389268,97.9403540157,_100,9,>100
10466,archbishop,186,30389454,97.9409534676,_100,10,>100
10467,overlook,186,30389640,97.9415529196,_100,8,>100
10468,ark,186,30389826,97.9421523715,_100,3,>100
10469,joints,186,30390012,97.9427518235,_100,6,>100
10470,equation,186,30390198,97.9433512754,_100,8,>100
10471,toes,186,30390384,97.9439507274,_100,4,>100
10472,pediatric,186,30390570,97.9445501793,_100,9,>100
10473,kyron,186,30390756,97.9451496313,_100,5,>100
10474,surround,186,30390942,97.9457490832,_100,8,>100
10475,fade,186,30391128,97.9463485352,_100,4,>100
10476,bug,186,30391314,97.9469479871,_100,3,>100
10477,madden,186,30391500,97.947547439,_100,6,>100
10478,heavier,186,30391686,97.948146891,_100,7,>100
10479,sensible,186,30391872,97.9487463429,_100,8,>100
10480,graffiti,186,30392058,97.9493457949,_100,8,>100
10481,perennial,186,30392244,97.9499452468,_100,9,>100
10482,escorted,185,30392429,97.9505414759,_100,8,>100
10483,sloppy,185,30392614,97.951137705,_100,6,>100
10484,specialties,185,30392799,97.9517339341,_100,11,>100
10485,beneficiaries,185,30392984,97.9523301632,_100,13,>100
10486,educating,185,30393169,97.9529263923,_100,9,>100
10487,scream,185,30393354,97.9535226214,_100,6,>100
10488,unnamed,185,30393539,97.9541188504,_100,7,>100
10489,collects,185,30393724,97.9547150795,_100,8,>100
10490,violin,185,30393909,97.9553113086,_100,6,>100
10491,dealings,185,30394094,97.9559075377,_100,8,>100
10492,fundamentally,185,30394279,97.9565037668,_100,13,>100
10493,troop,185,30394464,97.9570999959,_100,5,>100
10494,khan,185,30394649,97.957696225,_100,4,>100
10495,accelerated,185,30394834,97.958292454,_100,11,>100
10496,curtain,185,30395019,97.9588886831,_100,7,>100
10497,preston,185,30395204,97.9594849122,_100,7,>100
10498,pal,185,30395389,97.9600811413,_100,3,>100
10499,185,185,30395574,97.9606773704,_100,3,>100
10500,pfizer,185,30395759,97.9612735995,_100,6,>100
10501,scarlet,185,30395944,97.9618698286,_100,7,>100
10502,estranged,185,30396129,97.9624660576,_100,9,>100
10503,treaty,185,30396314,97.9630622867,_100,6,>100
10504,regrets,185,30396499,97.9636585158,_100,7,>100
10505,ambition,185,30396684,97.9642547449,_100,8,>100
10506,demise,185,30396869,97.964850974,_100,6,>100
10507,renamed,185,30397054,97.9654472031,_100,7,>100
10508,neglected,185,30397239,97.9660434322,_100,9,>100
10509,aesthetic,185,30397424,97.9666396612,_100,9,>100
10510,consequence,185,30397609,97.9672358903,_100,11,>100
10511,sydney,185,30397794,97.9678321194,_100,6,>100
10512,rowe,185,30397979,97.9684283485,_100,4,>100
10513,allergies,185,30398164,97.9690245776,_100,9,>100
10514,commands,185,30398349,97.9696208067,_100,8,>100
10515,coin,185,30398534,97.9702170358,_100,4,>100
10516,coincidence,185,30398719,97.9708132649,_100,11,>100
10517,severity,184,30398903,97.9714062711,_100,8,>100
10518,touting,184,30399087,97.9719992773,_100,7,>100
10519,browne,184,30399271,97.9725922835,_100,6,>100
10520,catastrophic,184,30399455,97.9731852898,_100,12,>100
10521,saut,184,30399639,97.973778296,_100,4,>100
10522,laundering,184,30399823,97.9743713022,_100,10,>100
10523,freight,184,30400007,97.9749643084,_100,7,>100
10524,sims,184,30400191,97.9755573147,_100,4,>100
10525,len,184,30400375,97.9761503209,_100,3,>100
10526,odot,184,30400559,97.9767433271,_100,4,>100
10527,norwegian,184,30400743,97.9773363333,_100,9,>100
10528,disadvantage,184,30400927,97.9779293396,_100,12,>100
10529,participant,184,30401111,97.9785223458,_100,11,>100
10530,streetcar,184,30401295,97.979115352,_100,9,>100
10531,hilarious,184,30401479,97.9797083582,_100,9,>100
10532,recalling,184,30401663,97.9803013645,_100,9,>100
10533,snapping,184,30401847,97.9808943707,_100,8,>100
10534,golfers,184,30402031,97.9814873769,_100,7,>100
10535,mozeliak,184,30402215,97.9820803832,_100,8,>100
10536,mechanics,184,30402399,97.9826733894,_100,9,>100
10537,acoustic,184,30402583,97.9832663956,_100,8,>100
10538,unpopular,184,30402767,97.9838594018,_100,9,>100
10539,recounted,184,30402951,97.9844524081,_100,9,>100
10540,dorm,184,30403135,97.9850454143,_100,4,>100
10541,englewood,184,30403319,97.9856384205,_100,9,>100
10542,jensen,184,30403503,97.9862314267,_100,6,>100
10543,regained,184,30403687,97.986824433,_100,8,>100
10544,belts,184,30403871,97.9874174392,_100,5,>100
10545,rocked,184,30404055,97.9880104454,_100,6,>100
10546,tags,184,30404239,97.9886034516,_100,4,>100
10547,stabilize,184,30404423,97.9891964579,_100,9,>100
10548,flashes,184,30404607,97.9897894641,_100,7,>100
10549,salvador,184,30404791,97.9903824703,_100,8,>100
10550,rendition,183,30404974,97.9909722537,_100,9,>100
10551,origins,183,30405157,97.9915620371,_100,7,>100
10552,bustling,183,30405340,97.9921518204,_100,8,>100
10553,functional,183,30405523,97.9927416038,_100,10,>100
10554,rusher,183,30405706,97.9933313872,_100,6,>100
10555,jackets,183,30405889,97.9939211705,_100,7,>100
10556,vanished,183,30406072,97.9945109539,_100,8,>100
10557,poem,183,30406255,97.9951007373,_100,4,>100
10558,swedish,183,30406438,97.9956905206,_100,7,>100
10559,irvington,183,30406621,97.996280304,_100,9,>100
10560,bumped,183,30406804,97.9968700874,_100,6,>100
10561,catalog,183,30406987,97.9974598707,_100,7,>100
10562,vigil,183,30407170,97.9980496541,_100,5,>100
10563,automobile,183,30407353,97.9986394375,_100,10,>100
10564,connie,183,30407536,97.9992292208,_100,6,>100
10565,mines,183,30407719,97.9998190042,_100,5,>100
10566,crafting,183,30407902,98.0004087876,_100,8,>100
10567,trooper,183,30408085,98.0009985709,_100,7,>100
10568,corrected,183,30408268,98.0015883543,_100,9,>100
10569,policing,183,30408451,98.0021781377,_100,8,>100
10570,clint,183,30408634,98.002767921,_100,5,>100
10571,tigard,183,30408817,98.0033577044,_100,6,>100
10572,descent,183,30409000,98.0039474878,_100,7,>100
10573,rabbit,183,30409183,98.0045372711,_100,6,>100
10574,nguyen,183,30409366,98.0051270545,_100,6,>100
10575,earnest,183,30409549,98.0057168379,_100,7,>100
10576,fewest,183,30409732,98.0063066212,_100,6,>100
10577,demaio,183,30409915,98.0068964046,_100,6,>100
10578,wit,183,30410098,98.007486188,_100,3,>100
10579,singh,183,30410281,98.0080759713,_100,5,>100
10580,sponsoring,183,30410464,98.0086657547,_100,10,>100
10581,balcony,183,30410647,98.009255538,_100,7,>100
10582,giffords,183,30410830,98.0098453214,_100,8,>100
10583,reminding,183,30411013,98.0104351048,_100,9,>100
10584,disastrous,183,30411196,98.0110248881,_100,10,>100
10585,ftc,183,30411379,98.0116146715,_100,3,>100
10586,hafner,182,30411561,98.012201232,_100,6,>100
10587,charleston,182,30411743,98.0127877925,_100,10,>100
10588,malcolm,182,30411925,98.013374353,_100,7,>100
10589,masterson,182,30412107,98.0139609135,_100,9,>100
10590,scramble,182,30412289,98.014547474,_100,8,>100
10591,melt,182,30412471,98.0151340346,_100,4,>100
10592,ottawa,182,30412653,98.0157205951,_100,6,>100
10593,clarence,182,30412835,98.0163071556,_100,8,>100
10594,lyles,182,30413017,98.0168937161,_100,5,>100
10595,seeded,182,30413199,98.0174802766,_100,6,>100
10596,nw,182,30413381,98.0180668371,_100,2,>100
10597,disrupt,182,30413563,98.0186533976,_100,7,>100
10598,remodeling,182,30413745,98.0192399581,_100,10,>100
10599,nicks,182,30413927,98.0198265186,_100,5,>100
10600,restraint,182,30414109,98.0204130791,_100,9,>100
10601,retro,182,30414291,98.0209996396,_100,5,>100
10602,indonesia,182,30414473,98.0215862001,_100,9,>100
10603,diverted,182,30414655,98.0221727606,_100,8,>100
10604,daring,182,30414837,98.0227593211,_100,6,>100
10605,ubiquitous,182,30415019,98.0233458816,_100,10,>100
10606,rebel,182,30415201,98.0239324422,_100,5,>100
10607,cyclists,182,30415383,98.0245190027,_100,8,>100
10608,cerf,182,30415565,98.0251055632,_100,4,>100
10609,fathers,182,30415747,98.0256921237,_100,7,>100
10610,chardon,182,30415929,98.0262786842,_100,7,>100
10611,blogger,182,30416111,98.0268652447,_100,7,>100
10612,breeze,182,30416293,98.0274518052,_100,6,>100
10613,emerges,182,30416475,98.0280383657,_100,7,>100
10614,proceeding,182,30416657,98.0286249262,_100,10,>100
10615,listings,182,30416839,98.0292114867,_100,8,>100
10616,merkel,182,30417021,98.0297980472,_100,6,>100
10617,specializing,182,30417203,98.0303846077,_100,12,>100
10618,repeating,182,30417385,98.0309711682,_100,9,>100
10619,loser,182,30417567,98.0315577287,_100,5,>100
10620,forthcoming,182,30417749,98.0321442892,_100,11,>100
10621,insects,181,30417930,98.0327276269,_100,7,>100
10622,restart,181,30418111,98.0333109645,_100,7,>100
10623,bulb,181,30418292,98.0338943022,_100,4,>100
10624,olsen,181,30418473,98.0344776398,_100,5,>100
10625,marsh,181,30418654,98.0350609775,_100,5,>100
10626,unbeaten,181,30418835,98.0356443151,_100,8,>100
10627,testifying,181,30419016,98.0362276528,_100,10,>100
10628,silk,181,30419197,98.0368109904,_100,4,>100
10629,affection,181,30419378,98.0373943281,_100,9,>100
10630,walnuts,181,30419559,98.0379776657,_100,7,>100
10631,aspirations,181,30419740,98.0385610034,_100,11,>100
10632,capturing,181,30419921,98.039144341,_100,9,>100
10633,logging,181,30420102,98.0397276786,_100,7,>100
10634,inflammation,181,30420283,98.0403110163,_100,12,>100
10635,drizzle,181,30420464,98.0408943539,_100,7,>100
10636,netanyahu,181,30420645,98.0414776916,_100,9,>100
10637,acidity,181,30420826,98.0420610292,_100,7,>100
10638,shanahan,181,30421007,98.0426443669,_100,8,>100
10639,shuttered,181,30421188,98.0432277045,_100,9,>100
10640,pacs,181,30421369,98.0438110422,_100,4,>100
10641,intervene,181,30421550,98.0443943798,_100,9,>100
10642,ego,181,30421731,98.0449777175,_100,3,>100
10643,evenings,181,30421912,98.0455610551,_100,8,>100
10644,fliers,181,30422093,98.0461443928,_100,6,>100
10645,prisoner,181,30422274,98.0467277304,_100,8,>100
10646,consciousness,181,30422455,98.0473110681,_100,13,>100
10647,glance,181,30422636,98.0478944057,_100,6,>100
10648,thrust,181,30422817,98.0484777433,_100,6,>100
10649,varies,181,30422998,98.049061081,_100,6,>100
10650,robot,181,30423179,98.0496444186,_100,5,>100
10651,staten,181,30423360,98.0502277563,_100,6,>100
10652,rooting,181,30423541,98.0508110939,_100,7,>100
10653,succession,181,30423722,98.0513944316,_100,10,>100
10654,ewing,181,30423903,98.0519777692,_100,5,>100
10655,thomson,181,30424084,98.0525611069,_100,7,>100
10656,episcopal,181,30424265,98.0531444445,_100,9,>100
10657,stressful,181,30424446,98.0537277822,_100,9,>100
10658,pp,181,30424627,98.0543111198,_100,2,>100
10659,duffy,181,30424808,98.0548944575,_100,5,>100
10660,realtors,181,30424989,98.0554777951,_100,8,>100
10661,hers,181,30425170,98.0560611328,_100,4,>100
10662,concession,180,30425350,98.0566412475,_100,10,>100
10663,lured,180,30425530,98.0572213623,_100,5,>100
10664,plaque,180,30425710,98.0578014771,_100,6,>100
10665,benefiting,180,30425890,98.0583815919,_100,10,>100
10666,consult,180,30426070,98.0589617067,_100,7,>100
10667,nutrients,180,30426250,98.0595418215,_100,9,>100
10668,weinberg,180,30426430,98.0601219363,_100,8,>100
10669,shipments,180,30426610,98.060702051,_100,9,>100
10670,publications,180,30426790,98.0612821658,_100,12,>100
10671,dc,180,30426970,98.0618622806,_100,2,>100
10672,hears,180,30427150,98.0624423954,_100,5,>100
10673,hendricks,180,30427330,98.0630225102,_100,9,>100
10674,juniors,180,30427510,98.063602625,_100,7,>100
10675,yost,180,30427690,98.0641827398,_100,4,>100
10676,discouraged,180,30427870,98.0647628546,_100,11,>100
10677,helmets,180,30428050,98.0653429693,_100,7,>100
10678,stadiums,180,30428230,98.0659230841,_100,8,>100
10679,mussels,180,30428410,98.0665031989,_100,7,>100
10680,deferred,180,30428590,98.0670833137,_100,8,>100
10681,abusive,180,30428770,98.0676634285,_100,7,>100
10682,highlighting,180,30428950,98.0682435433,_100,12,>100
10683,li,180,30429130,98.0688236581,_100,2,>100
10684,clearer,180,30429310,98.0694037728,_100,7,>100
10685,arise,180,30429490,98.0699838876,_100,5,>100
10686,fidelis,180,30429670,98.0705640024,_100,7,>100
10687,180,180,30429850,98.0711441172,_100,3,>100
10688,chapters,180,30430030,98.071724232,_100,8,>100
10689,affluent,180,30430210,98.0723043468,_100,8,>100
10690,forefront,179,30430389,98.0728812387,_100,9,>100
10691,blender,179,30430568,98.0734581306,_100,7,>100
10692,maturity,179,30430747,98.0740350226,_100,8,>100
10693,patti,179,30430926,98.0746119145,_100,5,>100
10694,sensitivity,179,30431105,98.0751888064,_100,11,>100
10695,foremost,179,30431284,98.0757656983,_100,8,>100
10696,amtrak,179,30431463,98.0763425903,_100,6,>100
10697,shaping,179,30431642,98.0769194822,_100,7,>100
10698,bagley,179,30431821,98.0774963741,_100,6,>100
10699,screamed,179,30432000,98.078073266,_100,8,>100
10700,lazy,179,30432179,98.078650158,_100,4,>100
10701,kindness,179,30432358,98.0792270499,_100,8,>100
10702,deepest,179,30432537,98.0798039418,_100,7,>100
10703,cluster,179,30432716,98.0803808338,_100,7,>100
10704,inevitably,179,30432895,98.0809577257,_100,10,>100
10705,ports,179,30433074,98.0815346176,_100,5,>100
10706,parenting,179,30433253,98.0821115095,_100,9,>100
10707,strengthening,179,30433432,98.0826884015,_100,13,>100
10708,translated,179,30433611,98.0832652934,_100,10,>100
10709,biking,179,30433790,98.0838421853,_100,6,>100
10710,invites,179,30433969,98.0844190772,_100,7,>100
10711,clout,179,30434148,98.0849959692,_100,5,>100
10712,salvation,179,30434327,98.0855728611,_100,9,>100
10713,anheuser,179,30434506,98.086149753,_100,8,>100
10714,inclusion,179,30434685,98.0867266449,_100,9,>100
10715,rooftop,179,30434864,98.0873035369,_100,7,>100
10716,farrell,179,30435043,98.0878804288,_100,7,>100
10717,dilemma,179,30435222,98.0884573207,_100,7,>100
10718,injuring,179,30435401,98.0890342127,_100,8,>100
10719,spirited,179,30435580,98.0896111046,_100,8,>100
10720,loopholes,179,30435759,98.0901879965,_100,9,>100
10721,coeur,179,30435938,98.0907648884,_100,5,>100
10722,narrowed,179,30436117,98.0913417804,_100,8,>100
10723,fielding,179,30436296,98.0919186723,_100,8,>100
10724,spite,179,30436475,98.0924955642,_100,5,>100
10725,nadal,179,30436654,98.0930724561,_100,5,>100
10726,instructors,179,30436833,98.0936493481,_100,11,>100
10727,learns,179,30437012,98.09422624,_100,6,>100
10728,ruined,179,30437191,98.0948031319,_100,6,>100
10729,cord,179,30437370,98.0953800239,_100,4,>100
10730,oprah,178,30437548,98.0959536929,_100,5,>100
10731,groupon,178,30437726,98.096527362,_100,7,>100
10732,blankets,178,30437904,98.0971010311,_100,8,>100
10733,mailing,178,30438082,98.0976747001,_100,7,>100
10734,broadband,178,30438260,98.0982483692,_100,9,>100
10735,emerson,178,30438438,98.0988220383,_100,7,>100
10736,pigs,178,30438616,98.0993957073,_100,4,>100
10737,differ,178,30438794,98.0999693764,_100,6,>100
10738,tampering,178,30438972,98.1005430455,_100,9,>100
10739,await,178,30439150,98.1011167145,_100,5,>100
10740,strides,178,30439328,98.1016903836,_100,7,>100
10741,bernstein,178,30439506,98.1022640527,_100,9,>100
10742,wes,178,30439684,98.1028377217,_100,3,>100
10743,renovate,178,30439862,98.1034113908,_100,8,>100
10744,wildwood,178,30440040,98.1039850599,_100,8,>100
10745,turbines,178,30440218,98.1045587289,_100,8,>100
10746,obsessed,178,30440396,98.105132398,_100,8,>100
10747,dep,178,30440574,98.1057060671,_100,3,>100
10748,headaches,178,30440752,98.1062797361,_100,9,>100
10749,beets,178,30440930,98.1068534052,_100,5,>100
10750,sparks,178,30441108,98.1074270743,_100,6,>100
10751,slick,178,30441286,98.1080007433,_100,5,>100
10752,garnered,178,30441464,98.1085744124,_100,8,>100
10753,usda,178,30441642,98.1091480815,_100,4,>100
10754,versatility,178,30441820,98.1097217505,_100,11,>100
10755,undoubtedly,178,30441998,98.1102954196,_100,11,>100
10756,ucf,178,30442176,98.1108690887,_100,3,>100
10757,builder,178,30442354,98.1114427577,_100,7,>100
10758,composition,178,30442532,98.1120164268,_100,11,>100
10759,fertilizer,178,30442710,98.1125900959,_100,10,>100
10760,underdog,178,30442888,98.1131637649,_100,8,>100
10761,extras,178,30443066,98.113737434,_100,6,>100
10762,aided,178,30443244,98.1143111031,_100,5,>100
10763,abusing,178,30443422,98.1148847721,_100,7,>100
10764,dim,178,30443600,98.1154584412,_100,3,>100
10765,alarming,177,30443777,98.1160288874,_100,8,>100
10766,folsom,177,30443954,98.1165993336,_100,6,>100
10767,isolation,177,30444131,98.1171697798,_100,9,>100
10768,angles,177,30444308,98.117740226,_100,6,>100
10769,tallest,177,30444485,98.1183106722,_100,7,>100
10770,immunity,177,30444662,98.1188811184,_100,8,>100
10771,pregame,177,30444839,98.1194515646,_100,7,>100
10772,wipe,177,30445016,98.1200220108,_100,4,>100
10773,karr,177,30445193,98.1205924571,_100,4,>100
10774,warrior,177,30445370,98.1211629033,_100,7,>100
10775,arugula,177,30445547,98.1217333495,_100,7,>100
10776,fenton,177,30445724,98.1223037957,_100,6,>100
10777,willow,177,30445901,98.1228742419,_100,6,>100
10778,replay,177,30446078,98.1234446881,_100,6,>100
10779,certificates,177,30446255,98.1240151343,_100,12,>100
10780,socially,177,30446432,98.1245855805,_100,8,>100
10781,gibbs,177,30446609,98.1251560267,_100,5,>100
10782,hydraulic,177,30446786,98.1257264729,_100,9,>100
10783,bureaucracy,177,30446963,98.1262969191,_100,11,>100
10784,poems,177,30447140,98.1268673653,_100,5,>100
10785,sergio,177,30447317,98.1274378115,_100,6,>100
10786,anglers,177,30447494,98.1280082577,_100,7,>100
10787,chestnut,177,30447671,98.1285787039,_100,8,>100
10788,bully,177,30447848,98.1291491502,_100,5,>100
10789,collar,177,30448025,98.1297195964,_100,6,>100
10790,thor,177,30448202,98.1302900426,_100,4,>100
10791,cloth,177,30448379,98.1308604888,_100,5,>100
10792,foreclosed,177,30448556,98.131430935,_100,10,>100
10793,vigorously,177,30448733,98.1320013812,_100,10,>100
10794,withdrawn,177,30448910,98.1325718274,_100,9,>100
10795,distressed,177,30449087,98.1331422736,_100,10,>100
10796,poles,177,30449264,98.1337127198,_100,5,>100
10797,strapped,176,30449440,98.1342799432,_100,8,>100
10798,debra,176,30449616,98.1348471665,_100,5,>100
10799,coordination,176,30449792,98.1354143899,_100,12,>100
10800,samsung,176,30449968,98.1359816132,_100,7,>100
10801,realty,176,30450144,98.1365488365,_100,6,>100
10802,gem,176,30450320,98.1371160599,_100,3,>100
10803,storefront,176,30450496,98.1376832832,_100,10,>100
10804,needy,176,30450672,98.1382505066,_100,5,>100
10805,clarify,176,30450848,98.1388177299,_100,7,>100
10806,gardeners,176,30451024,98.1393849533,_100,9,>100
10807,rita,176,30451200,98.1399521766,_100,4,>100
10808,eased,176,30451376,98.1405194,_100,5,>100
10809,sage,176,30451552,98.1410866233,_100,4,>100
10810,weed,176,30451728,98.1416538467,_100,4,>100
10811,simpler,176,30451904,98.14222107,_100,7,>100
10812,volunteering,176,30452080,98.1427882934,_100,12,>100
10813,valerie,176,30452256,98.1433555167,_100,7,>100
10814,organs,176,30452432,98.1439227401,_100,6,>100
10815,chaotic,176,30452608,98.1444899634,_100,7,>100
10816,fe,176,30452784,98.1450571867,_100,2,>100
10817,aberdeen,176,30452960,98.1456244101,_100,8,>100
10818,mentors,176,30453136,98.1461916334,_100,7,>100
10819,chipped,176,30453312,98.1467588568,_100,7,>100
10820,posey,176,30453488,98.1473260801,_100,5,>100
10821,netflix,176,30453664,98.1478933035,_100,7,>100
10822,groom,176,30453840,98.1484605268,_100,5,>100
10823,respectful,176,30454016,98.1490277502,_100,10,>100
10824,loosely,176,30454192,98.1495949735,_100,7,>100
10825,ivan,176,30454368,98.1501621969,_100,4,>100
10826,advisors,176,30454544,98.1507294202,_100,8,>100
10827,eleven,176,30454720,98.1512966436,_100,6,>100
10828,coyne,176,30454896,98.1518638669,_100,5,>100
10829,tmz,176,30455072,98.1524310903,_100,3,>100
10830,dolphin,176,30455248,98.1529983136,_100,7,>100
10831,nowitzki,176,30455424,98.153565537,_100,8,>100
10832,afloat,176,30455600,98.1541327603,_100,6,>100
10833,cam,176,30455776,98.1546999836,_100,3,>100
10834,ibm,176,30455952,98.155267207,_100,3,>100
10835,kidnapped,176,30456128,98.1558344303,_100,9,>100
10836,enforced,175,30456303,98.1563984308,_100,8,>100
10837,sens,175,30456478,98.1569624313,_100,4,>100
10838,outcry,175,30456653,98.1575264318,_100,6,>100
10839,cordray,175,30456828,98.1580904323,_100,7,>100
10840,qualifications,175,30457003,98.1586544328,_100,14,>100
10841,feeds,175,30457178,98.1592184333,_100,5,>100
10842,chilly,175,30457353,98.1597824338,_100,6,>100
10843,reunited,175,30457528,98.1603464342,_100,8,>100
10844,destroying,175,30457703,98.1609104347,_100,10,>100
10845,northeastern,175,30457878,98.1614744352,_100,12,>100
10846,inventive,175,30458053,98.1620384357,_100,9,>100
10847,testament,175,30458228,98.1626024362,_100,9,>100
10848,vetoed,175,30458403,98.1631664367,_100,6,>100
10849,dare,175,30458578,98.1637304372,_100,4,>100
10850,waits,175,30458753,98.1642944376,_100,5,>100
10851,hightower,175,30458928,98.1648584381,_100,9,>100
10852,boarded,175,30459103,98.1654224386,_100,7,>100
10853,175,175,30459278,98.1659864391,_100,3,>100
10854,heath,175,30459453,98.1665504396,_100,5,>100
10855,malibu,175,30459628,98.1671144401,_100,6,>100
10856,blaming,175,30459803,98.1676784406,_100,7,>100
10857,chic,175,30459978,98.1682424411,_100,4,>100
10858,dublin,175,30460153,98.1688064415,_100,6,>100
10859,porn,175,30460328,98.169370442,_100,4,>100
10860,desperation,175,30460503,98.1699344425,_100,11,>100
10861,dee,175,30460678,98.170498443,_100,3,>100
10862,tow,175,30460853,98.1710624435,_100,3,>100
10863,ramps,175,30461028,98.171626444,_100,5,>100
10864,insurer,175,30461203,98.1721904445,_100,7,>100
10865,deployment,175,30461378,98.172754445,_100,10,>100
10866,mentions,175,30461553,98.1733184454,_100,8,>100
10867,secrecy,175,30461728,98.1738824459,_100,7,>100
10868,parental,175,30461903,98.1744464464,_100,8,>100
10869,legion,175,30462078,98.1750104469,_100,6,>100
10870,upfront,175,30462253,98.1755744474,_100,7,>100
10871,curiosity,175,30462428,98.1761384479,_100,9,>100
10872,frenzy,175,30462603,98.1767024484,_100,6,>100
10873,burial,175,30462778,98.1772664488,_100,6,>100
10874,barnett,175,30462953,98.1778304493,_100,7,>100
10875,hathaway,174,30463127,98.178391227,_100,8,>100
10876,weddings,174,30463301,98.1789520046,_100,8,>100
10877,brenda,174,30463475,98.1795127822,_100,6,>100
10878,pressured,174,30463649,98.1800735598,_100,9,>100
10879,slides,174,30463823,98.1806343375,_100,6,>100
10880,announcements,174,30463997,98.1811951151,_100,13,>100
10881,tendon,174,30464171,98.1817558927,_100,6,>100
10882,florissant,174,30464345,98.1823166704,_100,10,>100
10883,furcal,174,30464519,98.182877448,_100,6,>100
10884,buick,174,30464693,98.1834382256,_100,5,>100
10885,furnishings,174,30464867,98.1839990032,_100,11,>100
10886,contempt,174,30465041,98.1845597809,_100,8,>100
10887,caliber,174,30465215,98.1851205585,_100,7,>100
10888,drainage,174,30465389,98.1856813361,_100,8,>100
10889,woodland,174,30465563,98.1862421137,_100,8,>100
10890,fri,174,30465737,98.1868028914,_100,3,>100
10891,reversal,174,30465911,98.187363669,_100,8,>100
10892,subpoena,174,30466085,98.1879244466,_100,8,>100
10893,spree,174,30466259,98.1884852243,_100,5,>100
10894,scent,174,30466433,98.1890460019,_100,5,>100
10895,owning,174,30466607,98.1896067795,_100,6,>100
10896,durbin,174,30466781,98.1901675571,_100,6,>100
10897,mobility,174,30466955,98.1907283348,_100,8,>100
10898,luxurious,174,30467129,98.1912891124,_100,9,>100
10899,soak,174,30467303,98.19184989,_100,4,>100
10900,pledges,174,30467477,98.1924106676,_100,7,>100
10901,portray,174,30467651,98.1929714453,_100,7,>100
10902,maloofs,174,30467825,98.1935322229,_100,7,>100
10903,miners,174,30467999,98.1940930005,_100,6,>100
10904,keen,174,30468173,98.1946537781,_100,4,>100
10905,affiliation,173,30468346,98.1952113329,_100,11,>100
10906,twinsburg,173,30468519,98.1957688877,_100,9,>100
10907,rested,173,30468692,98.1963264425,_100,6,>100
10908,smells,173,30468865,98.1968839972,_100,6,>100
10909,translates,173,30469038,98.197441552,_100,10,>100
10910,stockton,173,30469211,98.1979991068,_100,8,>100
10911,recess,173,30469384,98.1985566615,_100,6,>100
10912,similarities,173,30469557,98.1991142163,_100,12,>100
10913,slew,173,30469730,98.1996717711,_100,4,>100
10914,valencia,173,30469903,98.2002293258,_100,8,>100
10915,coors,173,30470076,98.2007868806,_100,5,>100
10916,belle,173,30470249,98.2013444354,_100,5,>100
10917,births,173,30470422,98.2019019901,_100,6,>100
10918,accelerate,173,30470595,98.2024595449,_100,10,>100
10919,mccafferty,173,30470768,98.2030170997,_100,10,>100
10920,tooth,173,30470941,98.2035746544,_100,5,>100
10921,chanting,173,30471114,98.2041322092,_100,8,>100
10922,repertoire,173,30471287,98.204689764,_100,10,>100
10923,originated,173,30471460,98.2052473187,_100,10,>100
10924,byrne,173,30471633,98.2058048735,_100,5,>100
10925,auctions,173,30471806,98.2063624283,_100,8,>100
10926,hinted,173,30471979,98.206919983,_100,6,>100
10927,punches,173,30472152,98.2074775378,_100,7,>100
10928,leaked,173,30472325,98.2080350926,_100,6,>100
10929,goodwin,173,30472498,98.2085926473,_100,7,>100
10930,portrayal,173,30472671,98.2091502021,_100,9,>100
10931,hardship,173,30472844,98.2097077569,_100,8,>100
10932,watts,173,30473017,98.2102653116,_100,5,>100
10933,trailhead,172,30473189,98.2108196435,_100,9,>100
10934,brantley,172,30473361,98.2113739754,_100,8,>100
10935,sofa,172,30473533,98.2119283074,_100,4,>100
10936,dull,172,30473705,98.2124826393,_100,4,>100
10937,izzo,172,30473877,98.2130369712,_100,4,>100
10938,apollo,172,30474049,98.2135913031,_100,6,>100
10939,tapping,172,30474221,98.214145635,_100,7,>100
10940,mara,172,30474393,98.2146999669,_100,4,>100
10941,renee,172,30474565,98.2152542988,_100,5,>100
10942,cognitive,172,30474737,98.2158086307,_100,9,>100
10943,arthritis,172,30474909,98.2163629626,_100,9,>100
10944,guiding,172,30475081,98.2169172945,_100,7,>100
10945,scottrade,172,30475253,98.2174716264,_100,9,>100
10946,paralyzed,172,30475425,98.2180259583,_100,9,>100
10947,hulk,172,30475597,98.2185802902,_100,4,>100
10948,bland,172,30475769,98.2191346221,_100,5,>100
10949,masks,172,30475941,98.2196889541,_100,5,>100
10950,grated,172,30476113,98.220243286,_100,6,>100
10951,fared,172,30476285,98.2207976179,_100,5,>100
10952,tornadoes,172,30476457,98.2213519498,_100,9,>100
10953,hobby,172,30476629,98.2219062817,_100,5,>100
10954,rulings,172,30476801,98.2224606136,_100,7,>100
10955,stacy,172,30476973,98.2230149455,_100,5,>100
10956,burnett,172,30477145,98.2235692774,_100,7,>100
10957,experiments,172,30477317,98.2241236093,_100,11,>100
10958,nook,172,30477489,98.2246779412,_100,4,>100
10959,darker,172,30477661,98.2252322731,_100,6,>100
10960,instincts,172,30477833,98.225786605,_100,9,>100
10961,creature,172,30478005,98.2263409369,_100,8,>100
10962,caesars,172,30478177,98.2268952688,_100,7,>100
10963,asbury,172,30478349,98.2274496008,_100,6,>100
10964,aspiring,172,30478521,98.2280039327,_100,8,>100
10965,researching,172,30478693,98.2285582646,_100,11,>100
10966,flair,172,30478865,98.2291125965,_100,5,>100
10967,peabody,172,30479037,98.2296669284,_100,7,>100
10968,fc,172,30479209,98.2302212603,_100,2,>100
10969,jamal,172,30479381,98.2307755922,_100,5,>100
10970,genuinely,171,30479552,98.2313267012,_100,9,>100
10971,adversity,171,30479723,98.2318778103,_100,9,>100
10972,mentoring,171,30479894,98.2324289193,_100,9,>100
10973,retaliation,171,30480065,98.2329800284,_100,11,>100
10974,traveler,171,30480236,98.2335311374,_100,8,>100
10975,cottage,171,30480407,98.2340822465,_100,7,>100
10976,losers,171,30480578,98.2346333555,_100,6,>100
10977,sheep,171,30480749,98.2351844646,_100,5,>100
10978,unfold,171,30480920,98.2357355736,_100,6,>100
10979,brew,171,30481091,98.2362866827,_100,4,>100
10980,commodities,171,30481262,98.2368377917,_100,11,>100
10981,promotional,171,30481433,98.2373889008,_100,11,>100
10982,dover,171,30481604,98.2379400098,_100,5,>100
10983,swiftly,171,30481775,98.2384911189,_100,7,>100
10984,slopes,171,30481946,98.2390422279,_100,6,>100
10985,bang,171,30482117,98.239593337,_100,4,>100
10986,compelled,171,30482288,98.240144446,_100,9,>100
10987,czech,171,30482459,98.2406955551,_100,5,>100
10988,sebastian,171,30482630,98.2412466641,_100,9,>100
10989,logged,171,30482801,98.2417977731,_100,6,>100
10990,foie,171,30482972,98.2423488822,_100,4,>100
10991,impaired,171,30483143,98.2428999912,_100,8,>100
10992,mineral,171,30483314,98.2434511003,_100,7,>100
10993,sincere,171,30483485,98.2440022093,_100,7,>100
10994,boone,171,30483656,98.2445533184,_100,5,>100
10995,fullback,171,30483827,98.2451044274,_100,8,>100
10996,govern,171,30483998,98.2456555365,_100,6,>100
10997,profitability,171,30484169,98.2462066455,_100,13,>100
10998,kraft,171,30484340,98.2467577546,_100,5,>100
10999,clams,171,30484511,98.2473088636,_100,5,>100
11000,weaknesses,171,30484682,98.2478599727,_100,10,>100
11001,hp,171,30484853,98.2484110817,_100,2,>100
11002,steen,171,30485024,98.2489621908,_100,5,>100
11003,hyde,170,30485194,98.2495100769,_100,4,>100
11004,soriano,170,30485364,98.2500579631,_100,7,>100
11005,textures,170,30485534,98.2506058493,_100,8,>100
11006,decorations,170,30485704,98.2511537355,_100,11,>100
11007,settlements,170,30485874,98.2517016217,_100,11,>100
11008,roseville,170,30486044,98.2522495079,_100,9,>100
11009,jammed,170,30486214,98.2527973941,_100,6,>100
11010,170,170,30486384,98.2533452803,_100,3,>100
11011,tagged,170,30486554,98.2538931664,_100,6,>100
11012,sacrifices,170,30486724,98.2544410526,_100,10,>100
11013,exercising,170,30486894,98.2549889388,_100,10,>100
11014,plymouth,170,30487064,98.255536825,_100,8,>100
11015,brotherhood,170,30487234,98.2560847112,_100,11,>100
11016,pastries,170,30487404,98.2566325974,_100,8,>100
11017,tiles,170,30487574,98.2571804836,_100,5,>100
11018,linger,170,30487744,98.2577283698,_100,6,>100
11019,dudley,170,30487914,98.2582762559,_100,6,>100
11020,inflated,170,30488084,98.2588241421,_100,8,>100
11021,ropes,170,30488254,98.2593720283,_100,5,>100
11022,pops,170,30488424,98.2599199145,_100,4,>100
11023,sketch,170,30488594,98.2604678007,_100,6,>100
11024,fickell,170,30488764,98.2610156869,_100,7,>100
11025,stray,170,30488934,98.2615635731,_100,5,>100
11026,yates,170,30489104,98.2621114593,_100,5,>100
11027,audits,170,30489274,98.2626593454,_100,6,>100
11028,misguided,170,30489444,98.2632072316,_100,9,>100
11029,raids,170,30489614,98.2637551178,_100,5,>100
11030,oils,170,30489784,98.264303004,_100,4,>100
11031,perron,170,30489954,98.2648508902,_100,6,>100
11032,lens,170,30490124,98.2653987764,_100,4,>100
11033,excluded,170,30490294,98.2659466626,_100,8,>100
11034,liner,170,30490464,98.2664945488,_100,5,>100
11035,overseen,170,30490634,98.2670424349,_100,8,>100
11036,mcconnell,170,30490804,98.2675903211,_100,9,>100
11037,launches,170,30490974,98.2681382073,_100,8,>100
11038,herbert,170,30491144,98.2686860935,_100,7,>100
11039,stall,170,30491314,98.2692339797,_100,5,>100
11040,disneyland,170,30491484,98.2697818659,_100,10,>100
11041,mccartney,170,30491654,98.2703297521,_100,9,>100
11042,elaine,170,30491824,98.2708776383,_100,6,>100
11043,punitive,169,30491993,98.2714223016,_100,8,>100
11044,cc,169,30492162,98.2719669649,_100,2,>100
11045,obamacare,169,30492331,98.2725116282,_100,9,>100
11046,everett,169,30492500,98.2730562916,_100,7,>100
11047,secular,169,30492669,98.2736009549,_100,7,>100
11048,hubbard,169,30492838,98.2741456182,_100,7,>100
11049,glue,169,30493007,98.2746902815,_100,4,>100
11050,marchionne,169,30493176,98.2752349449,_100,10,>100
11051,mendoza,169,30493345,98.2757796082,_100,7,>100
11052,twists,169,30493514,98.2763242715,_100,6,>100
11053,bryzgalov,169,30493683,98.2768689349,_100,9,>100
11054,vanderbilt,169,30493852,98.2774135982,_100,10,>100
11055,graphics,169,30494021,98.2779582615,_100,8,>100
11056,higgins,169,30494190,98.2785029248,_100,7,>100
11057,tackling,169,30494359,98.2790475882,_100,8,>100
11058,belongings,169,30494528,98.2795922515,_100,10,>100
11059,bins,169,30494697,98.2801369148,_100,4,>100
11060,relocation,169,30494866,98.2806815782,_100,10,>100
11061,persona,169,30495035,98.2812262415,_100,7,>100
11062,eatery,169,30495204,98.2817709048,_100,6,>100
11063,debating,169,30495373,98.2823155681,_100,8,>100
11064,permitting,169,30495542,98.2828602315,_100,10,>100
11065,enterprises,169,30495711,98.2834048948,_100,11,>100
11066,matchups,169,30495880,98.2839495581,_100,8,>100
11067,doctorate,169,30496049,98.2844942214,_100,9,>100
11068,ruins,169,30496218,98.2850388848,_100,5,>100
11069,needle,169,30496387,98.2855835481,_100,6,>100
11070,adventurous,169,30496556,98.2861282114,_100,11,>100
11071,rondo,169,30496725,98.2866728748,_100,5,>100
11072,peach,169,30496894,98.2872175381,_100,5,>100
11073,rattled,169,30497063,98.2877622014,_100,7,>100
11074,blends,169,30497232,98.2883068647,_100,6,>100
11075,savage,169,30497401,98.2888515281,_100,6,>100
11076,inspected,169,30497570,98.2893961914,_100,9,>100
11077,notification,169,30497739,98.2899408547,_100,12,>100
11078,definitive,169,30497908,98.290485518,_100,10,>100
11079,distributors,169,30498077,98.2910301814,_100,12,>100
11080,supplements,169,30498246,98.2915748447,_100,11,>100
11081,creme,169,30498415,98.292119508,_100,5,>100
11082,freezer,169,30498584,98.2926641714,_100,7,>100
11083,labs,169,30498753,98.2932088347,_100,4,>100
11084,ashton,169,30498922,98.293753498,_100,6,>100
11085,buzzer,169,30499091,98.2942981613,_100,6,>100
11086,shelley,169,30499260,98.2948428247,_100,7,>100
11087,unauthorized,168,30499428,98.2953842651,_100,12,>100
11088,damn,168,30499596,98.2959257056,_100,4,>100
11089,cookbook,168,30499764,98.2964671461,_100,8,>100
11090,hardin,168,30499932,98.2970085865,_100,6,>100
11091,fool,168,30500100,98.297550027,_100,4,>100
11092,activated,168,30500268,98.2980914675,_100,9,>100
11093,recurring,168,30500436,98.2986329079,_100,9,>100
11094,soaked,168,30500604,98.2991743484,_100,6,>100
11095,belgian,168,30500772,98.2997157889,_100,7,>100
11096,lookout,168,30500940,98.3002572293,_100,7,>100
11097,demolished,168,30501108,98.3007986698,_100,10,>100
11098,resolutions,168,30501276,98.3013401103,_100,11,>100
11099,flashing,168,30501444,98.3018815507,_100,8,>100
11100,blond,168,30501612,98.3024229912,_100,5,>100
11101,francois,168,30501780,98.3029644317,_100,8,>100
11102,extortion,168,30501948,98.3035058721,_100,9,>100
11103,paychecks,168,30502116,98.3040473126,_100,9,>100
11104,integral,168,30502284,98.3045887531,_100,8,>100
11105,fest,168,30502452,98.3051301936,_100,4,>100
11106,kc,168,30502620,98.305671634,_100,2,>100
11107,contreras,168,30502788,98.3062130745,_100,9,>100
11108,indicators,168,30502956,98.306754515,_100,10,>100
11109,ringing,168,30503124,98.3072959554,_100,7,>100
11110,mcdowell,168,30503292,98.3078373959,_100,8,>100
11111,infants,168,30503460,98.3083788364,_100,7,>100
11112,terrell,168,30503628,98.3089202768,_100,7,>100
11113,stemmed,168,30503796,98.3094617173,_100,7,>100
11114,proclaimed,168,30503964,98.3100031578,_100,10,>100
11115,acute,168,30504132,98.3105445982,_100,5,>100
11116,gin,168,30504300,98.3110860387,_100,3,>100
11117,steroid,168,30504468,98.3116274792,_100,7,>100
11118,outsiders,168,30504636,98.3121689196,_100,9,>100
11119,nailed,168,30504804,98.3127103601,_100,6,>100
11120,smokers,167,30504971,98.3132485777,_100,7,>100
11121,gail,167,30505138,98.3137867953,_100,4,>100
11122,downside,167,30505305,98.3143250129,_100,8,>100
11123,guarded,167,30505472,98.3148632305,_100,7,>100
11124,chewy,167,30505639,98.3154014481,_100,5,>100
11125,spans,167,30505806,98.3159396657,_100,5,>100
11126,deptford,167,30505973,98.3164778833,_100,8,>100
11127,boiling,167,30506140,98.317016101,_100,7,>100
11128,prized,167,30506307,98.3175543186,_100,6,>100
11129,carmen,167,30506474,98.3180925362,_100,6,>100
11130,jaime,167,30506641,98.3186307538,_100,5,>100
11131,penguins,167,30506808,98.3191689714,_100,8,>100
11132,collaborative,167,30506975,98.319707189,_100,13,>100
11133,confession,167,30507142,98.3202454066,_100,10,>100
11134,frightening,167,30507309,98.3207836242,_100,11,>100
11135,transcript,167,30507476,98.3213218418,_100,10,>100
11136,mistaken,167,30507643,98.3218600594,_100,8,>100
11137,sticker,167,30507810,98.322398277,_100,7,>100
11138,purely,167,30507977,98.3229364946,_100,6,>100
11139,carp,167,30508144,98.3234747122,_100,4,>100
11140,positively,167,30508311,98.3240129299,_100,10,>100
11141,louise,167,30508478,98.3245511475,_100,6,>100
11142,matta,167,30508645,98.3250893651,_100,5,>100
11143,plight,167,30508812,98.3256275827,_100,6,>100
11144,protested,167,30508979,98.3261658003,_100,9,>100
11145,bored,167,30509146,98.3267040179,_100,5,>100
11146,dimension,167,30509313,98.3272422355,_100,9,>100
11147,illustrates,167,30509480,98.3277804531,_100,11,>100
11148,dearborn,167,30509647,98.3283186707,_100,8,>100
11149,condos,167,30509814,98.3288568883,_100,6,>100
11150,spelled,167,30509981,98.3293951059,_100,7,>100
11151,bourbon,167,30510148,98.3299333235,_100,7,>100
11152,nursery,167,30510315,98.3304715411,_100,7,>100
11153,illustrate,167,30510482,98.3310097588,_100,10,>100
11154,pinal,167,30510649,98.3315479764,_100,5,>100
11155,bidders,167,30510816,98.332086194,_100,7,>100
11156,affiliates,167,30510983,98.3326244116,_100,10,>100
11157,eva,166,30511149,98.3331594063,_100,3,>100
11158,insurgents,166,30511315,98.3336944011,_100,10,>100
11159,displaced,166,30511481,98.3342293958,_100,9,>100
11160,kalil,166,30511647,98.3347643906,_100,5,>100
11161,namesake,166,30511813,98.3352993853,_100,8,>100
11162,z,166,30511979,98.3358343801,_100,1,>100
11163,peru,166,30512145,98.3363693748,_100,4,>100
11164,kelsey,166,30512311,98.3369043696,_100,6,>100
11165,dwyane,166,30512477,98.3374393643,_100,6,>100
11166,overdue,166,30512643,98.3379743591,_100,7,>100
11167,marinated,166,30512809,98.3385093538,_100,9,>100
11168,mistress,166,30512975,98.3390443486,_100,8,>100
11169,capistrano,166,30513141,98.3395793433,_100,10,>100
11170,chivas,166,30513307,98.340114338,_100,6,>100
11171,gases,166,30513473,98.3406493328,_100,5,>100
11172,technicians,166,30513639,98.3411843275,_100,11,>100
11173,ehrlich,166,30513805,98.3417193223,_100,7,>100
11174,paints,166,30513971,98.342254317,_100,6,>100
11175,earthy,166,30514137,98.3427893118,_100,6,>100
11176,palestinians,166,30514303,98.3433243065,_100,12,>100
11177,refinance,166,30514469,98.3438593013,_100,9,>100
11178,montero,166,30514635,98.344394296,_100,7,>100
11179,elephant,166,30514801,98.3449292908,_100,8,>100
11180,motives,166,30514967,98.3454642855,_100,7,>100
11181,famu,166,30515133,98.3459992803,_100,4,>100
11182,gdp,166,30515299,98.346534275,_100,3,>100
11183,breads,166,30515465,98.3470692698,_100,6,>100
11184,pounded,166,30515631,98.3476042645,_100,7,>100
11185,sauteed,166,30515797,98.3481392593,_100,7,>100
11186,brentwood,166,30515963,98.348674254,_100,9,>100
11187,lyon,166,30516129,98.3492092488,_100,4,>100
11188,variations,166,30516295,98.3497442435,_100,10,>100
11189,suleman,166,30516461,98.3502792383,_100,7,>100
11190,stove,166,30516627,98.350814233,_100,5,>100
11191,surfers,166,30516793,98.3513492277,_100,7,>100
11192,insights,166,30516959,98.3518842225,_100,8,>100
11193,correspondent,166,30517125,98.3524192172,_100,13,>100
11194,delaying,166,30517291,98.352954212,_100,8,>100
11195,yorker,166,30517457,98.3534892067,_100,6,>100
11196,kline,166,30517623,98.3540242015,_100,5,>100
11197,appreciates,165,30517788,98.3545559734,_100,11,>100
11198,pamela,165,30517953,98.3550877453,_100,6,>100
11199,inaccurate,165,30518118,98.3556195171,_100,10,>100
11200,intersections,165,30518283,98.356151289,_100,13,>100
11201,counterpart,165,30518448,98.3566830609,_100,11,>100
11202,advocated,165,30518613,98.3572148328,_100,9,>100
11203,rude,165,30518778,98.3577466047,_100,4,>100
11204,maui,165,30518943,98.3582783766,_100,4,>100
11205,schumaker,165,30519108,98.3588101485,_100,9,>100
11206,ca,165,30519273,98.3593419204,_100,2,>100
11207,staffer,165,30519438,98.3598736923,_100,7,>100
11208,stephens,165,30519603,98.3604054641,_100,8,>100
11209,generosity,165,30519768,98.360937236,_100,10,>100
11210,vets,165,30519933,98.3614690079,_100,4,>100
11211,festive,165,30520098,98.3620007798,_100,7,>100
11212,conflicting,165,30520263,98.3625325517,_100,11,>100
11213,roasting,165,30520428,98.3630643236,_100,8,>100
11214,barkley,165,30520593,98.3635960955,_100,7,>100
11215,blueprint,165,30520758,98.3641278674,_100,9,>100
11216,hugo,165,30520923,98.3646596392,_100,4,>100
11217,scarce,165,30521088,98.3651914111,_100,6,>100
11218,mayer,165,30521253,98.365723183,_100,5,>100
11219,elevation,165,30521418,98.3662549549,_100,9,>100
11220,165,165,30521583,98.3667867268,_100,3,>100
11221,filter,165,30521748,98.3673184987,_100,6,>100
11222,intricate,165,30521913,98.3678502706,_100,9,>100
11223,registry,165,30522078,98.3683820425,_100,8,>100
11224,judith,165,30522243,98.3689138143,_100,6,>100
11225,modeled,165,30522408,98.3694455862,_100,7,>100
11226,emergencies,165,30522573,98.3699773581,_100,11,>100
11227,functioning,165,30522738,98.37050913,_100,11,>100
11228,ironic,165,30522903,98.3710409019,_100,6,>100
11229,whereabouts,165,30523068,98.3715726738,_100,11,>100
11230,occupants,165,30523233,98.3721044457,_100,9,>100
11231,swanson,165,30523398,98.3726362176,_100,7,>100
11232,rotating,165,30523563,98.3731679894,_100,8,>100
11233,seismic,165,30523728,98.3736997613,_100,7,>100
11234,skinny,165,30523893,98.3742315332,_100,6,>100
11235,plumbing,164,30524057,98.3747600822,_100,8,>100
11236,funky,164,30524221,98.3752886313,_100,5,>100
11237,divisive,164,30524385,98.3758171803,_100,8,>100
11238,poison,164,30524549,98.3763457293,_100,6,>100
11239,underage,164,30524713,98.3768742784,_100,8,>100
11240,minivan,164,30524877,98.3774028274,_100,7,>100
11241,depp,164,30525041,98.3779313764,_100,4,>100
11242,durham,164,30525205,98.3784599254,_100,6,>100
11243,guinness,164,30525369,98.3789884745,_100,8,>100
11244,adele,164,30525533,98.3795170235,_100,5,>100
11245,catalyst,164,30525697,98.3800455725,_100,8,>100
11246,blowout,164,30525861,98.3805741216,_100,7,>100
11247,paige,164,30526025,98.3811026706,_100,5,>100
11248,belonging,164,30526189,98.3816312196,_100,9,>100
11249,clashes,164,30526353,98.3821597686,_100,7,>100
11250,lioi,164,30526517,98.3826883177,_100,4,>100
11251,castillo,164,30526681,98.3832168667,_100,8,>100
11252,unrestricted,164,30526845,98.3837454157,_100,12,>100
11253,pr,164,30527009,98.3842739648,_100,2,>100
11254,storied,164,30527173,98.3848025138,_100,7,>100
11255,gentleman,164,30527337,98.3853310628,_100,9,>100
11256,pits,164,30527501,98.3858596118,_100,4,>100
11257,aspen,164,30527665,98.3863881609,_100,5,>100
11258,mattered,164,30527829,98.3869167099,_100,8,>100
11259,crushing,164,30527993,98.3874452589,_100,8,>100
11260,globally,164,30528157,98.3879738079,_100,8,>100
11261,traced,164,30528321,98.388502357,_100,6,>100
11262,harmed,164,30528485,98.389030906,_100,6,>100
11263,peek,164,30528649,98.389559455,_100,4,>100
11264,endangering,164,30528813,98.3900880041,_100,11,>100
11265,explicit,164,30528977,98.3906165531,_100,8,>100
11266,norway,164,30529141,98.3911451021,_100,6,>100
11267,leftover,164,30529305,98.3916736511,_100,8,>100
11268,capability,164,30529469,98.3922022002,_100,10,>100
11269,flush,164,30529633,98.3927307492,_100,5,>100
11270,explores,164,30529797,98.3932592982,_100,8,>100
11271,grad,164,30529961,98.3937878473,_100,4,>100
11272,plots,164,30530125,98.3943163963,_100,5,>100
11273,continent,164,30530289,98.3948449453,_100,9,>100
11274,gonzales,163,30530452,98.3953702715,_100,8,>100
11275,clinched,163,30530615,98.3958955976,_100,8,>100
11276,presley,163,30530778,98.3964209238,_100,7,>100
11277,infectious,163,30530941,98.39694625,_100,10,>100
11278,soto,163,30531104,98.3974715761,_100,4,>100
11279,cheddar,163,30531267,98.3979969023,_100,7,>100
11280,championed,163,30531430,98.3985222285,_100,10,>100
11281,viral,163,30531593,98.3990475547,_100,5,>100
11282,airs,163,30531756,98.3995728808,_100,4,>100
11283,smuggling,163,30531919,98.400098207,_100,9,>100
11284,banners,163,30532082,98.4006235332,_100,7,>100
11285,belgium,163,30532245,98.4011488593,_100,7,>100
11286,cupcakes,163,30532408,98.4016741855,_100,8,>100
11287,shoreline,163,30532571,98.4021995117,_100,9,>100
11288,becky,163,30532734,98.4027248378,_100,5,>100
11289,mcguire,163,30532897,98.403250164,_100,7,>100
11290,outline,163,30533060,98.4037754902,_100,7,>100
11291,huntsman,163,30533223,98.4043008163,_100,8,>100
11292,lousy,163,30533386,98.4048261425,_100,5,>100
11293,sip,163,30533549,98.4053514687,_100,3,>100
11294,announces,163,30533712,98.4058767948,_100,9,>100
11295,tangy,163,30533875,98.406402121,_100,5,>100
11296,watkins,163,30534038,98.4069274472,_100,7,>100
11297,punching,163,30534201,98.4074527733,_100,8,>100
11298,inherent,163,30534364,98.4079780995,_100,8,>100
11299,norfolk,163,30534527,98.4085034257,_100,7,>100
11300,slider,163,30534690,98.4090287518,_100,6,>100
11301,flourish,163,30534853,98.409554078,_100,8,>100
11302,feinstein,163,30535016,98.4100794042,_100,9,>100
11303,copyright,162,30535178,98.4106015075,_100,9,>100
11304,grady,162,30535340,98.4111236108,_100,5,>100
11305,162,162,30535502,98.4116457141,_100,3,>100
11306,liabilities,162,30535664,98.4121678174,_100,11,>100
11307,bookstore,162,30535826,98.4126899207,_100,9,>100
11308,decidedly,162,30535988,98.413212024,_100,9,>100
11309,jointly,162,30536150,98.4137341273,_100,7,>100
11310,robberies,162,30536312,98.4142562306,_100,9,>100
11311,carole,162,30536474,98.414778334,_100,6,>100
11312,bun,162,30536636,98.4153004373,_100,3,>100
11313,variation,162,30536798,98.4158225406,_100,9,>100
11314,screenplay,162,30536960,98.4163446439,_100,10,>100
11315,boast,162,30537122,98.4168667472,_100,5,>100
11316,umpire,162,30537284,98.4173888505,_100,6,>100
11317,garnett,162,30537446,98.4179109538,_100,7,>100
11318,aerial,162,30537608,98.4184330571,_100,6,>100
11319,intercepted,162,30537770,98.4189551604,_100,11,>100
11320,asphalt,162,30537932,98.4194772637,_100,7,>100
11321,lexus,162,30538094,98.419999367,_100,5,>100
11322,influx,162,30538256,98.4205214703,_100,6,>100
11323,carte,162,30538418,98.4210435736,_100,5,>100
11324,downright,162,30538580,98.421565677,_100,9,>100
11325,guild,162,30538742,98.4220877803,_100,5,>100
11326,grey,162,30538904,98.4226098836,_100,4,>100
11327,clemons,162,30539066,98.4231319869,_100,7,>100
11328,pear,162,30539228,98.4236540902,_100,4,>100
11329,restrooms,162,30539390,98.4241761935,_100,9,>100
11330,startling,162,30539552,98.4246982968,_100,9,>100
11331,concord,162,30539714,98.4252204001,_100,7,>100
11332,spouses,162,30539876,98.4257425034,_100,7,>100
11333,onetime,162,30540038,98.4262646067,_100,7,>100
11334,honolulu,162,30540200,98.42678671,_100,8,>100
11335,dumping,162,30540362,98.4273088133,_100,7,>100
11336,frequency,162,30540524,98.4278309167,_100,9,>100
11337,testosterone,162,30540686,98.42835302,_100,12,>100
11338,cabins,162,30540848,98.4288751233,_100,6,>100
11339,berger,162,30541010,98.4293972266,_100,6,>100
11340,schaefer,162,30541172,98.4299193299,_100,8,>100
11341,snaps,162,30541334,98.4304414332,_100,5,>100
11342,altercation,162,30541496,98.4309635365,_100,11,>100
11343,retaining,161,30541657,98.4314824169,_100,9,>100
11344,hastings,161,30541818,98.4320012974,_100,8,>100
11345,prediction,161,30541979,98.4325201778,_100,10,>100
11346,harmon,161,30542140,98.4330390583,_100,6,>100
11347,squares,161,30542301,98.4335579387,_100,7,>100
11348,midfield,161,30542462,98.4340768192,_100,8,>100
11349,isle,161,30542623,98.4345956996,_100,4,>100
11350,levee,161,30542784,98.4351145801,_100,5,>100
11351,belmont,161,30542945,98.4356334605,_100,7,>100
11352,larson,161,30543106,98.436152341,_100,6,>100
11353,bleak,161,30543267,98.4366712214,_100,5,>100
11354,pineda,161,30543428,98.4371901019,_100,6,>100
11355,wander,161,30543589,98.4377089823,_100,6,>100
11356,calf,161,30543750,98.4382278628,_100,4,>100
11357,occupancy,161,30543911,98.4387467432,_100,9,>100
11358,pumper,161,30544072,98.4392656237,_100,6,>100
11359,accuses,161,30544233,98.4397845041,_100,7,>100
11360,berkshire,161,30544394,98.4403033846,_100,9,>100
11361,showcases,161,30544555,98.440822265,_100,9,>100
11362,fairy,161,30544716,98.4413411455,_100,5,>100
11363,canby,161,30544877,98.4418600259,_100,5,>100
11364,chinatown,161,30545038,98.4423789064,_100,9,>100
11365,fascinated,161,30545199,98.4428977868,_100,10,>100
11366,bloomington,161,30545360,98.4434166673,_100,11,>100
11367,brunner,161,30545521,98.4439355477,_100,7,>100
11368,dealerships,161,30545682,98.4444544281,_100,11,>100
11369,lexington,161,30545843,98.4449733086,_100,9,>100
11370,implicated,161,30546004,98.445492189,_100,10,>100
11371,scandals,161,30546165,98.4460110695,_100,8,>100
11372,metals,161,30546326,98.4465299499,_100,6,>100
11373,genes,161,30546487,98.4470488304,_100,5,>100
11374,guthrie,161,30546648,98.4475677108,_100,7,>100
11375,communist,161,30546809,98.4480865913,_100,9,>100
11376,prey,161,30546970,98.4486054717,_100,4,>100
11377,ferris,161,30547131,98.4491243522,_100,6,>100
11378,sellout,161,30547292,98.4496432326,_100,7,>100
11379,lamichael,161,30547453,98.4501621131,_100,9,>100
11380,deter,161,30547614,98.4506809935,_100,5,>100
11381,uphold,161,30547775,98.451199874,_100,6,>100
11382,vacuum,161,30547936,98.4517187544,_100,6,>100
11383,caltrans,161,30548097,98.4522376349,_100,8,>100
11384,wagon,161,30548258,98.4527565153,_100,5,>100
11385,reno,161,30548419,98.4532753958,_100,4,>100
11386,kissimmee,160,30548579,98.4537910534,_100,9,>100
11387,vampire,160,30548739,98.4543067109,_100,7,>100
11388,wealthiest,160,30548899,98.4548223685,_100,10,>100
11389,racked,160,30549059,98.4553380261,_100,6,>100
11390,lancers,160,30549219,98.4558536837,_100,7,>100
11391,linden,160,30549379,98.4563693413,_100,6,>100
11392,packaged,160,30549539,98.4568849989,_100,8,>100
11393,itunes,160,30549699,98.4574006565,_100,6,>100
11394,veggies,160,30549859,98.4579163141,_100,7,>100
11395,deliberate,160,30550019,98.4584319716,_100,10,>100
11396,meth,160,30550179,98.4589476292,_100,4,>100
11397,vaccines,160,30550339,98.4594632868,_100,8,>100
11398,heavyweight,160,30550499,98.4599789444,_100,11,>100
11399,caldwell,160,30550659,98.460494602,_100,8,>100
11400,fur,160,30550819,98.4610102596,_100,3,>100
11401,puppy,160,30550979,98.4615259172,_100,5,>100
11402,erased,160,30551139,98.4620415748,_100,6,>100
11403,landlords,160,30551299,98.4625572324,_100,9,>100
11404,fukushima,160,30551459,98.4630728899,_100,9,>100
11405,warmed,160,30551619,98.4635885475,_100,6,>100
11406,subjected,160,30551779,98.4641042051,_100,9,>100
11407,itinerary,160,30551939,98.4646198627,_100,9,>100
11408,bonding,160,30552099,98.4651355203,_100,7,>100
11409,qualifier,160,30552259,98.4656511779,_100,9,>100
11410,glowing,160,30552419,98.4661668355,_100,7,>100
11411,unfinished,160,30552579,98.4666824931,_100,10,>100
11412,tray,160,30552739,98.4671981506,_100,4,>100
11413,commanders,160,30552899,98.4677138082,_100,10,>100
11414,carrot,160,30553059,98.4682294658,_100,6,>100
11415,override,160,30553219,98.4687451234,_100,8,>100
11416,mixes,160,30553379,98.469260781,_100,5,>100
11417,seared,160,30553539,98.4697764386,_100,6,>100
11418,clearwater,160,30553699,98.4702920962,_100,10,>100
11419,fatalities,160,30553859,98.4708077538,_100,10,>100
11420,widening,160,30554019,98.4713234114,_100,8,>100
11421,villain,160,30554179,98.4718390689,_100,7,>100
11422,diplomats,160,30554339,98.4723547265,_100,9,>100
11423,160,160,30554499,98.4728703841,_100,3,>100
11424,midwestern,159,30554658,98.4733828188,_100,10,>100
11425,silva,159,30554817,98.4738952536,_100,5,>100
11426,enables,159,30554976,98.4744076883,_100,7,>100
11427,swan,159,30555135,98.474920123,_100,4,>100
11428,taller,159,30555294,98.4754325578,_100,6,>100
11429,thereby,159,30555453,98.4759449925,_100,7,>100
11430,rum,159,30555612,98.4764574272,_100,3,>100
11431,souls,159,30555771,98.4769698619,_100,5,>100
11432,charismatic,159,30555930,98.4774822967,_100,11,>100
11433,enabling,159,30556089,98.4779947314,_100,8,>100
11434,disagreement,159,30556248,98.4785071661,_100,12,>100
11435,incorrectly,159,30556407,98.4790196009,_100,11,>100
11436,attacker,159,30556566,98.4795320356,_100,8,>100
11437,pontiac,159,30556725,98.4800444703,_100,7,>100
11438,valor,159,30556884,98.480556905,_100,5,>100
11439,motto,159,30557043,98.4810693398,_100,5,>100
11440,sinatra,159,30557202,98.4815817745,_100,7,>100
11441,relish,159,30557361,98.4820942092,_100,6,>100
11442,slugging,159,30557520,98.482606644,_100,8,>100
11443,broadcaster,159,30557679,98.4831190787,_100,11,>100
11444,cotto,159,30557838,98.4836315134,_100,5,>100
11445,doubleheader,159,30557997,98.4841439481,_100,12,>100
11446,comfortably,159,30558156,98.4846563829,_100,11,>100
11447,accuse,159,30558315,98.4851688176,_100,6,>100
11448,erase,159,30558474,98.4856812523,_100,5,>100
11449,surgeons,159,30558633,98.486193687,_100,8,>100
11450,overdose,159,30558792,98.4867061218,_100,8,>100
11451,saddened,159,30558951,98.4872185565,_100,8,>100
11452,saute,159,30559110,98.4877309912,_100,5,>100
11453,backpack,159,30559269,98.488243426,_100,8,>100
11454,gwinnett,159,30559428,98.4887558607,_100,8,>100
11455,taiwan,159,30559587,98.4892682954,_100,6,>100
11456,flemington,159,30559746,98.4897807301,_100,10,>100
11457,underscores,159,30559905,98.4902931649,_100,11,>100
11458,drastically,159,30560064,98.4908055996,_100,11,>100
11459,fledgling,159,30560223,98.4913180343,_100,9,>100
11460,cutter,159,30560382,98.4918304691,_100,6,>100
11461,alison,159,30560541,98.4923429038,_100,6,>100
11462,unincorporated,159,30560700,98.4928553385,_100,14,>100
11463,buford,159,30560859,98.4933677732,_100,6,>100
11464,slapped,159,30561018,98.493880208,_100,7,>100
11465,jerseyans,158,30561176,98.4943894198,_100,9,>100
11466,leaking,158,30561334,98.4948986317,_100,7,>100
11467,cent,158,30561492,98.4954078436,_100,4,>100
11468,backstage,158,30561650,98.4959170554,_100,9,>100
11469,knox,158,30561808,98.4964262673,_100,4,>100
11470,akin,158,30561966,98.4969354792,_100,4,>100
11471,setbacks,158,30562124,98.4974446911,_100,8,>100
11472,barker,158,30562282,98.4979539029,_100,6,>100
11473,booster,158,30562440,98.4984631148,_100,7,>100
11474,cruelty,158,30562598,98.4989723267,_100,7,>100
11475,prevail,158,30562756,98.4994815385,_100,7,>100
11476,devon,158,30562914,98.4999907504,_100,5,>100
11477,crumbling,158,30563072,98.5004999623,_100,9,>100
11478,phases,158,30563230,98.5010091741,_100,6,>100
11479,muster,158,30563388,98.501518386,_100,6,>100
11480,levees,158,30563546,98.5020275979,_100,6,>100
11481,amend,158,30563704,98.5025368097,_100,5,>100
11482,cambridge,158,30563862,98.5030460216,_100,9,>100
11483,ricotta,158,30564020,98.5035552335,_100,7,>100
11484,breasts,158,30564178,98.5040644453,_100,7,>100
11485,pantry,158,30564336,98.5045736572,_100,6,>100
11486,succeeds,158,30564494,98.5050828691,_100,8,>100
11487,farmland,158,30564652,98.5055920809,_100,8,>100
11488,anthem,158,30564810,98.5061012928,_100,6,>100
11489,stokes,158,30564968,98.5066105047,_100,6,>100
11490,dues,158,30565126,98.5071197165,_100,4,>100
11491,kendrick,158,30565284,98.5076289284,_100,8,>100
11492,ahmad,158,30565442,98.5081381403,_100,5,>100
11493,dexter,158,30565600,98.5086473522,_100,6,>100
11494,westwood,158,30565758,98.509156564,_100,8,>100
11495,isaac,158,30565916,98.5096657759,_100,5,>100
11496,arson,158,30566074,98.5101749878,_100,5,>100
11497,citations,158,30566232,98.5106841996,_100,9,>100
11498,ecb,158,30566390,98.5111934115,_100,3,>100
11499,fritz,158,30566548,98.5117026234,_100,5,>100
11500,predominantly,158,30566706,98.5122118352,_100,13,>100
11501,oz,158,30566864,98.5127210471,_100,2,>100
11502,clarkson,158,30567022,98.513230259,_100,8,>100
11503,snake,158,30567180,98.5137394708,_100,5,>100
11504,gatherings,158,30567338,98.5142486827,_100,10,>100
11505,nearing,158,30567496,98.5147578946,_100,7,>100
11506,exhibitions,158,30567654,98.5152671064,_100,11,>100
11507,steered,158,30567812,98.5157763183,_100,7,>100
11508,giroux,158,30567970,98.5162855302,_100,6,>100
11509,simplicity,157,30568127,98.5167915192,_100,10,>100
11510,tempo,157,30568284,98.5172975082,_100,5,>100
11511,getaway,157,30568441,98.5178034972,_100,7,>100
11512,bumper,157,30568598,98.5183094862,_100,6,>100
11513,iceberg,157,30568755,98.5188154752,_100,7,>100
11514,structured,157,30568912,98.5193214642,_100,10,>100
11515,157,157,30569069,98.5198274532,_100,3,>100
11516,pneumonia,157,30569226,98.5203334422,_100,9,>100
11517,precincts,157,30569383,98.5208394313,_100,9,>100
11518,cancellation,157,30569540,98.5213454203,_100,12,>100
11519,wichita,157,30569697,98.5218514093,_100,7,>100
11520,havoc,157,30569854,98.5223573983,_100,5,>100
11521,hoops,157,30570011,98.5228633873,_100,5,>100
11522,spears,157,30570168,98.5233693763,_100,6,>100
11523,marian,157,30570325,98.5238753653,_100,6,>100
11524,humanitarian,157,30570482,98.5243813543,_100,12,>100
11525,rios,157,30570639,98.5248873433,_100,4,>100
11526,demonstrating,157,30570796,98.5253933323,_100,13,>100
11527,undecided,157,30570953,98.5258993213,_100,9,>100
11528,malpractice,157,30571110,98.5264053103,_100,11,>100
11529,destructive,157,30571267,98.5269112994,_100,11,>100
11530,colleen,157,30571424,98.5274172884,_100,7,>100
11531,flame,157,30571581,98.5279232774,_100,5,>100
11532,coffers,157,30571738,98.5284292664,_100,7,>100
11533,indications,157,30571895,98.5289352554,_100,11,>100
11534,cynical,157,30572052,98.5294412444,_100,7,>100
11535,innovations,157,30572209,98.5299472334,_100,11,>100
11536,vanessa,157,30572366,98.5304532224,_100,7,>100
11537,babbitt,157,30572523,98.5309592114,_100,7,>100
11538,rests,157,30572680,98.5314652004,_100,5,>100
11539,blaine,157,30572837,98.5319711894,_100,6,>100
11540,vying,157,30572994,98.5324771784,_100,5,>100
11541,michel,157,30573151,98.5329831675,_100,6,>100
11542,myth,157,30573308,98.5334891565,_100,4,>100
11543,sped,157,30573465,98.5339951455,_100,4,>100
11544,histories,157,30573622,98.5345011345,_100,9,>100
11545,otis,156,30573778,98.5350039006,_100,4,>100
11546,maloney,156,30573934,98.5355066668,_100,7,>100
11547,barton,156,30574090,98.5360094329,_100,6,>100
11548,whip,156,30574246,98.5365121991,_100,4,>100
11549,crawl,156,30574402,98.5370149652,_100,5,>100
11550,normandy,156,30574558,98.5375177314,_100,8,>100
11551,irresponsible,156,30574714,98.5380204975,_100,13,>100
11552,tribes,156,30574870,98.5385232637,_100,6,>100
11553,shooters,156,30575026,98.5390260298,_100,8,>100
11554,philosophical,156,30575182,98.539528796,_100,13,>100
11555,ignited,156,30575338,98.5400315621,_100,7,>100
11556,twain,156,30575494,98.5405343283,_100,5,>100
11557,bullied,156,30575650,98.5410370944,_100,7,>100
11558,feds,156,30575806,98.5415398606,_100,4,>100
11559,consulted,156,30575962,98.5420426267,_100,9,>100
11560,poorest,156,30576118,98.5425453929,_100,7,>100
11561,raffle,156,30576274,98.543048159,_100,6,>100
11562,pbs,156,30576430,98.5435509252,_100,3,>100
11563,prosciutto,156,30576586,98.5440536913,_100,10,>100
11564,focal,156,30576742,98.5445564574,_100,5,>100
11565,playbook,156,30576898,98.5450592236,_100,8,>100
11566,slain,156,30577054,98.5455619897,_100,5,>100
11567,zuckerberg,156,30577210,98.5460647559,_100,10,>100
11568,nominating,156,30577366,98.546567522,_100,10,>100
11569,pinnacle,156,30577522,98.5470702882,_100,8,>100
11570,deported,156,30577678,98.5475730543,_100,8,>100
11571,headache,156,30577834,98.5480758205,_100,8,>100
11572,loading,156,30577990,98.5485785866,_100,7,>100
11573,raided,156,30578146,98.5490813528,_100,6,>100
11574,refinery,156,30578302,98.5495841189,_100,8,>100
11575,pena,156,30578458,98.5500868851,_100,4,>100
11576,relieve,156,30578614,98.5505896512,_100,7,>100
11577,revived,156,30578770,98.5510924174,_100,7,>100
11578,abundant,156,30578926,98.5515951835,_100,8,>100
11579,cu,156,30579082,98.5520979497,_100,2,>100
11580,sheridan,156,30579238,98.5526007158,_100,8,>100
11581,dh,156,30579394,98.553103482,_100,2,>100
11582,theresa,156,30579550,98.5536062481,_100,7,>100
11583,bore,156,30579706,98.5541090143,_100,4,>100
11584,intrigued,156,30579862,98.5546117804,_100,9,>100
11585,vines,156,30580018,98.5551145466,_100,5,>100
11586,unrest,156,30580174,98.5556173127,_100,6,>100
11587,peanuts,156,30580330,98.5561200789,_100,7,>100
11588,weathered,156,30580486,98.556622845,_100,9,>100
11589,conrad,156,30580642,98.5571256112,_100,6,>100
11590,hennepin,156,30580798,98.5576283773,_100,8,>100
11591,bribe,156,30580954,98.5581311435,_100,5,>100
11592,possessing,156,30581110,98.5586339096,_100,10,>100
11593,brighter,156,30581266,98.5591366758,_100,8,>100
11594,whedon,156,30581422,98.5596394419,_100,6,>100
11595,cane,156,30581578,98.560142208,_100,4,>100
11596,protocol,156,30581734,98.5606449742,_100,8,>100
11597,husted,156,30581890,98.5611477403,_100,6,>100
11598,challengers,156,30582046,98.5616505065,_100,11,>100
11599,tempting,155,30582201,98.5621500498,_100,8,>100
11600,chaired,155,30582356,98.5626495931,_100,7,>100
11601,cooled,155,30582511,98.5631491364,_100,6,>100
11602,correctional,155,30582666,98.5636486796,_100,12,>100
11603,whatsoever,155,30582821,98.5641482229,_100,10,>100
11604,periodically,155,30582976,98.5646477662,_100,12,>100
11605,mistakenly,155,30583131,98.5651473095,_100,10,>100
11606,forge,155,30583286,98.5656468528,_100,5,>100
11607,tract,155,30583441,98.5661463961,_100,5,>100
11608,afghans,155,30583596,98.5666459394,_100,7,>100
11609,raritan,155,30583751,98.5671454827,_100,7,>100
11610,cough,155,30583906,98.567645026,_100,5,>100
11611,speculated,155,30584061,98.5681445692,_100,10,>100
11612,timed,155,30584216,98.5686441125,_100,5,>100
11613,155,155,30584371,98.5691436558,_100,3,>100
11614,females,155,30584526,98.5696431991,_100,7,>100
11615,dubai,155,30584681,98.5701427424,_100,5,>100
11616,americas,155,30584836,98.5706422857,_100,8,>100
11617,neon,155,30584991,98.571141829,_100,4,>100
11618,competent,155,30585146,98.5716413723,_100,9,>100
11619,taxed,155,30585301,98.5721409156,_100,5,>100
11620,desirable,155,30585456,98.5726404588,_100,9,>100
11621,voyage,155,30585611,98.5731400021,_100,6,>100
11622,cruises,155,30585766,98.5736395454,_100,7,>100
11623,arose,155,30585921,98.5741390887,_100,5,>100
11624,sounding,155,30586076,98.574638632,_100,8,>100
11625,baghdad,155,30586231,98.5751381753,_100,7,>100
11626,electronically,155,30586386,98.5756377186,_100,14,>100
11627,relating,155,30586541,98.5761372619,_100,8,>100
11628,wooded,155,30586696,98.5766368052,_100,6,>100
11629,truman,155,30586851,98.5771363484,_100,6,>100
11630,submitting,155,30587006,98.5776358917,_100,10,>100
11631,motions,155,30587161,98.578135435,_100,7,>100
11632,unintended,155,30587316,98.5786349783,_100,10,>100
11633,keynote,155,30587471,98.5791345216,_100,7,>100
11634,floods,155,30587626,98.5796340649,_100,6,>100
11635,terrence,155,30587781,98.5801336082,_100,8,>100
11636,seminars,155,30587936,98.5806331515,_100,8,>100
11637,fences,155,30588091,98.5811326947,_100,6,>100
11638,negotiation,154,30588245,98.5816290152,_100,11,>100
11639,mat,154,30588399,98.5821253356,_100,3,>100
11640,hostage,154,30588553,98.582621656,_100,7,>100
11641,reliance,154,30588707,98.5831179765,_100,8,>100
11642,maneuver,154,30588861,98.5836142969,_100,8,>100
11643,tapes,154,30589015,98.5841106173,_100,5,>100
11644,fronts,154,30589169,98.5846069377,_100,6,>100
11645,rockwood,154,30589323,98.5851032582,_100,8,>100
11646,sizemore,154,30589477,98.5855995786,_100,8,>100
11647,dismal,154,30589631,98.586095899,_100,6,>100
11648,154,154,30589785,98.5865922195,_100,3,>100
11649,countywide,154,30589939,98.5870885399,_100,10,>100
11650,costello,154,30590093,98.5875848603,_100,8,>100
11651,unanswered,154,30590247,98.5880811807,_100,10,>100
11652,discus,154,30590401,98.5885775012,_100,6,>100
11653,methamphetamine,154,30590555,98.5890738216,_100,15,>100
11654,logistics,154,30590709,98.589570142,_100,9,>100
11655,phelps,154,30590863,98.5900664625,_100,6,>100
11656,dui,154,30591017,98.5905627829,_100,3,>100
11657,irrelevant,154,30591171,98.5910591033,_100,10,>100
11658,acc,154,30591325,98.5915554237,_100,3,>100
11659,veal,154,30591479,98.5920517442,_100,4,>100
11660,explicitly,154,30591633,98.5925480646,_100,10,>100
11661,herrera,154,30591787,98.593044385,_100,7,>100
11662,contributes,154,30591941,98.5935407055,_100,11,>100
11663,cy,154,30592095,98.5940370259,_100,2,>100
11664,downhill,154,30592249,98.5945333463,_100,8,>100
11665,utterly,154,30592403,98.5950296667,_100,7,>100
11666,martial,154,30592557,98.5955259872,_100,7,>100
11667,golfer,154,30592711,98.5960223076,_100,6,>100
11668,landmarks,154,30592865,98.596518628,_100,9,>100
11669,flashy,154,30593019,98.5970149485,_100,6,>100
11670,flores,154,30593173,98.5975112689,_100,6,>100
11671,scottish,154,30593327,98.5980075893,_100,8,>100
11672,alien,154,30593481,98.5985039097,_100,5,>100
11673,technological,154,30593635,98.5990002302,_100,13,>100
11674,tentatively,154,30593789,98.5994965506,_100,11,>100
11675,incorrect,154,30593943,98.599992871,_100,9,>100
11676,referee,154,30594097,98.6004891915,_100,7,>100
11677,dvds,154,30594251,98.6009855119,_100,4,>100
11678,wyden,154,30594405,98.6014818323,_100,5,>100
11679,voinovich,154,30594559,98.6019781527,_100,9,>100
11680,northfield,154,30594713,98.6024744732,_100,10,>100
11681,legrand,154,30594867,98.6029707936,_100,7,>100
11682,visibility,153,30595020,98.6034638912,_100,10,>100
11683,dodger,153,30595173,98.6039569887,_100,6,>100
11684,grueling,153,30595326,98.6044500863,_100,8,>100
11685,wilcox,153,30595479,98.6049431839,_100,6,>100
11686,almond,153,30595632,98.6054362814,_100,6,>100
11687,explorer,153,30595785,98.605929379,_100,8,>100
11688,burglaries,153,30595938,98.6064224766,_100,10,>100
11689,craigslist,153,30596091,98.6069155742,_100,10,>100
11690,volatility,153,30596244,98.6074086717,_100,10,>100
11691,strains,153,30596397,98.6079017693,_100,7,>100
11692,immense,153,30596550,98.6083948669,_100,7,>100
11693,revamped,153,30596703,98.6088879644,_100,8,>100
11694,projection,153,30596856,98.609381062,_100,10,>100
11695,grinding,153,30597009,98.6098741596,_100,8,>100
11696,scorers,153,30597162,98.6103672571,_100,7,>100
11697,fatty,153,30597315,98.6108603547,_100,5,>100
11698,eileen,153,30597468,98.6113534523,_100,6,>100
11699,narcotics,153,30597621,98.6118465498,_100,9,>100
11700,militant,153,30597774,98.6123396474,_100,8,>100
11701,ku,153,30597927,98.612832745,_100,2,>100
11702,boundary,153,30598080,98.6133258425,_100,8,>100
11703,caleb,153,30598233,98.6138189401,_100,5,>100
11704,stunt,153,30598386,98.6143120377,_100,5,>100
11705,repaid,153,30598539,98.6148051353,_100,6,>100
11706,continuously,153,30598692,98.6152982328,_100,12,>100
11707,cherries,153,30598845,98.6157913304,_100,8,>100
11708,elijah,153,30598998,98.616284428,_100,6,>100
11709,foothills,153,30599151,98.6167775255,_100,9,>100
11710,livestock,153,30599304,98.6172706231,_100,9,>100
11711,stickers,153,30599457,98.6177637207,_100,8,>100
11712,payout,153,30599610,98.6182568182,_100,6,>100
11713,remotely,153,30599763,98.6187499158,_100,8,>100
11714,corona,153,30599916,98.6192430134,_100,6,>100
11715,fairfield,153,30600069,98.6197361109,_100,9,>100
11716,gravity,153,30600222,98.6202292085,_100,7,>100
11717,greed,153,30600375,98.6207223061,_100,5,>100
11718,backfield,153,30600528,98.6212154036,_100,9,>100
11719,eateries,153,30600681,98.6217085012,_100,8,>100
11720,recommending,153,30600834,98.6222015988,_100,12,>100
11721,orchestrated,153,30600987,98.6226946964,_100,12,>100
11722,hazards,153,30601140,98.6231877939,_100,7,>100
11723,mentioning,153,30601293,98.6236808915,_100,10,>100
11724,reinstated,153,30601446,98.6241739891,_100,10,>100
11725,153,153,30601599,98.6246670866,_100,3,>100
11726,absentee,153,30601752,98.6251601842,_100,8,>100
11727,ritter,153,30601905,98.6256532818,_100,6,>100
11728,provocative,153,30602058,98.6261463793,_100,11,>100
11729,hourly,153,30602211,98.6266394769,_100,6,>100
11730,displaying,153,30602364,98.6271325745,_100,10,>100
11731,intimidated,153,30602517,98.627625672,_100,11,>100
11732,swear,153,30602670,98.6281187696,_100,5,>100
11733,engineered,153,30602823,98.6286118672,_100,10,>100
11734,barring,153,30602976,98.6291049647,_100,7,>100
11735,remodel,153,30603129,98.6295980623,_100,7,>100
11736,perched,153,30603282,98.6300911599,_100,7,>100
11737,mighty,153,30603435,98.6305842575,_100,6,>100
11738,robber,153,30603588,98.631077355,_100,6,>100
11739,veterinarian,153,30603741,98.6315704526,_100,12,>100
11740,wandered,153,30603894,98.6320635502,_100,8,>100
11741,cloves,153,30604047,98.6325566477,_100,6,>100
11742,footwear,153,30604200,98.6330497453,_100,8,>100
11743,disruptive,153,30604353,98.6335428429,_100,10,>100
11744,weiner,152,30604505,98.6340327176,_100,6,>100
11745,alberta,152,30604657,98.6345225923,_100,7,>100
11746,oversized,152,30604809,98.635012467,_100,9,>100
11747,kaine,152,30604961,98.6355023417,_100,5,>100
11748,venice,152,30605113,98.6359922164,_100,6,>100
11749,hatch,152,30605265,98.6364820911,_100,5,>100
11750,ortega,152,30605417,98.6369719658,_100,6,>100
11751,citywide,152,30605569,98.6374618405,_100,8,>100
11752,joanne,152,30605721,98.6379517152,_100,6,>100
11753,buena,152,30605873,98.63844159,_100,5,>100
11754,parishioners,152,30606025,98.6389314647,_100,12,>100
11755,shining,152,30606177,98.6394213394,_100,7,>100
11756,meaty,152,30606329,98.6399112141,_100,5,>100
11757,ponzi,152,30606481,98.6404010888,_100,5,>100
11758,advising,152,30606633,98.6408909635,_100,8,>100
11759,meredith,152,30606785,98.6413808382,_100,8,>100
11760,deliberations,152,30606937,98.6418707129,_100,13,>100
11761,seminole,152,30607089,98.6423605876,_100,8,>100
11762,whistle,152,30607241,98.6428504623,_100,7,>100
11763,beast,152,30607393,98.643340337,_100,5,>100
11764,concerto,152,30607545,98.6438302117,_100,8,>100
11765,manufacture,152,30607697,98.6443200865,_100,11,>100
11766,staircase,152,30607849,98.6448099612,_100,9,>100
11767,exceptionally,152,30608001,98.6452998359,_100,13,>100
11768,weaken,152,30608153,98.6457897106,_100,6,>100
11769,calculate,152,30608305,98.6462795853,_100,9,>100
11770,departing,152,30608457,98.64676946,_100,9,>100
11771,ss,152,30608609,98.6472593347,_100,2,>100
11772,woodbury,152,30608761,98.6477492094,_100,8,>100
11773,accents,152,30608913,98.6482390841,_100,7,>100
11774,installations,152,30609065,98.6487289588,_100,13,>100
11775,terps,152,30609217,98.6492188335,_100,5,>100
11776,muted,152,30609369,98.6497087083,_100,5,>100
11777,rodham,152,30609521,98.650198583,_100,6,>100
11778,disrupted,152,30609673,98.6506884577,_100,9,>100
11779,polk,152,30609825,98.6511783324,_100,4,>100
11780,recognizable,152,30609977,98.6516682071,_100,12,>100
11781,footsteps,152,30610129,98.6521580818,_100,9,>100
11782,chanted,152,30610281,98.6526479565,_100,7,>100
11783,pearson,152,30610433,98.6531378312,_100,7,>100
11784,barron,152,30610585,98.6536277059,_100,6,>100
11785,wrigley,152,30610737,98.6541175806,_100,7,>100
11786,152,152,30610889,98.6546074553,_100,3,>100
11787,conducts,152,30611041,98.65509733,_100,8,>100
11788,ineligible,152,30611193,98.6555872048,_100,10,>100
11789,blagojevich,152,30611345,98.6560770795,_100,11,>100
11790,spared,152,30611497,98.6565669542,_100,6,>100
11791,inspect,151,30611648,98.657053606,_100,7,>100
11792,deductions,151,30611799,98.6575402579,_100,10,>100
11793,traits,151,30611950,98.6580269097,_100,6,>100
11794,schundler,151,30612101,98.6585135616,_100,9,>100
11795,senses,151,30612252,98.6590002134,_100,6,>100
11796,lauderdale,151,30612403,98.6594868653,_100,10,>100
11797,infusion,151,30612554,98.6599735171,_100,8,>100
11798,valuation,151,30612705,98.660460169,_100,9,>100
11799,proceeded,151,30612856,98.6609468208,_100,9,>100
11800,traces,151,30613007,98.6614334727,_100,6,>100
11801,proactive,151,30613158,98.6619201245,_100,9,>100
11802,coup,151,30613309,98.6624067764,_100,4,>100
11803,wandering,151,30613460,98.6628934282,_100,9,>100
11804,extensions,151,30613611,98.6633800801,_100,10,>100
11805,anticipating,151,30613762,98.6638667319,_100,12,>100
11806,shrubs,151,30613913,98.6643533838,_100,6,>100
11807,geography,151,30614064,98.6648400356,_100,9,>100
11808,pendleton,151,30614215,98.6653266875,_100,9,>100
11809,cranford,151,30614366,98.6658133393,_100,8,>100
11810,divert,151,30614517,98.6662999912,_100,6,>100
11811,approves,151,30614668,98.666786643,_100,8,>100
11812,taxing,151,30614819,98.6672732948,_100,6,>100
11813,katy,151,30614970,98.6677599467,_100,4,>100
11814,rejection,151,30615121,98.6682465985,_100,9,>100
11815,unveiling,151,30615272,98.6687332504,_100,9,>100
11816,brightly,151,30615423,98.6692199022,_100,8,>100
11817,gravel,151,30615574,98.6697065541,_100,6,>100
11818,crises,151,30615725,98.6701932059,_100,6,>100
11819,breweries,151,30615876,98.6706798578,_100,9,>100
11820,romero,151,30616027,98.6711665096,_100,6,>100
11821,hesitate,151,30616178,98.6716531615,_100,8,>100
11822,organizational,151,30616329,98.6721398133,_100,14,>100
11823,thunderstorms,151,30616480,98.6726264652,_100,13,>100
11824,bravo,151,30616631,98.673113117,_100,5,>100
11825,robbie,151,30616782,98.6735997689,_100,6,>100
11826,adler,151,30616933,98.6740864207,_100,5,>100
11827,wisniewski,151,30617084,98.6745730726,_100,10,>100
11828,dice,151,30617235,98.6750597244,_100,4,>100
11829,shave,151,30617386,98.6755463763,_100,5,>100
11830,battleground,151,30617537,98.6760330281,_100,12,>100
11831,spiked,151,30617688,98.67651968,_100,6,>100
11832,greatness,150,30617838,98.677003109,_100,9,>100
11833,occupation,150,30617988,98.677486538,_100,10,>100
11834,crossroads,150,30618138,98.6779699669,_100,10,>100
11835,150,150,30618288,98.6784533959,_100,3,>100
11836,intake,150,30618438,98.6789368249,_100,6,>100
11837,stormed,150,30618588,98.6794202539,_100,7,>100
11838,addicted,150,30618738,98.6799036829,_100,8,>100
11839,preferably,150,30618888,98.6803871119,_100,10,>100
11840,constraints,150,30619038,98.6808705409,_100,11,>100
11841,freak,150,30619188,98.6813539699,_100,5,>100
11842,maloof,150,30619338,98.6818373989,_100,6,>100
11843,abu,150,30619488,98.6823208278,_100,3,>100
11844,reinforced,150,30619638,98.6828042568,_100,10,>100
11845,atkinson,150,30619788,98.6832876858,_100,8,>100
11846,rosie,150,30619938,98.6837711148,_100,5,>100
11847,impoverished,150,30620088,98.6842545438,_100,12,>100
11848,cipriano,150,30620238,98.6847379728,_100,8,>100
11849,fringe,150,30620388,98.6852214018,_100,6,>100
11850,fran,150,30620538,98.6857048308,_100,4,>100
11851,paraphernalia,150,30620688,98.6861882598,_100,13,>100
11852,benton,150,30620838,98.6866716887,_100,6,>100
11853,tighten,150,30620988,98.6871551177,_100,7,>100
11854,navigation,150,30621138,98.6876385467,_100,10,>100
11855,msu,150,30621288,98.6881219757,_100,3,>100
11856,fracture,150,30621438,98.6886054047,_100,8,>100
11857,applaud,150,30621588,98.6890888337,_100,7,>100
11858,thread,150,30621738,98.6895722627,_100,6,>100
11859,shortened,150,30621888,98.6900556917,_100,9,>100
11860,distractions,150,30622038,98.6905391207,_100,12,>100
11861,reeling,150,30622188,98.6910225496,_100,7,>100
11862,dusty,150,30622338,98.6915059786,_100,5,>100
11863,gluten,150,30622488,98.6919894076,_100,6,>100
11864,delgado,150,30622638,98.6924728366,_100,7,>100
11865,hamburger,150,30622788,98.6929562656,_100,9,>100
11866,caffeine,150,30622938,98.6934396946,_100,8,>100
11867,upshaw,150,30623088,98.6939231236,_100,6,>100
11868,berman,150,30623238,98.6944065526,_100,6,>100
11869,disturbed,150,30623388,98.6948899816,_100,9,>100
11870,cages,150,30623538,98.6953734105,_100,5,>100
11871,behave,150,30623688,98.6958568395,_100,6,>100
11872,ideology,150,30623838,98.6963402685,_100,8,>100
11873,stricter,150,30623988,98.6968236975,_100,8,>100
11874,flanagan,150,30624138,98.6973071265,_100,8,>100
11875,insufficient,150,30624288,98.6977905555,_100,12,>100
11876,luna,150,30624438,98.6982739845,_100,4,>100
11877,rooney,150,30624588,98.6987574135,_100,6,>100
11878,smash,150,30624738,98.6992408425,_100,5,>100
11879,tehran,150,30624888,98.6997242714,_100,6,>100
11880,tangible,150,30625038,98.7002077004,_100,8,>100
11881,choreography,150,30625188,98.7006911294,_100,12,>100
11882,kramer,150,30625338,98.7011745584,_100,6,>100
11883,bieber,150,30625488,98.7016579874,_100,6,>100
11884,wedges,150,30625638,98.7021414164,_100,6,>100
11885,reconstruction,150,30625788,98.7026248454,_100,14,>100
11886,kwon,150,30625938,98.7031082744,_100,4,>100
11887,vacated,150,30626088,98.7035917034,_100,7,>100
11888,anticipates,150,30626238,98.7040751323,_100,11,>100
11889,consisted,150,30626388,98.7045585613,_100,9,>100
11890,ravioli,150,30626538,98.7050419903,_100,7,>100
11891,sailors,150,30626688,98.7055254193,_100,7,>100
11892,jurisdictions,149,30626837,98.7060056254,_100,13,>100
11893,guardian,149,30626986,98.7064858316,_100,8,>100
11894,venerable,149,30627135,98.7069660377,_100,9,>100
11895,islamist,149,30627284,98.7074462438,_100,8,>100
11896,munich,149,30627433,98.70792645,_100,6,>100
11897,choked,149,30627582,98.7084066561,_100,6,>100
11898,fencing,149,30627731,98.7088868622,_100,7,>100
11899,aligned,149,30627880,98.7093670683,_100,7,>100
11900,motorist,149,30628029,98.7098472745,_100,8,>100
11901,entertained,149,30628178,98.7103274806,_100,11,>100
11902,rug,149,30628327,98.7108076867,_100,3,>100
11903,compounds,149,30628476,98.7112878929,_100,9,>100
11904,oshie,149,30628625,98.711768099,_100,5,>100
11905,feathers,149,30628774,98.7122483051,_100,8,>100
11906,gated,149,30628923,98.7127285112,_100,5,>100
11907,restrictive,149,30629072,98.7132087174,_100,11,>100
11908,downed,149,30629221,98.7136889235,_100,6,>100
11909,haith,149,30629370,98.7141691296,_100,5,>100
11910,fragrant,149,30629519,98.7146493358,_100,8,>100
11911,tofu,149,30629668,98.7151295419,_100,4,>100
11912,obligated,149,30629817,98.715609748,_100,9,>100
11913,physics,149,30629966,98.7160899541,_100,7,>100
11914,communicating,149,30630115,98.7165701603,_100,13,>100
11915,slope,149,30630264,98.7170503664,_100,5,>100
11916,shields,149,30630413,98.7175305725,_100,7,>100
11917,dwayne,149,30630562,98.7180107787,_100,6,>100
11918,rubble,149,30630711,98.7184909848,_100,6,>100
11919,meyers,149,30630860,98.7189711909,_100,6,>100
11920,jaw,149,30631009,98.719451397,_100,3,>100
11921,greetings,149,30631158,98.7199316032,_100,9,>100
11922,stocked,149,30631307,98.7204118093,_100,7,>100
11923,ozzie,149,30631456,98.7208920154,_100,5,>100
11924,barner,149,30631605,98.7213722216,_100,6,>100
11925,remark,149,30631754,98.7218524277,_100,6,>100
11926,scioscia,149,30631903,98.7223326338,_100,8,>100
11927,vouchers,149,30632052,98.72281284,_100,8,>100
11928,retrieve,149,30632201,98.7232930461,_100,8,>100
11929,ruiz,149,30632350,98.7237732522,_100,4,>100
11930,exited,149,30632499,98.7242534583,_100,6,>100
11931,unlocked,149,30632648,98.7247336645,_100,8,>100
11932,bodemeister,149,30632797,98.7252138706,_100,11,>100
11933,flats,149,30632946,98.7256940767,_100,5,>100
11934,steinberg,149,30633095,98.7261742829,_100,9,>100
11935,ticketmaster,149,30633244,98.726654489,_100,12,>100
11936,sloan,149,30633393,98.7271346951,_100,5,>100
11937,jars,149,30633542,98.7276149012,_100,4,>100
11938,diploma,149,30633691,98.7280951074,_100,7,>100
11939,tad,149,30633840,98.7285753135,_100,3,>100
11940,trans,149,30633989,98.7290555196,_100,5,>100
11941,auditions,149,30634138,98.7295357258,_100,9,>100
11942,frantic,149,30634287,98.7300159319,_100,7,>100
11943,scanners,149,30634436,98.730496138,_100,8,>100
11944,yosemite,149,30634585,98.7309763441,_100,8,>100
11945,rats,149,30634734,98.7314565503,_100,4,>100
11946,velocity,148,30634882,98.7319335335,_100,8,>100
11947,exceeds,148,30635030,98.7324105168,_100,7,>100
11948,beaver,148,30635178,98.7328875001,_100,6,>100
11949,municipality,148,30635326,98.7333644833,_100,12,>100
11950,taxable,148,30635474,98.7338414666,_100,7,>100
11951,astonishing,148,30635622,98.7343184499,_100,11,>100
11952,mcmahon,148,30635770,98.7347954332,_100,7,>100
11953,richest,148,30635918,98.7352724164,_100,7,>100
11954,limbs,148,30636066,98.7357493997,_100,5,>100
11955,hesitant,148,30636214,98.736226383,_100,8,>100
11956,devised,148,30636362,98.7367033662,_100,7,>100
11957,poignant,148,30636510,98.7371803495,_100,8,>100
11958,disruption,148,30636658,98.7376573328,_100,10,>100
11959,devote,148,30636806,98.738134316,_100,6,>100
11960,uconn,148,30636954,98.7386112993,_100,5,>100
11961,llp,148,30637102,98.7390882826,_100,3,>100
11962,autistic,148,30637250,98.7395652658,_100,8,>100
11963,hormones,148,30637398,98.7400422491,_100,8,>100
11964,spaghetti,148,30637546,98.7405192324,_100,9,>100
11965,shaun,148,30637694,98.7409962157,_100,5,>100
11966,lidstrom,148,30637842,98.7414731989,_100,8,>100
11967,musicals,148,30637990,98.7419501822,_100,8,>100
11968,dragging,148,30638138,98.7424271655,_100,8,>100
11969,juveniles,148,30638286,98.7429041487,_100,9,>100
11970,codey,148,30638434,98.743381132,_100,5,>100
11971,beastie,148,30638582,98.7438581153,_100,7,>100
11972,transplants,148,30638730,98.7443350985,_100,11,>100
11973,remodeled,148,30638878,98.7448120818,_100,9,>100
11974,sensors,148,30639026,98.7452890651,_100,7,>100
11975,wilde,148,30639174,98.7457660483,_100,5,>100
11976,beam,148,30639322,98.7462430316,_100,4,>100
11977,walkway,148,30639470,98.7467200149,_100,7,>100
11978,markers,148,30639618,98.7471969982,_100,7,>100
11979,depicted,148,30639766,98.7476739814,_100,8,>100
11980,scaled,148,30639914,98.7481509647,_100,6,>100
11981,relation,148,30640062,98.748627948,_100,8,>100
11982,standoff,148,30640210,98.7491049312,_100,8,>100
11983,firsthand,148,30640358,98.7495819145,_100,9,>100
11984,knack,148,30640506,98.7500588978,_100,5,>100
11985,dine,148,30640654,98.750535881,_100,4,>100
11986,balloon,148,30640802,98.7510128643,_100,7,>100
11987,faulk,148,30640950,98.7514898476,_100,5,>100
11988,kale,148,30641098,98.7519668308,_100,4,>100
11989,sober,148,30641246,98.7524438141,_100,5,>100
11990,motorola,148,30641394,98.7529207974,_100,8,>100
11991,oranges,148,30641542,98.7533977806,_100,7,>100
11992,blooms,148,30641690,98.7538747639,_100,6,>100
11993,bruised,148,30641838,98.7543517472,_100,7,>100
11994,boasted,148,30641986,98.7548287305,_100,7,>100
11995,quinnipiac,148,30642134,98.7553057137,_100,10,>100
11996,chatter,148,30642282,98.755782697,_100,7,>100
11997,whereas,147,30642429,98.7562564574,_100,7,>100
11998,grilling,147,30642576,98.7567302178,_100,8,>100
11999,suicidal,147,30642723,98.7572039782,_100,8,>100
12000,glaring,147,30642870,98.7576777386,_100,7,>100
12001,termination,147,30643017,98.758151499,_100,11,>100
12002,weary,147,30643164,98.7586252594,_100,5,>100
12003,diluted,147,30643311,98.7590990199,_100,7,>100
12004,warrensville,147,30643458,98.7595727803,_100,12,>100
12005,mango,147,30643605,98.7600465407,_100,5,>100
12006,waitress,147,30643752,98.7605203011,_100,8,>100
12007,louder,147,30643899,98.7609940615,_100,6,>100
12008,healthful,147,30644046,98.7614678219,_100,9,>100
12009,twenty,147,30644193,98.7619415823,_100,6,>100
12010,bittersweet,147,30644340,98.7624153427,_100,11,>100
12011,leisure,147,30644487,98.7628891031,_100,7,>100
12012,noisy,147,30644634,98.7633628635,_100,5,>100
12013,pillows,147,30644781,98.7638366239,_100,7,>100
12014,edmonton,147,30644928,98.7643103844,_100,8,>100
12015,bells,147,30645075,98.7647841448,_100,5,>100
12016,mortality,147,30645222,98.7652579052,_100,9,>100
12017,denny,147,30645369,98.7657316656,_100,5,>100
12018,progressed,147,30645516,98.766205426,_100,10,>100
12019,injected,147,30645663,98.7666791864,_100,8,>100
12020,relievers,147,30645810,98.7671529468,_100,9,>100
12021,bricks,147,30645957,98.7676267072,_100,6,>100
12022,cramped,147,30646104,98.7681004676,_100,7,>100
12023,bait,147,30646251,98.768574228,_100,4,>100
12024,reinforce,147,30646398,98.7690479884,_100,9,>100
12025,liu,147,30646545,98.7695217489,_100,3,>100
12026,spawned,147,30646692,98.7699955093,_100,7,>100
12027,wasting,147,30646839,98.7704692697,_100,7,>100
12028,rawlings,147,30646986,98.7709430301,_100,8,>100
12029,nails,147,30647133,98.7714167905,_100,5,>100
12030,brees,147,30647280,98.7718905509,_100,5,>100
12031,liaison,147,30647427,98.7723643113,_100,7,>100
12032,dell,146,30647573,98.7728348489,_100,4,>100
12033,pairings,146,30647719,98.7733053864,_100,8,>100
12034,auditors,146,30647865,98.773775924,_100,8,>100
12035,vargas,146,30648011,98.7742464615,_100,6,>100
12036,cpr,146,30648157,98.7747169991,_100,3,>100
12037,shutouts,146,30648303,98.7751875366,_100,8,>100
12038,dubious,146,30648449,98.7756580742,_100,7,>100
12039,aloha,146,30648595,98.7761286117,_100,5,>100
12040,susceptible,146,30648741,98.7765991493,_100,11,>100
12041,summoned,146,30648887,98.7770696868,_100,8,>100
12042,duration,146,30649033,98.7775402244,_100,8,>100
12043,replica,146,30649179,98.7780107619,_100,7,>100
12044,tackled,146,30649325,98.7784812995,_100,7,>100
12045,treasures,146,30649471,98.778951837,_100,9,>100
12046,roofs,146,30649617,98.7794223746,_100,5,>100
12047,generously,146,30649763,98.7798929121,_100,10,>100
12048,cinema,146,30649909,98.7803634496,_100,6,>100
12049,tumultuous,146,30650055,98.7808339872,_100,10,>100
12050,rye,146,30650201,98.7813045247,_100,3,>100
12051,salvage,146,30650347,98.7817750623,_100,7,>100
12052,claude,146,30650493,98.7822455998,_100,6,>100
12053,marrow,146,30650639,98.7827161374,_100,6,>100
12054,poached,146,30650785,98.7831866749,_100,7,>100
12055,grin,146,30650931,98.7836572125,_100,4,>100
12056,bamboo,146,30651077,98.78412775,_100,6,>100
12057,folding,146,30651223,98.7845982876,_100,7,>100
12058,quincy,146,30651369,98.7850688251,_100,6,>100
12059,alma,146,30651515,98.7855393627,_100,4,>100
12060,alberto,146,30651661,98.7860099002,_100,7,>100
12061,granger,146,30651807,98.7864804378,_100,7,>100
12062,volkswagen,146,30651953,98.7869509753,_100,10,>100
12063,ditch,146,30652099,98.7874215129,_100,5,>100
12064,baseline,146,30652245,98.7878920504,_100,8,>100
12065,contending,146,30652391,98.788362588,_100,10,>100
12066,refrain,146,30652537,98.7888331255,_100,7,>100
12067,exceeding,146,30652683,98.7893036631,_100,9,>100
12068,autographs,146,30652829,98.7897742006,_100,10,>100
12069,bayless,146,30652975,98.7902447382,_100,7,>100
12070,vicki,146,30653121,98.7907152757,_100,5,>100
12071,mediocre,146,30653267,98.7911858133,_100,8,>100
12072,cod,146,30653413,98.7916563508,_100,3,>100
12073,royalton,146,30653559,98.7921268884,_100,8,>100
12074,brake,146,30653705,98.7925974259,_100,5,>100
12075,angered,146,30653851,98.7930679635,_100,7,>100
12076,emmy,145,30653996,98.7935352782,_100,4,>100
12077,brisk,145,30654141,98.7940025929,_100,5,>100
12078,foley,145,30654286,98.7944699075,_100,5,>100
12079,counters,145,30654431,98.7949372222,_100,8,>100
12080,psychiatrist,145,30654576,98.7954045369,_100,12,>100
12081,harlem,145,30654721,98.7958718516,_100,6,>100
12082,paused,145,30654866,98.7963391663,_100,6,>100
12083,wardrobe,145,30655011,98.796806481,_100,8,>100
12084,depths,145,30655156,98.7972737957,_100,6,>100
12085,pencil,145,30655301,98.7977411104,_100,6,>100
12086,schuller,145,30655446,98.7982084251,_100,8,>100
12087,fixes,145,30655591,98.7986757397,_100,5,>100
12088,cor,145,30655736,98.7991430544,_100,3,>100
12089,convey,145,30655881,98.7996103691,_100,6,>100
12090,haunting,145,30656026,98.8000776838,_100,8,>100
12091,makeshift,145,30656171,98.8005449985,_100,9,>100
12092,thefts,145,30656316,98.8010123132,_100,6,>100
12093,revolutionary,145,30656461,98.8014796279,_100,13,>100
12094,franco,145,30656606,98.8019469426,_100,6,>100
12095,cheney,145,30656751,98.8024142573,_100,6,>100
12096,crumbs,145,30656896,98.802881572,_100,6,>100
12097,fascination,145,30657041,98.8033488866,_100,11,>100
12098,stints,145,30657186,98.8038162013,_100,6,>100
12099,santos,145,30657331,98.804283516,_100,6,>100
12100,cutbacks,145,30657476,98.8047508307,_100,8,>100
12101,fossil,145,30657621,98.8052181454,_100,6,>100
12102,supermarkets,145,30657766,98.8056854601,_100,12,>100
12103,curfew,145,30657911,98.8061527748,_100,6,>100
12104,serbia,145,30658056,98.8066200895,_100,6,>100
12105,troupe,145,30658201,98.8070874042,_100,6,>100
12106,televisions,145,30658346,98.8075547188,_100,11,>100
12107,exploit,145,30658491,98.8080220335,_100,7,>100
12108,urine,145,30658636,98.8084893482,_100,5,>100
12109,uneven,145,30658781,98.8089566629,_100,6,>100
12110,vastly,145,30658926,98.8094239776,_100,6,>100
12111,145,145,30659071,98.8098912923,_100,3,>100
12112,drowned,145,30659216,98.810358607,_100,7,>100
12113,spreads,145,30659361,98.8108259217,_100,7,>100
12114,sounders,145,30659506,98.8112932364,_100,8,>100
12115,diminish,145,30659651,98.811760551,_100,8,>100
12116,clifford,145,30659796,98.8122278657,_100,8,>100
12117,prevalent,145,30659941,98.8126951804,_100,9,>100
12118,arteries,145,30660086,98.8131624951,_100,8,>100
12119,hector,145,30660231,98.8136298098,_100,6,>100
12120,julius,145,30660376,98.8140971245,_100,6,>100
12121,bartlett,145,30660521,98.8145644392,_100,8,>100
12122,suggs,145,30660666,98.8150317539,_100,5,>100
12123,glaze,144,30660810,98.8154958457,_100,5,>100
12124,seizure,144,30660954,98.8159599375,_100,7,>100
12125,salted,144,30661098,98.8164240294,_100,6,>100
12126,lahood,144,30661242,98.8168881212,_100,6,>100
12127,pundits,144,30661386,98.817352213,_100,7,>100
12128,refreshments,144,30661530,98.8178163048,_100,12,>100
12129,undergone,144,30661674,98.8182803967,_100,9,>100
12130,gonzaga,144,30661818,98.8187444885,_100,7,>100
12131,fielded,144,30661962,98.8192085803,_100,7,>100
12132,bochy,144,30662106,98.8196726722,_100,5,>100
12133,converting,144,30662250,98.820136764,_100,10,>100
12134,hitler,144,30662394,98.8206008558,_100,6,>100
12135,motivate,144,30662538,98.8210649477,_100,8,>100
12136,escalating,144,30662682,98.8215290395,_100,10,>100
12137,pinpoint,144,30662826,98.8219931313,_100,8,>100
12138,thereafter,144,30662970,98.8224572231,_100,10,>100
12139,oceanside,144,30663114,98.822921315,_100,9,>100
12140,songwriter,144,30663258,98.8233854068,_100,10,>100
12141,amnesty,144,30663402,98.8238494986,_100,7,>100
12142,lackluster,144,30663546,98.8243135905,_100,10,>100
12143,tomlin,144,30663690,98.8247776823,_100,6,>100
12144,marvelous,144,30663834,98.8252417741,_100,9,>100
12145,mcbride,144,30663978,98.8257058659,_100,7,>100
12146,forwarded,144,30664122,98.8261699578,_100,9,>100
12147,currie,144,30664266,98.8266340496,_100,6,>100
12148,144,144,30664410,98.8270981414,_100,3,>100
12149,prowess,144,30664554,98.8275622333,_100,7,>100
12150,lodged,144,30664698,98.8280263251,_100,6,>100
12151,supplemental,144,30664842,98.8284904169,_100,12,>100
12152,kearny,144,30664986,98.8289545088,_100,6,>100
12153,kodak,144,30665130,98.8294186006,_100,5,>100
12154,cartel,144,30665274,98.8298826924,_100,6,>100
12155,sung,144,30665418,98.8303467842,_100,4,>100
12156,maureen,144,30665562,98.8308108761,_100,7,>100
12157,reimburse,144,30665706,98.8312749679,_100,9,>100
12158,intensely,144,30665850,98.8317390597,_100,9,>100
12159,regulator,144,30665994,98.8322031516,_100,9,>100
12160,iced,144,30666138,98.8326672434,_100,4,>100
12161,dynamics,143,30666281,98.8331281124,_100,8,>100
12162,distinguish,143,30666424,98.8335889813,_100,11,>100
12163,tenor,143,30666567,98.8340498503,_100,5,>100
12164,awarding,143,30666710,98.8345107193,_100,8,>100
12165,accordingly,143,30666853,98.8349715882,_100,11,>100
12166,stained,143,30666996,98.8354324572,_100,7,>100
12167,refinancing,143,30667139,98.8358933262,_100,11,>100
12168,uh,143,30667282,98.8363541951,_100,2,>100
12169,scratched,143,30667425,98.8368150641,_100,9,>100
12170,pins,143,30667568,98.8372759331,_100,4,>100
12171,forrest,143,30667711,98.8377368021,_100,7,>100
12172,elegance,143,30667854,98.838197671,_100,8,>100
12173,cured,143,30667997,98.83865854,_100,5,>100
12174,prominence,143,30668140,98.839119409,_100,10,>100
12175,irrigation,143,30668283,98.8395802779,_100,10,>100
12176,granting,143,30668426,98.8400411469,_100,8,>100
12177,ceremonial,143,30668569,98.8405020159,_100,10,>100
12178,dotted,143,30668712,98.8409628848,_100,6,>100
12179,143,143,30668855,98.8414237538,_100,3,>100
12180,extensively,143,30668998,98.8418846228,_100,11,>100
12181,malone,143,30669141,98.8423454917,_100,6,>100
12182,lectures,143,30669284,98.8428063607,_100,8,>100
12183,meg,143,30669427,98.8432672297,_100,3,>100
12184,mellon,143,30669570,98.8437280987,_100,6,>100
12185,kirby,143,30669713,98.8441889676,_100,5,>100
12186,gators,143,30669856,98.8446498366,_100,6,>100
12187,morale,143,30669999,98.8451107056,_100,6,>100
12188,botanical,143,30670142,98.8455715745,_100,9,>100
12189,mf,143,30670285,98.8460324435,_100,2,>100
12190,slumped,143,30670428,98.8464933125,_100,7,>100
12191,joplin,143,30670571,98.8469541814,_100,6,>100
12192,sophomores,143,30670714,98.8474150504,_100,10,>100
12193,departures,143,30670857,98.8478759194,_100,10,>100
12194,knives,143,30671000,98.8483367883,_100,6,>100
12195,burgeoning,143,30671143,98.8487976573,_100,10,>100
12196,millville,143,30671286,98.8492585263,_100,9,>100
12197,patron,143,30671429,98.8497193953,_100,6,>100
12198,pans,143,30671572,98.8501802642,_100,4,>100
12199,vladimir,143,30671715,98.8506411332,_100,8,>100
12200,cruising,143,30671858,98.8511020022,_100,8,>100
12201,poultry,143,30672001,98.8515628711,_100,7,>100
12202,consuming,143,30672144,98.8520237401,_100,9,>100
12203,recoup,143,30672287,98.8524846091,_100,6,>100
12204,hallways,142,30672429,98.8529422552,_100,8,>100
12205,disbelief,142,30672571,98.8533999013,_100,9,>100
12206,humidity,142,30672713,98.8538575474,_100,8,>100
12207,davies,142,30672855,98.8543151935,_100,6,>100
12208,rational,142,30672997,98.8547728396,_100,8,>100
12209,misled,142,30673139,98.8552304857,_100,6,>100
12210,twelve,142,30673281,98.8556881318,_100,6,>100
12211,laser,142,30673423,98.8561457779,_100,5,>100
12212,vin,142,30673565,98.8566034241,_100,3,>100
12213,mohamed,142,30673707,98.8570610702,_100,7,>100
12214,winterhawks,142,30673849,98.8575187163,_100,11,>100
12215,shrugged,142,30673991,98.8579763624,_100,8,>100
12216,autumn,142,30674133,98.8584340085,_100,6,>100
12217,strengthened,142,30674275,98.8588916546,_100,12,>100
12218,outage,142,30674417,98.8593493007,_100,6,>100
12219,transgender,142,30674559,98.8598069468,_100,11,>100
12220,downgrade,142,30674701,98.8602645929,_100,9,>100
12221,snakes,142,30674843,98.860722239,_100,6,>100
12222,fabrics,142,30674985,98.8611798852,_100,7,>100
12223,kidd,142,30675127,98.8616375313,_100,4,>100
12224,splitting,142,30675269,98.8620951774,_100,9,>100
12225,sipping,142,30675411,98.8625528235,_100,7,>100
12226,luckily,142,30675553,98.8630104696,_100,7,>100
12227,trey,142,30675695,98.8634681157,_100,4,>100
12228,entrepreneurial,142,30675837,98.8639257618,_100,15,>100
12229,uptick,142,30675979,98.8643834079,_100,6,>100
12230,disregard,142,30676121,98.864841054,_100,9,>100
12231,tar,142,30676263,98.8652987001,_100,3,>100
12232,vans,142,30676405,98.8657563462,_100,4,>100
12233,newborn,142,30676547,98.8662139924,_100,7,>100
12234,sitcom,142,30676689,98.8666716385,_100,6,>100
12235,sveum,142,30676831,98.8671292846,_100,5,>100
12236,radioactive,142,30676973,98.8675869307,_100,11,>100
12237,plummeted,142,30677115,98.8680445768,_100,9,>100
12238,continuous,142,30677257,98.8685022229,_100,10,>100
12239,softly,142,30677399,98.868959869,_100,6,>100
12240,bidder,142,30677541,98.8694175151,_100,6,>100
12241,vinyl,142,30677683,98.8698751612,_100,5,>100
12242,coated,142,30677825,98.8703328073,_100,6,>100
12243,watershed,142,30677967,98.8707904535,_100,9,>100
12244,stature,142,30678109,98.8712480996,_100,7,>100
12245,rupert,142,30678251,98.8717057457,_100,6,>100
12246,interchange,142,30678393,98.8721633918,_100,11,>100
12247,accreditation,142,30678535,98.8726210379,_100,13,>100
12248,subdivision,142,30678677,98.873078684,_100,11,>100
12249,balloons,142,30678819,98.8735363301,_100,8,>100
12250,suvs,142,30678961,98.8739939762,_100,4,>100
12251,introduces,142,30679103,98.8744516223,_100,10,>100
12252,longevity,142,30679245,98.8749092684,_100,9,>100
12253,foes,142,30679387,98.8753669145,_100,4,>100
12254,artery,142,30679529,98.8758245607,_100,6,>100
12255,imperative,142,30679671,98.8762822068,_100,10,>100
12256,tate,142,30679813,98.8767398529,_100,4,>100
12257,manningham,142,30679955,98.877197499,_100,10,>100
12258,novelist,142,30680097,98.8776551451,_100,8,>100
12259,camaraderie,142,30680239,98.8781127912,_100,11,>100
12260,timberwolves,142,30680381,98.8785704373,_100,12,>100
12261,gowns,142,30680523,98.8790280834,_100,5,>100
12262,tammy,142,30680665,98.8794857295,_100,5,>100
12263,greenwich,142,30680807,98.8799433756,_100,9,>100
12264,ricardo,142,30680949,98.8804010217,_100,7,>100
12265,falsely,142,30681091,98.8808586679,_100,7,>100
12266,virtue,142,30681233,98.881316314,_100,6,>100
12267,shortcomings,142,30681375,98.8817739601,_100,12,>100
12268,gatos,141,30681516,98.8822283833,_100,5,>100
12269,screams,141,30681657,98.8826828066,_100,7,>100
12270,alexandria,141,30681798,98.8831372298,_100,10,>100
12271,envisions,141,30681939,98.8835916531,_100,9,>100
12272,motorcycles,141,30682080,98.8840460763,_100,11,>100
12273,temper,141,30682221,98.8845004996,_100,6,>100
12274,selfish,141,30682362,98.8849549228,_100,7,>100
12275,141,141,30682503,98.8854093461,_100,3,>100
12276,doll,141,30682644,98.8858637693,_100,4,>100
12277,roar,141,30682785,98.8863181926,_100,4,>100
12278,aarp,141,30682926,98.8867726158,_100,4,>100
12279,honeymoon,141,30683067,98.8872270391,_100,9,>100
12280,detection,141,30683208,98.8876814623,_100,9,>100
12281,austria,141,30683349,98.8881358856,_100,7,>100
12282,articulate,141,30683490,98.8885903088,_100,10,>100
12283,flashed,141,30683631,98.8890447321,_100,7,>100
12284,stripes,141,30683772,98.8894991553,_100,7,>100
12285,masterpiece,141,30683913,98.8899535786,_100,11,>100
12286,stubborn,141,30684054,98.8904080018,_100,8,>100
12287,vest,141,30684195,98.8908624251,_100,4,>100
12288,hid,141,30684336,98.8913168483,_100,3,>100
12289,suicides,141,30684477,98.8917712716,_100,8,>100
12290,conley,141,30684618,98.8922256948,_100,6,>100
12291,ordinances,141,30684759,98.8926801181,_100,10,>100
12292,bald,141,30684900,98.8931345413,_100,4,>100
12293,isom,141,30685041,98.8935889646,_100,4,>100
12294,yauch,141,30685182,98.8940433878,_100,5,>100
12295,sesame,141,30685323,98.8944978111,_100,6,>100
12296,amusing,141,30685464,98.8949522343,_100,7,>100
12297,rotary,141,30685605,98.8954066576,_100,6,>100
12298,redemption,141,30685746,98.8958610808,_100,10,>100
12299,confidentiality,141,30685887,98.8963155041,_100,15,>100
12300,tortilla,141,30686028,98.8967699273,_100,8,>100
12301,reasoning,141,30686169,98.8972243506,_100,9,>100
12302,venezuela,141,30686310,98.8976787738,_100,9,>100
12303,archives,141,30686451,98.8981331971,_100,8,>100
12304,geographic,141,30686592,98.8985876203,_100,10,>100
12305,laced,141,30686733,98.8990420436,_100,5,>100
12306,raucous,141,30686874,98.8994964668,_100,7,>100
12307,nugent,141,30687015,98.8999508901,_100,6,>100
12308,awake,141,30687156,98.9004053133,_100,5,>100
12309,knowledgeable,141,30687297,98.9008597366,_100,13,>100
12310,saltzman,141,30687438,98.9013141598,_100,8,>100
12311,transforming,141,30687579,98.9017685831,_100,12,>100
12312,pge,141,30687720,98.9022230063,_100,3,>100
12313,improbable,141,30687861,98.9026774296,_100,10,>100
12314,dorado,141,30688002,98.9031318528,_100,6,>100
12315,gunshots,141,30688143,98.9035862761,_100,8,>100
12316,viewer,141,30688284,98.9040406993,_100,6,>100
12317,vacancies,141,30688425,98.9044951226,_100,9,>100
12318,fracturing,140,30688565,98.9049463229,_100,10,>100
12319,polo,140,30688705,98.9053975233,_100,4,>100
12320,shakes,140,30688845,98.9058487237,_100,6,>100
12321,barney,140,30688985,98.9062999241,_100,6,>100
12322,wishing,140,30689125,98.9067511245,_100,7,>100
12323,lauded,140,30689265,98.9072023249,_100,6,>100
12324,collateral,140,30689405,98.9076535253,_100,10,>100
12325,dial,140,30689545,98.9081047257,_100,4,>100
12326,carlo,140,30689685,98.9085559261,_100,5,>100
12327,ashamed,140,30689825,98.9090071265,_100,7,>100
12328,glamorous,140,30689965,98.9094583268,_100,9,>100
12329,phony,140,30690105,98.9099095272,_100,5,>100
12330,dewitt,140,30690245,98.9103607276,_100,6,>100
12331,clicking,140,30690385,98.910811928,_100,8,>100
12332,coordinating,140,30690525,98.9112631284,_100,12,>100
12333,qualifies,140,30690665,98.9117143288,_100,9,>100
12334,stereotypes,140,30690805,98.9121655292,_100,11,>100
12335,buds,140,30690945,98.9126167296,_100,4,>100
12336,flick,140,30691085,98.91306793,_100,5,>100
12337,imaging,140,30691225,98.9135191303,_100,7,>100
12338,lhp,140,30691365,98.9139703307,_100,3,>100
12339,defects,140,30691505,98.9144215311,_100,7,>100
12340,newsletter,140,30691645,98.9148727315,_100,10,>100
12341,dietary,140,30691785,98.9153239319,_100,7,>100
12342,bloggers,140,30691925,98.9157751323,_100,8,>100
12343,palette,140,30692065,98.9162263327,_100,7,>100
12344,countryside,140,30692205,98.9166775331,_100,11,>100
12345,buckets,140,30692345,98.9171287335,_100,7,>100
12346,legends,140,30692485,98.9175799339,_100,7,>100
12347,quarterfinal,140,30692625,98.9180311342,_100,12,>100
12348,metaphor,140,30692765,98.9184823346,_100,8,>100
12349,clich,140,30692905,98.918933535,_100,5,>100
12350,balked,140,30693045,98.9193847354,_100,6,>100
12351,euros,140,30693185,98.9198359358,_100,5,>100
12352,140,140,30693325,98.9202871362,_100,3,>100
12353,ponder,140,30693465,98.9207383366,_100,6,>100
12354,establishments,140,30693605,98.921189537,_100,14,>100
12355,dirk,140,30693745,98.9216407374,_100,4,>100
12356,diameter,140,30693885,98.9220919378,_100,8,>100
12357,mcnamee,140,30694025,98.9225431381,_100,7,>100
12358,strive,140,30694165,98.9229943385,_100,6,>100
12359,allocated,140,30694305,98.9234455389,_100,9,>100
12360,darryl,140,30694445,98.9238967393,_100,6,>100
12361,racks,140,30694585,98.9243479397,_100,5,>100
12362,billboards,140,30694725,98.9247991401,_100,10,>100
12363,odor,140,30694865,98.9252503405,_100,4,>100
12364,marquee,140,30695005,98.9257015409,_100,7,>100
12365,creators,140,30695145,98.9261527413,_100,8,>100
12366,upright,140,30695285,98.9266039416,_100,7,>100
12367,gunpoint,140,30695425,98.927055142,_100,8,>100
12368,mcdonnell,140,30695565,98.9275063424,_100,9,>100
12369,clemson,140,30695705,98.9279575428,_100,7,>100
12370,loomis,140,30695845,98.9284087432,_100,6,>100
12371,abide,139,30695984,98.9288567207,_100,5,>100
12372,cashman,139,30696123,98.9293046983,_100,7,>100
12373,tan,139,30696262,98.9297526758,_100,3,>100
12374,nut,139,30696401,98.9302006533,_100,3,>100
12375,mercedes,139,30696540,98.9306486309,_100,8,>100
12376,milpitas,139,30696679,98.9310966084,_100,8,>100
12377,chatting,139,30696818,98.9315445859,_100,8,>100
12378,collier,139,30696957,98.9319925634,_100,7,>100
12379,stirred,139,30697096,98.932440541,_100,7,>100
12380,forums,139,30697235,98.9328885185,_100,6,>100
12381,researched,139,30697374,98.933336496,_100,10,>100
12382,richer,139,30697513,98.9337844736,_100,6,>100
12383,distributor,139,30697652,98.9342324511,_100,11,>100
12384,regards,139,30697791,98.9346804286,_100,7,>100
12385,rampant,139,30697930,98.9351284062,_100,7,>100
12386,noticeable,139,30698069,98.9355763837,_100,10,>100
12387,jewsbury,139,30698208,98.9360243612,_100,8,>100
12388,academically,139,30698347,98.9364723387,_100,12,>100
12389,biologist,139,30698486,98.9369203163,_100,9,>100
12390,arresting,139,30698625,98.9373682938,_100,9,>100
12391,stakeholders,139,30698764,98.9378162713,_100,12,>100
12392,condominium,139,30698903,98.9382642489,_100,11,>100
12393,fueling,139,30699042,98.9387122264,_100,7,>100
12394,allowance,139,30699181,98.9391602039,_100,9,>100
12395,avila,139,30699320,98.9396081814,_100,5,>100
12396,visually,139,30699459,98.940056159,_100,8,>100
12397,rejecting,139,30699598,98.9405041365,_100,9,>100
12398,secaucus,139,30699737,98.940952114,_100,8,>100
12399,con,139,30699876,98.9414000916,_100,3,>100
12400,kerr,139,30700015,98.9418480691,_100,4,>100
12401,moreno,139,30700154,98.9422960466,_100,6,>100
12402,offended,139,30700293,98.9427440242,_100,8,>100
12403,nordstrom,139,30700432,98.9431920017,_100,9,>100
12404,visions,139,30700571,98.9436399792,_100,7,>100
12405,ideals,139,30700710,98.9440879567,_100,6,>100
12406,lyndhurst,139,30700849,98.9445359343,_100,9,>100
12407,rash,139,30700988,98.9449839118,_100,4,>100
12408,collaborate,139,30701127,98.9454318893,_100,11,>100
12409,windy,139,30701266,98.9458798669,_100,5,>100
12410,impending,139,30701405,98.9463278444,_100,9,>100
12411,lavender,139,30701544,98.9467758219,_100,8,>100
12412,keeper,139,30701683,98.9472237995,_100,6,>100
12413,whimsical,139,30701822,98.947671777,_100,9,>100
12414,heartfelt,139,30701961,98.9481197545,_100,9,>100
12415,fist,139,30702100,98.948567732,_100,4,>100
12416,insistence,139,30702239,98.9490157096,_100,10,>100
12417,grieving,138,30702377,98.9494604642,_100,8,>100
12418,nostalgia,138,30702515,98.9499052189,_100,9,>100
12419,pillow,138,30702653,98.9503499736,_100,6,>100
12420,glenelg,138,30702791,98.9507947283,_100,7,>100
12421,fitted,138,30702929,98.9512394829,_100,6,>100
12422,bianchi,138,30703067,98.9516842376,_100,7,>100
12423,executing,138,30703205,98.9521289923,_100,9,>100
12424,maj,138,30703343,98.9525737469,_100,3,>100
12425,patches,138,30703481,98.9530185016,_100,7,>100
12426,density,138,30703619,98.9534632563,_100,7,>100
12427,138,138,30703757,98.9539080109,_100,3,>100
12428,richness,138,30703895,98.9543527656,_100,8,>100
12429,flakes,138,30704033,98.9547975203,_100,6,>100
12430,nickel,138,30704171,98.9552422749,_100,6,>100
12431,alyssa,138,30704309,98.9556870296,_100,6,>100
12432,understated,138,30704447,98.9561317843,_100,11,>100
12433,cigar,138,30704585,98.956576539,_100,5,>100
12434,spit,138,30704723,98.9570212936,_100,4,>100
12435,dwindling,138,30704861,98.9574660483,_100,9,>100
12436,condolences,138,30704999,98.957910803,_100,11,>100
12437,attackers,138,30705137,98.9583555576,_100,9,>100
12438,bb,138,30705275,98.9588003123,_100,2,>100
12439,instructional,138,30705413,98.959245067,_100,13,>100
12440,terminate,138,30705551,98.9596898216,_100,9,>100
12441,slashing,138,30705689,98.9601345763,_100,8,>100
12442,tnt,138,30705827,98.960579331,_100,3,>100
12443,bowen,138,30705965,98.9610240857,_100,5,>100
12444,hips,138,30706103,98.9614688403,_100,4,>100
12445,zachary,138,30706241,98.961913595,_100,7,>100
12446,unfolded,138,30706379,98.9623583497,_100,8,>100
12447,dude,138,30706517,98.9628031043,_100,4,>100
12448,proxy,138,30706655,98.963247859,_100,5,>100
12449,cafes,138,30706793,98.9636926137,_100,5,>100
12450,gems,138,30706931,98.9641373683,_100,4,>100
12451,stresses,138,30707069,98.964582123,_100,8,>100
12452,coating,138,30707207,98.9650268777,_100,7,>100
12453,dysfunctional,138,30707345,98.9654716324,_100,13,>100
12454,djokovic,138,30707483,98.965916387,_100,8,>100
12455,dumplings,138,30707621,98.9663611417,_100,9,>100
12456,foolish,138,30707759,98.9668058964,_100,7,>100
12457,visionary,138,30707897,98.967250651,_100,9,>100
12458,antiques,138,30708035,98.9676954057,_100,8,>100
12459,hickson,138,30708173,98.9681401604,_100,7,>100
12460,risotto,138,30708311,98.968584915,_100,7,>100
12461,coupon,138,30708449,98.9690296697,_100,6,>100
12462,gadgets,137,30708586,98.9694712015,_100,7,>100
12463,canine,137,30708723,98.9699127333,_100,6,>100
12464,kipnis,137,30708860,98.9703542651,_100,6,>100
12465,daryl,137,30708997,98.970795797,_100,5,>100
12466,schlafly,137,30709134,98.9712373288,_100,8,>100
12467,rigid,137,30709271,98.9716788606,_100,5,>100
12468,banquet,137,30709408,98.9721203924,_100,7,>100
12469,throwback,137,30709545,98.9725619242,_100,9,>100
12470,groove,137,30709682,98.973003456,_100,6,>100
12471,killers,137,30709819,98.9734449878,_100,7,>100
12472,breathtaking,137,30709956,98.9738865196,_100,12,>100
12473,seniority,137,30710093,98.9743280514,_100,9,>100
12474,underwood,137,30710230,98.9747695832,_100,9,>100
12475,raspberry,137,30710367,98.9752111151,_100,9,>100
12476,expiration,137,30710504,98.9756526469,_100,10,>100
12477,tempted,137,30710641,98.9760941787,_100,7,>100
12478,slugger,137,30710778,98.9765357105,_100,7,>100
12479,guerra,137,30710915,98.9769772423,_100,6,>100
12480,despair,137,30711052,98.9774187741,_100,7,>100
12481,summed,137,30711189,98.9778603059,_100,6,>100
12482,takeout,137,30711326,98.9783018377,_100,7,>100
12483,essays,137,30711463,98.9787433695,_100,6,>100
12484,migration,137,30711600,98.9791849013,_100,9,>100
12485,determines,137,30711737,98.9796264331,_100,10,>100
12486,devotion,137,30711874,98.980067965,_100,8,>100
12487,trumpet,137,30712011,98.9805094968,_100,7,>100
12488,doubtful,137,30712148,98.9809510286,_100,8,>100
12489,fertility,137,30712285,98.9813925604,_100,9,>100
12490,intermission,137,30712422,98.9818340922,_100,12,>100
12491,drones,137,30712559,98.982275624,_100,6,>100
12492,lemonade,137,30712696,98.9827171558,_100,8,>100
12493,jumpers,137,30712833,98.9831586876,_100,7,>100
12494,situated,137,30712970,98.9836002194,_100,8,>100
12495,microwave,137,30713107,98.9840417512,_100,9,>100
12496,prototype,137,30713244,98.9844832831,_100,9,>100
12497,multimillion,137,30713381,98.9849248149,_100,12,>100
12498,monkey,137,30713518,98.9853663467,_100,6,>100
12499,naval,137,30713655,98.9858078785,_100,5,>100
12500,spills,137,30713792,98.9862494103,_100,6,>100
12501,cries,137,30713929,98.9866909421,_100,5,>100
12502,echo,137,30714066,98.9871324739,_100,4,>100
12503,137,137,30714203,98.9875740057,_100,3,>100
12504,scrapped,137,30714340,98.9880155375,_100,8,>100
12505,patriot,137,30714477,98.9884570693,_100,7,>100
12506,dorsey,137,30714614,98.9888986012,_100,6,>100
12507,expo,137,30714751,98.989340133,_100,4,>100
12508,tipping,137,30714888,98.9897816648,_100,7,>100
12509,poisoning,137,30715025,98.9902231966,_100,9,>100
12510,authenticity,137,30715162,98.9906647284,_100,12,>100
12511,comforting,137,30715299,98.9911062602,_100,10,>100
12512,tortillas,137,30715436,98.991547792,_100,9,>100
12513,gil,137,30715573,98.9919893238,_100,3,>100
12514,garages,137,30715710,98.9924308556,_100,7,>100
12515,statues,137,30715847,98.9928723874,_100,7,>100
12516,policymakers,136,30715983,98.9933106964,_100,12,>100
12517,alarms,136,30716119,98.9937490053,_100,6,>100
12518,diets,136,30716255,98.9941873143,_100,5,>100
12519,deflected,136,30716391,98.9946256232,_100,9,>100
12520,announcer,136,30716527,98.9950639322,_100,9,>100
12521,payoff,136,30716663,98.9955022411,_100,6,>100
12522,mixer,136,30716799,98.9959405501,_100,5,>100
12523,pageant,136,30716935,98.996378859,_100,7,>100
12524,prayed,136,30717071,98.996817168,_100,6,>100
12525,retention,136,30717207,98.9972554769,_100,9,>100
12526,kenya,136,30717343,98.9976937859,_100,5,>100
12527,costco,136,30717479,98.9981320948,_100,6,>100
12528,parsons,136,30717615,98.9985704038,_100,7,>100
12529,strikeout,136,30717751,98.9990087127,_100,9,>100
12530,wrongful,136,30717887,98.9994470217,_100,8,>100
12531,flagged,136,30718023,98.9998853306,_100,7,>100
12532,meditation,136,30718159,99.0003236396,_100,10,>100
12533,observing,136,30718295,99.0007619485,_100,9,>100
12534,wrestled,136,30718431,99.0012002575,_100,8,>100
12535,reclaim,136,30718567,99.0016385664,_100,7,>100
12536,rig,136,30718703,99.0020768754,_100,3,>100
12537,consolation,136,30718839,99.0025151843,_100,11,>100
12538,underscored,136,30718975,99.0029534933,_100,11,>100
12539,chin,136,30719111,99.0033918022,_100,4,>100
12540,counterfeit,136,30719247,99.0038301112,_100,11,>100
12541,earthquakes,136,30719383,99.0042684201,_100,11,>100
12542,replicate,136,30719519,99.0047067291,_100,9,>100
12543,farewell,136,30719655,99.005145038,_100,8,>100
12544,unleashed,136,30719791,99.005583347,_100,9,>100
12545,logs,136,30719927,99.0060216559,_100,4,>100
12546,hb,136,30720063,99.0064599649,_100,2,>100
12547,rv,136,30720199,99.0068982738,_100,2,>100
12548,seizures,136,30720335,99.0073365828,_100,8,>100
12549,echoes,136,30720471,99.0077748917,_100,6,>100
12550,kroger,136,30720607,99.0082132007,_100,6,>100
12551,objectives,136,30720743,99.0086515096,_100,10,>100
12552,beams,136,30720879,99.0090898186,_100,5,>100
12553,psu,136,30721015,99.0095281275,_100,3,>100
12554,daylight,136,30721151,99.0099664365,_100,8,>100
12555,sweater,136,30721287,99.0104047454,_100,7,>100
12556,merritt,136,30721423,99.0108430544,_100,7,>100
12557,plentiful,136,30721559,99.0112813633,_100,9,>100
12558,riesling,136,30721695,99.0117196723,_100,8,>100
12559,crocker,136,30721831,99.0121579812,_100,7,>100
12560,paced,136,30721967,99.0125962902,_100,5,>100
12561,gum,136,30722103,99.0130345991,_100,3,>100
12562,namely,136,30722239,99.0134729081,_100,6,>100
12563,alfaro,136,30722375,99.013911217,_100,6,>100
12564,creepy,136,30722511,99.014349526,_100,6,>100
12565,coastline,136,30722647,99.0147878349,_100,9,>100
12566,ouster,136,30722783,99.0152261439,_100,6,>100
12567,rebate,136,30722919,99.0156644528,_100,6,>100
12568,crammed,136,30723055,99.0161027618,_100,7,>100
12569,divincenzo,136,30723191,99.0165410707,_100,10,>100
12570,demographics,136,30723327,99.0169793797,_100,12,>100
12571,avalon,136,30723463,99.0174176886,_100,6,>100
12572,135,135,30723598,99.0178527747,_100,3,>100
12573,sibling,135,30723733,99.0182878608,_100,7,>100
12574,knowingly,135,30723868,99.0187229469,_100,9,>100
12575,parsippany,135,30724003,99.019158033,_100,10,>100
12576,casually,135,30724138,99.0195931191,_100,8,>100
12577,homelessness,135,30724273,99.0200282052,_100,12,>100
12578,pioneering,135,30724408,99.0204632913,_100,10,>100
12579,detectors,135,30724543,99.0208983774,_100,9,>100
12580,welcomes,135,30724678,99.0213334635,_100,8,>100
12581,brightest,135,30724813,99.0217685495,_100,9,>100
12582,sheen,135,30724948,99.0222036356,_100,5,>100
12583,restrained,135,30725083,99.0226387217,_100,10,>100
12584,bel,135,30725218,99.0230738078,_100,3,>100
12585,welch,135,30725353,99.0235088939,_100,5,>100
12586,camelback,135,30725488,99.02394398,_100,9,>100
12587,foliage,135,30725623,99.0243790661,_100,7,>100
12588,emphasizing,135,30725758,99.0248141522,_100,11,>100
12589,casualties,135,30725893,99.0252492383,_100,10,>100
12590,tandem,135,30726028,99.0256843244,_100,6,>100
12591,tourney,135,30726163,99.0261194104,_100,7,>100
12592,harness,135,30726298,99.0265544965,_100,7,>100
12593,dysfunction,135,30726433,99.0269895826,_100,11,>100
12594,unveil,135,30726568,99.0274246687,_100,6,>100
12595,endeavor,135,30726703,99.0278597548,_100,8,>100
12596,intensified,135,30726838,99.0282948409,_100,11,>100
12597,identifies,135,30726973,99.028729927,_100,10,>100
12598,kirkpatrick,135,30727108,99.0291650131,_100,11,>100
12599,disruptions,135,30727243,99.0296000992,_100,11,>100
12600,housewives,135,30727378,99.0300351853,_100,10,>100
12601,homegrown,135,30727513,99.0304702713,_100,9,>100
12602,tangled,135,30727648,99.0309053574,_100,7,>100
12603,correspondence,135,30727783,99.0313404435,_100,14,>100
12604,medford,135,30727918,99.0317755296,_100,7,>100
12605,props,135,30728053,99.0322106157,_100,5,>100
12606,wwe,135,30728188,99.0326457018,_100,3,>100
12607,tortured,135,30728323,99.0330807879,_100,8,>100
12608,evolve,135,30728458,99.033515874,_100,6,>100
12609,camry,135,30728593,99.0339509601,_100,5,>100
12610,telegraph,135,30728728,99.0343860462,_100,9,>100
12611,thief,135,30728863,99.0348211322,_100,5,>100
12612,destiny,135,30728998,99.0352562183,_100,7,>100
12613,fanned,135,30729133,99.0356913044,_100,6,>100
12614,fianc,135,30729268,99.0361263905,_100,5,>100
12615,hybrids,135,30729403,99.0365614766,_100,7,>100
12616,tinyurl,135,30729538,99.0369965627,_100,7,>100
12617,icons,135,30729673,99.0374316488,_100,5,>100
12618,modify,135,30729808,99.0378667349,_100,6,>100
12619,notebook,135,30729943,99.038301821,_100,8,>100
12620,stare,135,30730078,99.0387369071,_100,5,>100
12621,rosenthal,135,30730213,99.0391719931,_100,9,>100
12622,insulin,135,30730348,99.0396070792,_100,7,>100
12623,sided,135,30730483,99.0400421653,_100,5,>100
12624,chu,135,30730618,99.0404772514,_100,3,>100
12625,forgiveness,135,30730753,99.0409123375,_100,11,>100
12626,facilitate,135,30730888,99.0413474236,_100,10,>100
12627,greenwood,135,30731023,99.0417825097,_100,9,>100
12628,scotch,135,30731158,99.0422175958,_100,6,>100
12629,salute,135,30731293,99.0426526819,_100,6,>100
12630,distributing,135,30731428,99.043087768,_100,12,>100
12631,clyde,135,30731563,99.043522854,_100,5,>100
12632,fearful,135,30731698,99.0439579401,_100,7,>100
12633,backlog,135,30731833,99.0443930262,_100,7,>100
12634,descended,135,30731968,99.0448281123,_100,9,>100
12635,rocking,135,30732103,99.0452631984,_100,7,>100
12636,inspirational,135,30732238,99.0456982845,_100,13,>100
12637,holloway,135,30732373,99.0461333706,_100,8,>100
12638,cornelius,135,30732508,99.0465684567,_100,9,>100
12639,blocker,135,30732643,99.0470035428,_100,7,>100
12640,denounced,135,30732778,99.0474386289,_100,9,>100
12641,depart,135,30732913,99.0478737149,_100,6,>100
12642,collaborated,135,30733048,99.048308801,_100,12,>100
12643,activism,134,30733182,99.0487406643,_100,8,>100
12644,arctic,134,30733316,99.0491725275,_100,6,>100
12645,therapies,134,30733450,99.0496043907,_100,9,>100
12646,translation,134,30733584,99.050036254,_100,11,>100
12647,upton,134,30733718,99.0504681172,_100,5,>100
12648,dante,134,30733852,99.0508999804,_100,5,>100
12649,communal,134,30733986,99.0513318436,_100,8,>100
12650,reopening,134,30734120,99.0517637069,_100,9,>100
12651,greenberg,134,30734254,99.0521955701,_100,9,>100
12652,traps,134,30734388,99.0526274333,_100,5,>100
12653,dewey,134,30734522,99.0530592966,_100,5,>100
12654,preferences,134,30734656,99.0534911598,_100,11,>100
12655,faulty,134,30734790,99.053923023,_100,6,>100
12656,statistic,134,30734924,99.0543548863,_100,9,>100
12657,fuller,134,30735058,99.0547867495,_100,6,>100
12658,rainfall,134,30735192,99.0552186127,_100,8,>100
12659,aloud,134,30735326,99.0556504759,_100,5,>100
12660,convened,134,30735460,99.0560823392,_100,8,>100
12661,jovi,134,30735594,99.0565142024,_100,4,>100
12662,fdic,134,30735728,99.0569460656,_100,4,>100
12663,disturbance,134,30735862,99.0573779289,_100,11,>100
12664,kroenke,134,30735996,99.0578097921,_100,7,>100
12665,obstruction,134,30736130,99.0582416553,_100,11,>100
12666,panetta,134,30736264,99.0586735186,_100,7,>100
12667,seaside,134,30736398,99.0591053818,_100,7,>100
12668,proficient,134,30736532,99.059537245,_100,10,>100
12669,climbs,134,30736666,99.0599691082,_100,6,>100
12670,encampment,134,30736800,99.0604009715,_100,10,>100
12671,receipt,134,30736934,99.0608328347,_100,7,>100
12672,deduction,134,30737068,99.0612646979,_100,9,>100
12673,runaway,134,30737202,99.0616965612,_100,7,>100
12674,marital,134,30737336,99.0621284244,_100,7,>100
12675,te,134,30737470,99.0625602876,_100,2,>100
12676,overland,134,30737604,99.0629921509,_100,8,>100
12677,privatization,134,30737738,99.0634240141,_100,13,>100
12678,feud,134,30737872,99.0638558773,_100,4,>100
12679,subscription,134,30738006,99.0642877405,_100,12,>100
12680,tier,134,30738140,99.0647196038,_100,4,>100
12681,earners,134,30738274,99.065151467,_100,7,>100
12682,culprit,134,30738408,99.0655833302,_100,7,>100
12683,haynes,134,30738542,99.0660151935,_100,6,>100
12684,ordeal,134,30738676,99.0664470567,_100,6,>100
12685,refrigerated,134,30738810,99.0668789199,_100,12,>100
12686,tainted,134,30738944,99.0673107832,_100,7,>100
12687,bosnian,134,30739078,99.0677426464,_100,7,>100
12688,nostalgic,134,30739212,99.0681745096,_100,9,>100
12689,swath,134,30739346,99.0686063728,_100,5,>100
12690,landscapes,134,30739480,99.0690382361,_100,10,>100
12691,adverse,134,30739614,99.0694700993,_100,7,>100
12692,brien,134,30739748,99.0699019625,_100,5,>100
12693,farley,134,30739882,99.0703338258,_100,6,>100
12694,defazio,134,30740016,99.070765689,_100,7,>100
12695,mckinley,134,30740150,99.0711975522,_100,8,>100
12696,linkedin,134,30740284,99.0716294155,_100,8,>100
12697,explanations,134,30740418,99.0720612787,_100,12,>100
12698,naive,134,30740552,99.0724931419,_100,5,>100
12699,elyria,134,30740686,99.0729250051,_100,6,>100
12700,toms,134,30740820,99.0733568684,_100,4,>100
12701,ashes,134,30740954,99.0737887316,_100,5,>100
12702,dea,134,30741088,99.0742205948,_100,3,>100
12703,depicting,133,30741221,99.0746492352,_100,9,>100
12704,cellar,133,30741354,99.0750778756,_100,6,>100
12705,ukraine,133,30741487,99.0755065159,_100,7,>100
12706,leveled,133,30741620,99.0759351563,_100,7,>100
12707,elevate,133,30741753,99.0763637967,_100,7,>100
12708,chants,133,30741886,99.0767924371,_100,6,>100
12709,compliment,133,30742019,99.0772210774,_100,10,>100
12710,environments,133,30742152,99.0776497178,_100,12,>100
12711,unhealthy,133,30742285,99.0780783582,_100,9,>100
12712,cauliflower,133,30742418,99.0785069985,_100,11,>100
12713,delinquent,133,30742551,99.0789356389,_100,10,>100
12714,pristine,133,30742684,99.0793642793,_100,8,>100
12715,relates,133,30742817,99.0797929196,_100,7,>100
12716,roadways,133,30742950,99.08022156,_100,8,>100
12717,bursts,133,30743083,99.0806502004,_100,6,>100
12718,affton,133,30743216,99.0810788408,_100,6,>100
12719,heroic,133,30743349,99.0815074811,_100,6,>100
12720,ny,133,30743482,99.0819361215,_100,2,>100
12721,joaquin,133,30743615,99.0823647619,_100,7,>100
12722,stooges,133,30743748,99.0827934022,_100,7,>100
12723,canucks,133,30743881,99.0832220426,_100,7,>100
12724,trailers,133,30744014,99.083650683,_100,8,>100
12725,progression,133,30744147,99.0840793233,_100,11,>100
12726,thigh,133,30744280,99.0845079637,_100,5,>100
12727,contemplating,133,30744413,99.0849366041,_100,13,>100
12728,dissolved,133,30744546,99.0853652445,_100,9,>100
12729,rave,133,30744679,99.0857938848,_100,4,>100
12730,milton,133,30744812,99.0862225252,_100,6,>100
12731,133,133,30744945,99.0866511656,_100,3,>100
12732,explosions,133,30745078,99.0870798059,_100,10,>100
12733,melanie,133,30745211,99.0875084463,_100,7,>100
12734,cardiovascular,133,30745344,99.0879370867,_100,14,>100
12735,bartenders,133,30745477,99.0883657271,_100,10,>100
12736,sailed,133,30745610,99.0887943674,_100,6,>100
12737,alonso,133,30745743,99.0892230078,_100,6,>100
12738,cesar,133,30745876,99.0896516482,_100,5,>100
12739,urges,133,30746009,99.0900802885,_100,5,>100
12740,boiled,133,30746142,99.0905089289,_100,6,>100
12741,abound,133,30746275,99.0909375693,_100,6,>100
12742,plotting,133,30746408,99.0913662096,_100,8,>100
12743,persian,133,30746541,99.09179485,_100,7,>100
12744,safeguards,133,30746674,99.0922234904,_100,10,>100
12745,willoughby,133,30746807,99.0926521308,_100,10,>100
12746,aerospace,133,30746940,99.0930807711,_100,9,>100
12747,oddly,133,30747073,99.0935094115,_100,5,>100
12748,robots,133,30747206,99.0939380519,_100,6,>100
12749,historians,133,30747339,99.0943666922,_100,10,>100
12750,fm,133,30747472,99.0947953326,_100,2,>100
12751,bathtub,133,30747605,99.095223973,_100,7,>100
12752,wei,133,30747738,99.0956526133,_100,3,>100
12753,consisting,133,30747871,99.0960812537,_100,10,>100
12754,charred,133,30748004,99.0965098941,_100,7,>100
12755,webber,133,30748137,99.0969385345,_100,6,>100
12756,hogan,133,30748270,99.0973671748,_100,5,>100
12757,cereal,133,30748403,99.0977958152,_100,6,>100
12758,avoids,133,30748536,99.0982244556,_100,6,>100
12759,carnahan,133,30748669,99.0986530959,_100,8,>100
12760,horseback,133,30748802,99.0990817363,_100,9,>100
12761,respiratory,133,30748935,99.0995103767,_100,11,>100
12762,cycles,133,30749068,99.099939017,_100,6,>100
12763,escort,133,30749201,99.1003676574,_100,6,>100
12764,marino,133,30749334,99.1007962978,_100,6,>100
12765,heartbreaking,133,30749467,99.1012249382,_100,13,>100
12766,deng,133,30749600,99.1016535785,_100,4,>100
12767,jungle,132,30749732,99.102078996,_100,6,>100
12768,monarch,132,30749864,99.1025044135,_100,7,>100
12769,ailments,132,30749996,99.1029298311,_100,8,>100
12770,waterways,132,30750128,99.1033552486,_100,9,>100
12771,subsidize,132,30750260,99.1037806661,_100,9,>100
12772,salinas,132,30750392,99.1042060836,_100,7,>100
12773,jeanne,132,30750524,99.1046315011,_100,6,>100
12774,osborne,132,30750656,99.1050569186,_100,7,>100
12775,132,132,30750788,99.1054823361,_100,3,>100
12776,reilly,132,30750920,99.1059077536,_100,6,>100
12777,repairing,132,30751052,99.1063331711,_100,9,>100
12778,mattingly,132,30751184,99.1067585886,_100,9,>100
12779,russians,132,30751316,99.1071840062,_100,8,>100
12780,realtor,132,30751448,99.1076094237,_100,7,>100
12781,plaintiff,132,30751580,99.1080348412,_100,9,>100
12782,mexicans,132,30751712,99.1084602587,_100,8,>100
12783,hinds,132,30751844,99.1088856762,_100,5,>100
12784,adjoining,132,30751976,99.1093110937,_100,9,>100
12785,thu,132,30752108,99.1097365112,_100,3,>100
12786,empathy,132,30752240,99.1101619287,_100,7,>100
12787,raul,132,30752372,99.1105873462,_100,4,>100
12788,paddle,132,30752504,99.1110127637,_100,6,>100
12789,outsider,132,30752636,99.1114381813,_100,8,>100
12790,haas,132,30752768,99.1118635988,_100,4,>100
12791,coronado,132,30752900,99.1122890163,_100,8,>100
12792,halibut,132,30753032,99.1127144338,_100,7,>100
12793,respectable,132,30753164,99.1131398513,_100,11,>100
12794,airfare,132,30753296,99.1135652688,_100,7,>100
12795,clashed,132,30753428,99.1139906863,_100,7,>100
12796,marcy,132,30753560,99.1144161038,_100,5,>100
12797,campers,132,30753692,99.1148415213,_100,7,>100
12798,chilling,132,30753824,99.1152669389,_100,8,>100
12799,loretta,132,30753956,99.1156923564,_100,7,>100
12800,hartford,132,30754088,99.1161177739,_100,8,>100
12801,marrying,132,30754220,99.1165431914,_100,8,>100
12802,restroom,132,30754352,99.1169686089,_100,8,>100
12803,portraits,132,30754484,99.1173940264,_100,9,>100
12804,endangerment,132,30754616,99.1178194439,_100,12,>100
12805,isaiah,132,30754748,99.1182448614,_100,6,>100
12806,hal,132,30754880,99.1186702789,_100,3,>100
12807,metrodome,132,30755012,99.1190956964,_100,9,>100
12808,windshield,132,30755144,99.119521114,_100,10,>100
12809,bomber,132,30755276,99.1199465315,_100,6,>100
12810,larceny,132,30755408,99.120371949,_100,7,>100
12811,mousse,132,30755540,99.1207973665,_100,6,>100
12812,regimen,132,30755672,99.121222784,_100,7,>100
12813,softer,132,30755804,99.1216482015,_100,6,>100
12814,meteorologist,131,30755935,99.1220703962,_100,13,>100
12815,winless,131,30756066,99.1224925908,_100,7,>100
12816,jacques,131,30756197,99.1229147855,_100,7,>100
12817,inauguration,131,30756328,99.1233369801,_100,12,>100
12818,decker,131,30756459,99.1237591748,_100,6,>100
12819,slab,131,30756590,99.1241813694,_100,4,>100
12820,goddard,131,30756721,99.1246035641,_100,7,>100
12821,sentiments,131,30756852,99.1250257587,_100,10,>100
12822,unreasonable,131,30756983,99.1254479534,_100,12,>100
12823,nagbe,131,30757114,99.125870148,_100,5,>100
12824,portuguese,131,30757245,99.1262923427,_100,10,>100
12825,mubarak,131,30757376,99.1267145373,_100,7,>100
12826,birdies,131,30757507,99.127136732,_100,7,>100
12827,accepts,131,30757638,99.1275589266,_100,7,>100
12828,stringent,131,30757769,99.1279811213,_100,9,>100
12829,exaggerated,131,30757900,99.1284033159,_100,11,>100
12830,cecil,131,30758031,99.1288255106,_100,5,>100
12831,groundwater,131,30758162,99.1292477052,_100,11,>100
12832,bleachers,131,30758293,99.1296698999,_100,9,>100
12833,ho,131,30758424,99.1300920945,_100,2,>100
12834,outsourcing,131,30758555,99.1305142892,_100,11,>100
12835,sirens,131,30758686,99.1309364838,_100,6,>100
12836,playhouse,131,30758817,99.1313586785,_100,9,>100
12837,discarded,131,30758948,99.1317808731,_100,9,>100
12838,pears,131,30759079,99.1322030678,_100,5,>100
12839,repayment,131,30759210,99.1326252624,_100,9,>100
12840,pals,131,30759341,99.1330474571,_100,4,>100
12841,reimbursed,131,30759472,99.1334696517,_100,10,>100
12842,operative,131,30759603,99.1338918464,_100,9,>100
12843,singular,131,30759734,99.134314041,_100,8,>100
12844,horns,131,30759865,99.1347362357,_100,5,>100
12845,cvc,131,30759996,99.1351584303,_100,3,>100
12846,separates,131,30760127,99.135580625,_100,9,>100
12847,muller,131,30760258,99.1360028196,_100,6,>100
12848,riverview,131,30760389,99.1364250143,_100,9,>100
12849,fishman,131,30760520,99.1368472089,_100,7,>100
12850,slavery,131,30760651,99.1372694036,_100,7,>100
12851,swirling,131,30760782,99.1376915982,_100,8,>100
12852,dispensary,131,30760913,99.1381137929,_100,10,>100
12853,valve,131,30761044,99.1385359875,_100,5,>100
12854,feasible,131,30761175,99.1389581822,_100,8,>100
12855,bogey,131,30761306,99.1393803768,_100,5,>100
12856,131,131,30761437,99.1398025715,_100,3,>100
12857,edu,131,30761568,99.1402247661,_100,3,>100
12858,vienna,131,30761699,99.1406469608,_100,6,>100
12859,java,131,30761830,99.1410691554,_100,4,>100
12860,pers,131,30761961,99.1414913501,_100,4,>100
12861,christianity,131,30762092,99.1419135447,_100,12,>100
12862,bloc,131,30762223,99.1423357394,_100,4,>100
12863,frustrations,131,30762354,99.142757934,_100,12,>100
12864,inventories,131,30762485,99.1431801287,_100,11,>100
12865,clevelanders,131,30762616,99.1436023233,_100,12,>100
12866,freeholders,131,30762747,99.144024518,_100,11,>100
12867,emeritus,131,30762878,99.1444467126,_100,8,>100
12868,bashara,131,30763009,99.1448689073,_100,7,>100
12869,cue,131,30763140,99.1452911019,_100,3,>100
12870,gilmore,131,30763271,99.1457132966,_100,7,>100
12871,lo,131,30763402,99.1461354912,_100,2,>100
12872,dodd,131,30763533,99.1465576859,_100,4,>100
12873,odom,131,30763664,99.1469798805,_100,4,>100
12874,mesh,131,30763795,99.1474020752,_100,4,>100
12875,bowers,131,30763926,99.1478242698,_100,6,>100
12876,poked,131,30764057,99.1482464645,_100,5,>100
12877,brandt,130,30764187,99.1486654363,_100,6,>100
12878,breakup,130,30764317,99.1490844081,_100,7,>100
12879,dei,130,30764447,99.1495033798,_100,3,>100
12880,raft,130,30764577,99.1499223516,_100,4,>100
12881,clinch,130,30764707,99.1503413234,_100,6,>100
12882,ribbons,130,30764837,99.1507602952,_100,7,>100
12883,fenway,130,30764967,99.151179267,_100,6,>100
12884,stepfather,130,30765097,99.1515982388,_100,10,>100
12885,signage,130,30765227,99.1520172106,_100,7,>100
12886,bruises,130,30765357,99.1524361824,_100,7,>100
12887,peacefully,130,30765487,99.1528551542,_100,10,>100
12888,bridget,130,30765617,99.153274126,_100,7,>100
12889,madoff,130,30765747,99.1536930977,_100,6,>100
12890,vitamins,130,30765877,99.1541120695,_100,8,>100
12891,ah,130,30766007,99.1545310413,_100,2,>100
12892,injections,130,30766137,99.1549500131,_100,10,>100
12893,rhythms,130,30766267,99.1553689849,_100,7,>100
12894,trivia,130,30766397,99.1557879567,_100,6,>100
12895,hasay,130,30766527,99.1562069285,_100,5,>100
12896,cheyenne,130,30766657,99.1566259003,_100,8,>100
12897,mon,130,30766787,99.1570448721,_100,3,>100
12898,guts,130,30766917,99.1574638439,_100,4,>100
12899,confirms,130,30767047,99.1578828157,_100,8,>100
12900,fulfilling,130,30767177,99.1583017874,_100,10,>100
12901,130,130,30767307,99.1587207592,_100,3,>100
12902,snooki,130,30767437,99.159139731,_100,6,>100
12903,instinct,130,30767567,99.1595587028,_100,8,>100
12904,chsaa,130,30767697,99.1599776746,_100,5,>100
12905,lawns,130,30767827,99.1603966464,_100,5,>100
12906,balsamic,130,30767957,99.1608156182,_100,8,>100
12907,snapshot,130,30768087,99.16123459,_100,8,>100
12908,mohamud,130,30768217,99.1616535618,_100,7,>100
12909,conner,130,30768347,99.1620725336,_100,6,>100
12910,kayla,130,30768477,99.1624915053,_100,5,>100
12911,blackhawks,130,30768607,99.1629104771,_100,10,>100
12912,dots,130,30768737,99.1633294489,_100,4,>100
12913,caesar,130,30768867,99.1637484207,_100,6,>100
12914,caregiver,130,30768997,99.1641673925,_100,9,>100
12915,sneakers,130,30769127,99.1645863643,_100,8,>100
12916,icing,130,30769257,99.1650053361,_100,5,>100
12917,computing,130,30769387,99.1654243079,_100,9,>100
12918,chorizo,130,30769517,99.1658432797,_100,7,>100
12919,sail,130,30769647,99.1662622515,_100,4,>100
12920,stumbling,130,30769777,99.1666812233,_100,9,>100
12921,inception,130,30769907,99.167100195,_100,9,>100
12922,insult,130,30770037,99.1675191668,_100,6,>100
12923,recovers,130,30770167,99.1679381386,_100,8,>100
12924,generator,130,30770297,99.1683571104,_100,9,>100
12925,triad,130,30770427,99.1687760822,_100,5,>100
12926,ruby,130,30770557,99.169195054,_100,4,>100
12927,buccaneers,130,30770687,99.1696140258,_100,10,>100
12928,insured,130,30770817,99.1700329976,_100,7,>100
12929,promoter,130,30770947,99.1704519694,_100,8,>100
12930,hampered,130,30771077,99.1708709412,_100,8,>100
12931,reap,130,30771207,99.1712899129,_100,4,>100
12932,fujita,130,30771337,99.1717088847,_100,6,>100
12933,energized,130,30771467,99.1721278565,_100,9,>100
12934,commons,130,30771597,99.1725468283,_100,7,>100
12935,robotic,129,30771726,99.1729625772,_100,7,>100
12936,hugged,129,30771855,99.1733783262,_100,6,>100
12937,incorporating,129,30771984,99.1737940751,_100,13,>100
12938,authorize,129,30772113,99.174209824,_100,9,>100
12939,cascade,129,30772242,99.174625573,_100,7,>100
12940,muny,129,30772371,99.1750413219,_100,4,>100
12941,upgrading,129,30772500,99.1754570708,_100,9,>100
12942,sluh,129,30772629,99.1758728198,_100,4,>100
12943,approvals,129,30772758,99.1762885687,_100,9,>100
12944,integration,129,30772887,99.1767043176,_100,11,>100
12945,mayonnaise,129,30773016,99.1771200666,_100,10,>100
12946,implies,129,30773145,99.1775358155,_100,7,>100
12947,mia,129,30773274,99.1779515644,_100,3,>100
12948,hotline,129,30773403,99.1783673133,_100,7,>100
12949,nicknamed,129,30773532,99.1787830623,_100,9,>100
12950,stevie,129,30773661,99.1791988112,_100,6,>100
12951,amboy,129,30773790,99.1796145601,_100,5,>100
12952,dominique,129,30773919,99.1800303091,_100,9,>100
12953,jonas,129,30774048,99.180446058,_100,5,>100
12954,subdued,129,30774177,99.1808618069,_100,7,>100
12955,fading,129,30774306,99.1812775559,_100,6,>100
12956,hatred,129,30774435,99.1816933048,_100,6,>100
12957,textbooks,129,30774564,99.1821090537,_100,9,>100
12958,gabbert,129,30774693,99.1825248026,_100,7,>100
12959,intrigue,129,30774822,99.1829405516,_100,8,>100
12960,spence,129,30774951,99.1833563005,_100,6,>100
12961,skid,129,30775080,99.1837720494,_100,4,>100
12962,soften,129,30775209,99.1841877984,_100,6,>100
12963,artichoke,129,30775338,99.1846035473,_100,9,>100
12964,lapses,129,30775467,99.1850192962,_100,6,>100
12965,barge,129,30775596,99.1854350452,_100,5,>100
12966,adamant,129,30775725,99.1858507941,_100,7,>100
12967,rightly,129,30775854,99.186266543,_100,7,>100
12968,lineups,129,30775983,99.186682292,_100,7,>100
12969,tumors,129,30776112,99.1870980409,_100,6,>100
12970,ellison,129,30776241,99.1875137898,_100,7,>100
12971,petroleum,129,30776370,99.1879295387,_100,9,>100
12972,concluding,129,30776499,99.1883452877,_100,10,>100
12973,midsize,129,30776628,99.1887610366,_100,7,>100
12974,129,129,30776757,99.1891767855,_100,3,>100
12975,brecksville,129,30776886,99.1895925345,_100,11,>100
12976,anti,129,30777015,99.1900082834,_100,4,>100
12977,aliens,129,30777144,99.1904240323,_100,6,>100
12978,furlough,129,30777273,99.1908397813,_100,8,>100
12979,nuanced,129,30777402,99.1912555302,_100,7,>100
12980,layout,129,30777531,99.1916712791,_100,6,>100
12981,headquartered,129,30777660,99.192087028,_100,13,>100
12982,botched,129,30777789,99.192502777,_100,7,>100
12983,sacked,129,30777918,99.1929185259,_100,6,>100
12984,espresso,129,30778047,99.1933342748,_100,8,>100
12985,unite,129,30778176,99.1937500238,_100,5,>100
12986,airplanes,129,30778305,99.1941657727,_100,9,>100
12987,dent,128,30778433,99.1945782988,_100,4,>100
12988,mildly,128,30778561,99.1949908248,_100,6,>100
12989,crest,128,30778689,99.1954033509,_100,5,>100
12990,mariano,128,30778817,99.195815877,_100,7,>100
12991,coke,128,30778945,99.1962284031,_100,4,>100
12992,vows,128,30779073,99.1966409291,_100,4,>100
12993,stacey,128,30779201,99.1970534552,_100,6,>100
12994,handcuffed,128,30779329,99.1974659813,_100,10,>100
12995,pesto,128,30779457,99.1978785073,_100,5,>100
12996,generators,128,30779585,99.1982910334,_100,10,>100
12997,lent,128,30779713,99.1987035595,_100,4,>100
12998,liqueur,128,30779841,99.1991160855,_100,7,>100
12999,cider,128,30779969,99.1995286116,_100,5,>100
13000,exhibited,128,30780097,99.1999411377,_100,9,>100
13001,mckay,128,30780225,99.2003536638,_100,5,>100
13002,128,128,30780353,99.2007661898,_100,3,>100
13003,holden,128,30780481,99.2011787159,_100,6,>100
13004,clerks,128,30780609,99.201591242,_100,6,>100
13005,mischief,128,30780737,99.202003768,_100,8,>100
13006,chongqing,128,30780865,99.2024162941,_100,9,>100
13007,faint,128,30780993,99.2028288202,_100,5,>100
13008,emphasizes,128,30781121,99.2032413463,_100,10,>100
13009,closings,128,30781249,99.2036538723,_100,8,>100
13010,reside,128,30781377,99.2040663984,_100,6,>100
13011,williamson,128,30781505,99.2044789245,_100,10,>100
13012,ensures,128,30781633,99.2048914505,_100,7,>100
13013,visas,128,30781761,99.2053039766,_100,5,>100
13014,brisket,128,30781889,99.2057165027,_100,7,>100
13015,slayings,128,30782017,99.2061290287,_100,8,>100
13016,ware,128,30782145,99.2065415548,_100,4,>100
13017,derived,128,30782273,99.2069540809,_100,7,>100
13018,revisit,128,30782401,99.207366607,_100,7,>100
13019,sweeter,128,30782529,99.207779133,_100,7,>100
13020,marquez,128,30782657,99.2081916591,_100,7,>100
13021,sensational,128,30782785,99.2086041852,_100,11,>100
13022,tailored,128,30782913,99.2090167112,_100,8,>100
13023,competes,128,30783041,99.2094292373,_100,8,>100
13024,fiercely,128,30783169,99.2098417634,_100,8,>100
13025,vocalist,128,30783297,99.2102542894,_100,8,>100
13026,loaf,128,30783425,99.2106668155,_100,4,>100
13027,sub,128,30783553,99.2110793416,_100,3,>100
13028,amsterdam,128,30783681,99.2114918677,_100,9,>100
13029,doughnuts,128,30783809,99.2119043937,_100,9,>100
13030,bristol,128,30783937,99.2123169198,_100,7,>100
13031,middleburg,128,30784065,99.2127294459,_100,10,>100
13032,winemaker,128,30784193,99.2131419719,_100,9,>100
13033,nix,128,30784321,99.213554498,_100,3,>100
13034,muscular,128,30784449,99.2139670241,_100,8,>100
13035,locke,128,30784577,99.2143795502,_100,5,>100
13036,blames,128,30784705,99.2147920762,_100,6,>100
13037,bureaucratic,128,30784833,99.2152046023,_100,12,>100
13038,reacting,128,30784961,99.2156171284,_100,8,>100
13039,fruity,128,30785089,99.2160296544,_100,6,>100
13040,rogue,128,30785217,99.2164421805,_100,5,>100
13041,mates,128,30785345,99.2168547066,_100,5,>100
13042,rebellion,128,30785473,99.2172672326,_100,9,>100
13043,believer,127,30785600,99.2176765359,_100,8,>100
13044,coachella,127,30785727,99.2180858391,_100,9,>100
13045,mercantile,127,30785854,99.2184951423,_100,10,>100
13046,pegged,127,30785981,99.2189044455,_100,6,>100
13047,coca,127,30786108,99.2193137487,_100,4,>100
13048,wynn,127,30786235,99.2197230519,_100,4,>100
13049,deadlines,127,30786362,99.2201323551,_100,9,>100
13050,citation,127,30786489,99.2205416583,_100,8,>100
13051,orchard,127,30786616,99.2209509615,_100,7,>100
13052,biscuits,127,30786743,99.2213602648,_100,8,>100
13053,flacco,127,30786870,99.221769568,_100,6,>100
13054,desires,127,30786997,99.2221788712,_100,7,>100
13055,beads,127,30787124,99.2225881744,_100,5,>100
13056,sensibility,127,30787251,99.2229974776,_100,11,>100
13057,emergence,127,30787378,99.2234067808,_100,9,>100
13058,stacks,127,30787505,99.223816084,_100,6,>100
13059,sophia,127,30787632,99.2242253872,_100,6,>100
13060,judd,127,30787759,99.2246346904,_100,4,>100
13061,circulated,127,30787886,99.2250439936,_100,10,>100
13062,toby,127,30788013,99.2254532969,_100,4,>100
13063,branded,127,30788140,99.2258626001,_100,7,>100
13064,popovich,127,30788267,99.2262719033,_100,8,>100
13065,yorkers,127,30788394,99.2266812065,_100,7,>100
13066,callahan,127,30788521,99.2270905097,_100,8,>100
13067,mogul,127,30788648,99.2274998129,_100,5,>100
13068,brushed,127,30788775,99.2279091161,_100,7,>100
13069,disclosures,127,30788902,99.2283184193,_100,11,>100
13070,elwell,127,30789029,99.2287277225,_100,6,>100
13071,interpret,127,30789156,99.2291370258,_100,9,>100
13072,foe,127,30789283,99.229546329,_100,3,>100
13073,shepard,127,30789410,99.2299556322,_100,7,>100
13074,rigs,127,30789537,99.2303649354,_100,4,>100
13075,resistant,127,30789664,99.2307742386,_100,9,>100
13076,ma,127,30789791,99.2311835418,_100,2,>100
13077,prevailed,127,30789918,99.231592845,_100,9,>100
13078,imagery,127,30790045,99.2320021482,_100,7,>100
13079,hawk,127,30790172,99.2324114514,_100,4,>100
13080,punctuated,127,30790299,99.2328207547,_100,10,>100
13081,slack,127,30790426,99.2332300579,_100,5,>100
13082,127,127,30790553,99.2336393611,_100,3,>100
13083,violinist,127,30790680,99.2340486643,_100,9,>100
13084,considerations,127,30790807,99.2344579675,_100,14,>100
13085,rouge,127,30790934,99.2348672707,_100,5,>100
13086,exclude,127,30791061,99.2352765739,_100,7,>100
13087,jarrett,127,30791188,99.2356858771,_100,7,>100
13088,rationale,127,30791315,99.2360951803,_100,9,>100
13089,daddy,127,30791442,99.2365044835,_100,5,>100
13090,steelhead,127,30791569,99.2369137868,_100,9,>100
13091,griner,127,30791696,99.23732309,_100,6,>100
13092,updating,127,30791823,99.2377323932,_100,8,>100
13093,bananas,127,30791950,99.2381416964,_100,7,>100
13094,tutoring,127,30792077,99.2385509996,_100,8,>100
13095,vega,127,30792204,99.2389603028,_100,4,>100
13096,gillespie,127,30792331,99.239369606,_100,9,>100
13097,awe,127,30792458,99.2397789092,_100,3,>100
13098,applicant,127,30792585,99.2401882124,_100,9,>100
13099,underscore,127,30792712,99.2405975157,_100,10,>100
13100,mascot,127,30792839,99.2410068189,_100,6,>100
13101,budding,127,30792966,99.2414161221,_100,7,>100
13102,embattled,127,30793093,99.2418254253,_100,9,>100
13103,madigan,127,30793220,99.2422347285,_100,7,>100
13104,fordham,127,30793347,99.2426440317,_100,7,>100
13105,refugee,126,30793473,99.2430501121,_100,7,>100
13106,aromas,126,30793599,99.2434561924,_100,6,>100
13107,separating,126,30793725,99.2438622728,_100,10,>100
13108,solyndra,126,30793851,99.2442683531,_100,8,>100
13109,lesbians,126,30793977,99.2446744335,_100,8,>100
13110,familiarity,126,30794103,99.2450805138,_100,11,>100
13111,selig,126,30794229,99.2454865942,_100,5,>100
13112,bunny,126,30794355,99.2458926745,_100,5,>100
13113,adorable,126,30794481,99.2462987549,_100,8,>100
13114,mired,126,30794607,99.2467048352,_100,5,>100
13115,sword,126,30794733,99.2471109156,_100,5,>100
13116,embedded,126,30794859,99.2475169959,_100,8,>100
13117,schmitt,126,30794985,99.2479230763,_100,7,>100
13118,bubbly,126,30795111,99.2483291566,_100,6,>100
13119,gossip,126,30795237,99.248735237,_100,6,>100
13120,crumbled,126,30795363,99.2491413173,_100,8,>100
13121,fingerprints,126,30795489,99.2495473977,_100,12,>100
13122,mechanic,126,30795615,99.249953478,_100,8,>100
13123,comprised,126,30795741,99.2503595584,_100,9,>100
13124,atm,126,30795867,99.2507656387,_100,3,>100
13125,disparity,126,30795993,99.2511717191,_100,9,>100
13126,126,126,30796119,99.2515777994,_100,3,>100
13127,instability,126,30796245,99.2519838798,_100,11,>100
13128,middleton,126,30796371,99.2523899601,_100,9,>100
13129,liable,126,30796497,99.2527960405,_100,6,>100
13130,prominently,126,30796623,99.2532021208,_100,11,>100
13131,retains,126,30796749,99.2536082012,_100,7,>100
13132,deeds,126,30796875,99.2540142815,_100,5,>100
13133,lombardi,126,30797001,99.2544203619,_100,8,>100
13134,positioning,126,30797127,99.2548264422,_100,11,>100
13135,vulnerability,126,30797253,99.2552325226,_100,13,>100
13136,alpha,126,30797379,99.2556386029,_100,5,>100
13137,blitz,126,30797505,99.2560446833,_100,5,>100
13138,cables,126,30797631,99.2564507636,_100,6,>100
13139,evoke,126,30797757,99.256856844,_100,5,>100
13140,discard,126,30797883,99.2572629243,_100,7,>100
13141,consolidate,126,30798009,99.2576690047,_100,11,>100
13142,airwaves,126,30798135,99.258075085,_100,8,>100
13143,gods,126,30798261,99.2584811654,_100,4,>100
13144,outages,126,30798387,99.2588872457,_100,7,>100
13145,deleted,126,30798513,99.2592933261,_100,7,>100
13146,shines,126,30798639,99.2596994064,_100,6,>100
13147,pleasantly,126,30798765,99.2601054868,_100,10,>100
13148,sophistication,126,30798891,99.2605115671,_100,14,>100
13149,raleigh,126,30799017,99.2609176475,_100,7,>100
13150,begging,126,30799143,99.2613237278,_100,7,>100
13151,invention,126,30799269,99.2617298082,_100,9,>100
13152,spagnuolo,126,30799395,99.2621358885,_100,9,>100
13153,drinkers,126,30799521,99.2625419689,_100,8,>100
13154,duane,126,30799647,99.2629480492,_100,5,>100
13155,soaking,126,30799773,99.2633541296,_100,7,>100
13156,flint,126,30799899,99.2637602099,_100,5,>100
13157,seamless,126,30800025,99.2641662903,_100,8,>100
13158,ag,126,30800151,99.2645723706,_100,2,>100
13159,menacing,126,30800277,99.264978451,_100,8,>100
13160,fulfilled,126,30800403,99.2653845313,_100,9,>100
13161,walkers,126,30800529,99.2657906117,_100,7,>100
13162,gretchen,126,30800655,99.266196692,_100,8,>100
13163,doc,126,30800781,99.2666027724,_100,3,>100
13164,gradual,126,30800907,99.2670088527,_100,7,>100
13165,consortium,126,30801033,99.2674149331,_100,10,>100
13166,personalized,126,30801159,99.2678210134,_100,12,>100
13167,erected,126,30801285,99.2682270938,_100,7,>100
13168,allergy,126,30801411,99.2686331741,_100,7,>100
13169,gestures,126,30801537,99.2690392545,_100,8,>100
13170,leukemia,126,30801663,99.2694453348,_100,8,>100
13171,scant,126,30801789,99.2698514152,_100,5,>100
13172,discretionary,126,30801915,99.2702574956,_100,13,>100
13173,sunk,126,30802041,99.2706635759,_100,4,>100
13174,voucher,126,30802167,99.2710696563,_100,7,>100
13175,admiration,126,30802293,99.2714757366,_100,10,>100
13176,thirty,125,30802418,99.2718785941,_100,6,>100
13177,unfunded,125,30802543,99.2722814516,_100,8,>100
13178,europeans,125,30802668,99.2726843091,_100,9,>100
13179,involuntary,125,30802793,99.2730871666,_100,11,>100
13180,clergy,125,30802918,99.2734900241,_100,6,>100
13181,attire,125,30803043,99.2738928815,_100,6,>100
13182,terminals,125,30803168,99.274295739,_100,9,>100
13183,suitcase,125,30803293,99.2746985965,_100,8,>100
13184,sinha,125,30803418,99.275101454,_100,5,>100
13185,temptation,125,30803543,99.2755043115,_100,10,>100
13186,saddle,125,30803668,99.275907169,_100,6,>100
13187,cheapest,125,30803793,99.2763100265,_100,8,>100
13188,jelly,125,30803918,99.276712884,_100,5,>100
13189,badgers,125,30804043,99.2771157415,_100,7,>100
13190,125,125,30804168,99.277518599,_100,3,>100
13191,macaroni,125,30804293,99.2779214565,_100,8,>100
13192,whales,125,30804418,99.2783243139,_100,6,>100
13193,outpouring,125,30804543,99.2787271714,_100,10,>100
13194,felonies,125,30804668,99.2791300289,_100,8,>100
13195,filet,125,30804793,99.2795328864,_100,5,>100
13196,rumored,125,30804918,99.2799357439,_100,7,>100
13197,enticing,125,30805043,99.2803386014,_100,8,>100
13198,sequences,125,30805168,99.2807414589,_100,9,>100
13199,mays,125,30805293,99.2811443164,_100,4,>100
13200,rails,125,30805418,99.2815471739,_100,5,>100
13201,brews,125,30805543,99.2819500314,_100,5,>100
13202,shallots,125,30805668,99.2823528889,_100,8,>100
13203,eliminates,125,30805793,99.2827557463,_100,10,>100
13204,horsepower,125,30805918,99.2831586038,_100,10,>100
13205,gladstone,125,30806043,99.2835614613,_100,9,>100
13206,revision,125,30806168,99.2839643188,_100,8,>100
13207,formations,125,30806293,99.2843671763,_100,10,>100
13208,chess,125,30806418,99.2847700338,_100,5,>100
13209,kulongoski,125,30806543,99.2851728913,_100,10,>100
13210,extraordinarily,125,30806668,99.2855757488,_100,15,>100
13211,postpone,125,30806793,99.2859786063,_100,8,>100
13212,opting,125,30806918,99.2863814638,_100,6,>100
13213,undertaking,125,30807043,99.2867843213,_100,11,>100
13214,kia,125,30807168,99.2871871787,_100,3,>100
13215,aig,125,30807293,99.2875900362,_100,3,>100
13216,bury,125,30807418,99.2879928937,_100,4,>100
13217,commemorate,125,30807543,99.2883957512,_100,11,>100
13218,descalso,125,30807668,99.2887986087,_100,8,>100
13219,ignatius,125,30807793,99.2892014662,_100,8,>100
13220,exits,125,30807918,99.2896043237,_100,5,>100
13221,punishing,125,30808043,99.2900071812,_100,9,>100
13222,achilles,125,30808168,99.2904100387,_100,8,>100
13223,comedies,125,30808293,99.2908128962,_100,8,>100
13224,yearlong,125,30808418,99.2912157536,_100,8,>100
13225,presided,125,30808543,99.2916186111,_100,8,>100
13226,lindenwood,125,30808668,99.2920214686,_100,10,>100
13227,experimenting,124,30808792,99.2924211033,_100,13,>100
13228,fats,124,30808916,99.2928207379,_100,4,>100
13229,grendell,124,30809040,99.2932203725,_100,8,>100
13230,orbit,124,30809164,99.2936200072,_100,5,>100
13231,judgments,124,30809288,99.2940196418,_100,9,>100
13232,randomly,124,30809412,99.2944192764,_100,8,>100
13233,jolla,124,30809536,99.294818911,_100,5,>100
13234,negligence,124,30809660,99.2952185457,_100,10,>100
13235,batches,124,30809784,99.2956181803,_100,7,>100
13236,walleye,124,30809908,99.2960178149,_100,7,>100
13237,porsche,124,30810032,99.2964174496,_100,7,>100
13238,textbook,124,30810156,99.2968170842,_100,8,>100
13239,jong,124,30810280,99.2972167188,_100,4,>100
13240,wax,124,30810404,99.2976163535,_100,3,>100
13241,breivik,124,30810528,99.2980159881,_100,7,>100
13242,sketches,124,30810652,99.2984156227,_100,8,>100
13243,chong,124,30810776,99.2988152574,_100,5,>100
13244,graders,124,30810900,99.299214892,_100,7,>100
13245,wetlands,124,30811024,99.2996145266,_100,8,>100
13246,truffle,124,30811148,99.3000141612,_100,7,>100
13247,saul,124,30811272,99.3004137959,_100,4,>100
13248,monumental,124,30811396,99.3008134305,_100,10,>100
13249,agave,124,30811520,99.3012130651,_100,5,>100
13250,brace,124,30811644,99.3016126998,_100,5,>100
13251,escaping,124,30811768,99.3020123344,_100,8,>100
13252,124,124,30811892,99.302411969,_100,3,>100
13253,swat,124,30812016,99.3028116037,_100,4,>100
13254,ufc,124,30812140,99.3032112383,_100,3,>100
13255,patel,124,30812264,99.3036108729,_100,5,>100
13256,console,124,30812388,99.3040105076,_100,7,>100
13257,phrases,124,30812512,99.3044101422,_100,7,>100
13258,governmental,124,30812636,99.3048097768,_100,12,>100
13259,commonwealth,124,30812760,99.3052094114,_100,12,>100
13260,statutory,124,30812884,99.3056090461,_100,9,>100
13261,copeland,124,30813008,99.3060086807,_100,8,>100
13262,trajectory,124,30813132,99.3064083153,_100,10,>100
13263,editions,124,30813256,99.30680795,_100,8,>100
13264,lamented,124,30813380,99.3072075846,_100,8,>100
13265,ros,124,30813504,99.3076072192,_100,3,>100
13266,sprinkled,124,30813628,99.3080068539,_100,9,>100
13267,safest,124,30813752,99.3084064885,_100,6,>100
13268,platte,124,30813876,99.3088061231,_100,6,>100
13269,ethanol,124,30814000,99.3092057578,_100,7,>100
13270,cartels,124,30814124,99.3096053924,_100,7,>100
13271,valves,124,30814248,99.310005027,_100,6,>100
13272,missiles,124,30814372,99.3104046616,_100,8,>100
13273,prudent,124,30814496,99.3108042963,_100,7,>100
13274,deed,124,30814620,99.3112039309,_100,4,>100
13275,tastings,124,30814744,99.3116035655,_100,8,>100
13276,icahn,124,30814868,99.3120032002,_100,5,>100
13277,nighttime,124,30814992,99.3124028348,_100,9,>100
13278,conceal,124,30815116,99.3128024694,_100,7,>100
13279,illicit,124,30815240,99.3132021041,_100,7,>100
13280,altar,124,30815364,99.3136017387,_100,5,>100
13281,fluffy,123,30815487,99.3139981505,_100,6,>100
13282,crump,123,30815610,99.3143945622,_100,5,>100
13283,trilogy,123,30815733,99.314790974,_100,7,>100
13284,decroce,123,30815856,99.3151873858,_100,7,>100
13285,tacoma,123,30815979,99.3155837975,_100,6,>100
13286,reminders,123,30816102,99.3159802093,_100,9,>100
13287,mainland,123,30816225,99.3163766211,_100,8,>100
13288,landowners,123,30816348,99.3167730329,_100,10,>100
13289,flagstaff,123,30816471,99.3171694446,_100,9,>100
13290,puppet,123,30816594,99.3175658564,_100,6,>100
13291,triangle,123,30816717,99.3179622682,_100,8,>100
13292,downgraded,123,30816840,99.3183586799,_100,10,>100
13293,plc,123,30816963,99.3187550917,_100,3,>100
13294,neatly,123,30817086,99.3191515035,_100,6,>100
13295,staffed,123,30817209,99.3195479153,_100,7,>100
13296,hops,123,30817332,99.319944327,_100,4,>100
13297,header,123,30817455,99.3203407388,_100,6,>100
13298,leigh,123,30817578,99.3207371506,_100,5,>100
13299,revolving,123,30817701,99.3211335623,_100,9,>100
13300,turbine,123,30817824,99.3215299741,_100,7,>100
13301,operatives,123,30817947,99.3219263859,_100,10,>100
13302,insulation,123,30818070,99.3223227977,_100,10,>100
13303,mustangs,123,30818193,99.3227192094,_100,8,>100
13304,tremont,123,30818316,99.3231156212,_100,7,>100
13305,volcano,123,30818439,99.323512033,_100,7,>100
13306,libyan,123,30818562,99.3239084447,_100,6,>100
13307,blending,123,30818685,99.3243048565,_100,8,>100
13308,skirts,123,30818808,99.3247012683,_100,6,>100
13309,champs,123,30818931,99.3250976801,_100,6,>100
13310,inadvertently,123,30819054,99.3254940918,_100,13,>100
13311,gridlock,123,30819177,99.3258905036,_100,8,>100
13312,derailed,123,30819300,99.3262869154,_100,8,>100
13313,gaze,123,30819423,99.3266833271,_100,4,>100
13314,bicycles,123,30819546,99.3270797389,_100,8,>100
13315,morse,123,30819669,99.3274761507,_100,5,>100
13316,divine,123,30819792,99.3278725624,_100,6,>100
13317,kara,123,30819915,99.3282689742,_100,4,>100
13318,theo,123,30820038,99.328665386,_100,4,>100
13319,rumor,123,30820161,99.3290617978,_100,5,>100
13320,propelled,123,30820284,99.3294582095,_100,9,>100
13321,harvested,123,30820407,99.3298546213,_100,9,>100
13322,foothill,123,30820530,99.3302510331,_100,8,>100
13323,onboard,123,30820653,99.3306474448,_100,7,>100
13324,hugs,123,30820776,99.3310438566,_100,4,>100
13325,slippery,123,30820899,99.3314402684,_100,8,>100
13326,summitt,123,30821022,99.3318366802,_100,7,>100
13327,ryder,123,30821145,99.3322330919,_100,5,>100
13328,noodle,123,30821268,99.3326295037,_100,6,>100
13329,attach,123,30821391,99.3330259155,_100,6,>100
13330,pollen,123,30821514,99.3334223272,_100,6,>100
13331,viability,123,30821637,99.333818739,_100,9,>100
13332,murky,123,30821760,99.3342151508,_100,5,>100
13333,rinne,123,30821883,99.3346115626,_100,5,>100
13334,janice,123,30822006,99.3350079743,_100,6,>100
13335,soar,123,30822129,99.3354043861,_100,4,>100
13336,afforded,123,30822252,99.3358007979,_100,8,>100
13337,123,123,30822375,99.3361972096,_100,3,>100
13338,crackers,123,30822498,99.3365936214,_100,8,>100
13339,epstein,123,30822621,99.3369900332,_100,7,>100
13340,preakness,123,30822744,99.3373864449,_100,9,>100
13341,likened,123,30822867,99.3377828567,_100,7,>100
13342,fuentes,123,30822990,99.3381792685,_100,7,>100
13343,desks,123,30823113,99.3385756803,_100,5,>100
13344,cyber,123,30823236,99.338972092,_100,5,>100
13345,replacements,123,30823359,99.3393685038,_100,12,>100
13346,ashland,123,30823482,99.3397649156,_100,7,>100
13347,ptsd,123,30823605,99.3401613273,_100,4,>100
13348,parise,123,30823728,99.3405577391,_100,6,>100
13349,striker,123,30823851,99.3409541509,_100,7,>100
13350,betsy,123,30823974,99.3413505627,_100,5,>100
13351,reiff,123,30824097,99.3417469744,_100,5,>100
13352,elena,123,30824220,99.3421433862,_100,5,>100
13353,marinade,123,30824343,99.342539798,_100,8,>100
13354,stagnant,123,30824466,99.3429362097,_100,8,>100
13355,spielberg,122,30824588,99.3433293987,_100,9,>100
13356,murdering,122,30824710,99.3437225876,_100,9,>100
13357,beneficiary,122,30824832,99.3441157765,_100,11,>100
13358,layered,122,30824954,99.3445089654,_100,7,>100
13359,veterinary,122,30825076,99.3449021543,_100,10,>100
13360,leopold,122,30825198,99.3452953432,_100,7,>100
13361,bingo,122,30825320,99.3456885321,_100,5,>100
13362,heel,122,30825442,99.346081721,_100,4,>100
13363,verified,122,30825564,99.3464749099,_100,8,>100
13364,colbert,122,30825686,99.3468680988,_100,7,>100
13365,idle,122,30825808,99.3472612878,_100,4,>100
13366,utilize,122,30825930,99.3476544767,_100,7,>100
13367,needles,122,30826052,99.3480476656,_100,7,>100
13368,ol,122,30826174,99.3484408545,_100,2,>100
13369,depicts,122,30826296,99.3488340434,_100,7,>100
13370,eastwood,122,30826418,99.3492272323,_100,8,>100
13371,blasts,122,30826540,99.3496204212,_100,6,>100
13372,inexperienced,122,30826662,99.3500136101,_100,13,>100
13373,cvs,122,30826784,99.350406799,_100,3,>100
13374,interactions,122,30826906,99.350799988,_100,12,>100
13375,prohibiting,122,30827028,99.3511931769,_100,11,>100
13376,quickness,122,30827150,99.3515863658,_100,9,>100
13377,mcclendon,122,30827272,99.3519795547,_100,9,>100
13378,phyllis,122,30827394,99.3523727436,_100,7,>100
13379,prose,122,30827516,99.3527659325,_100,5,>100
13380,guzman,122,30827638,99.3531591214,_100,6,>100
13381,mindful,122,30827760,99.3535523103,_100,7,>100
13382,awfully,122,30827882,99.3539454992,_100,7,>100
13383,bless,122,30828004,99.3543386882,_100,5,>100
13384,warranted,122,30828126,99.3547318771,_100,9,>100
13385,blossoms,122,30828248,99.355125066,_100,8,>100
13386,handcuffs,122,30828370,99.3555182549,_100,9,>100
13387,notoriously,122,30828492,99.3559114438,_100,11,>100
13388,longmont,122,30828614,99.3563046327,_100,8,>100
13389,humorous,122,30828736,99.3566978216,_100,8,>100
13390,ominous,122,30828858,99.3570910105,_100,7,>100
13391,verse,122,30828980,99.3574841994,_100,5,>100
13392,hustle,122,30829102,99.3578773884,_100,6,>100
13393,partnering,122,30829224,99.3582705773,_100,10,>100
13394,scans,122,30829346,99.3586637662,_100,5,>100
13395,astoria,122,30829468,99.3590569551,_100,7,>100
13396,noteworthy,122,30829590,99.359450144,_100,10,>100
13397,staffs,122,30829712,99.3598433329,_100,6,>100
13398,conaway,122,30829834,99.3602365218,_100,7,>100
13399,dreaming,122,30829956,99.3606297107,_100,8,>100
13400,cancelled,122,30830078,99.3610228996,_100,9,>100
13401,outpost,122,30830200,99.3614160886,_100,7,>100
13402,olympian,122,30830322,99.3618092775,_100,8,>100
13403,councilors,122,30830444,99.3622024664,_100,10,>100
13404,benchmarks,122,30830566,99.3625956553,_100,10,>100
13405,deaf,122,30830688,99.3629888442,_100,4,>100
13406,murals,122,30830810,99.3633820331,_100,6,>100
13407,evacuate,122,30830932,99.363775222,_100,8,>100
13408,eliot,122,30831054,99.3641684109,_100,5,>100
13409,rink,122,30831176,99.3645615998,_100,4,>100
13410,penchant,122,30831298,99.3649547888,_100,8,>100
13411,calhoun,122,30831420,99.3653479777,_100,7,>100
13412,122,122,30831542,99.3657411666,_100,3,>100
13413,drowning,122,30831664,99.3661343555,_100,8,>100
13414,cheerful,122,30831786,99.3665275444,_100,8,>100
13415,withholding,122,30831908,99.3669207333,_100,11,>100
13416,heartbeat,122,30832030,99.3673139222,_100,9,>100
13417,recycle,122,30832152,99.3677071111,_100,7,>100
13418,shark,122,30832274,99.3681003,_100,5,>100
13419,nunez,122,30832396,99.368493489,_100,5,>100
13420,endurance,122,30832518,99.3688866779,_100,9,>100
13421,henrik,122,30832640,99.3692798668,_100,6,>100
13422,gunn,122,30832762,99.3696730557,_100,4,>100
13423,gutted,122,30832884,99.3700662446,_100,6,>100
13424,hanover,122,30833006,99.3704594335,_100,7,>100
13425,briere,122,30833128,99.3708526224,_100,6,>100
13426,presumed,122,30833250,99.3712458113,_100,8,>100
13427,hester,122,30833372,99.3716390002,_100,6,>100
13428,lag,122,30833494,99.3720321892,_100,3,>100
13429,bark,122,30833616,99.3724253781,_100,4,>100
13430,debacle,122,30833738,99.372818567,_100,7,>100
13431,attendants,122,30833860,99.3732117559,_100,10,>100
13432,relocating,121,30833981,99.3736017219,_100,10,>100
13433,appraisal,121,30834102,99.373991688,_100,9,>100
13434,ilya,121,30834223,99.374381654,_100,4,>100
13435,eden,121,30834344,99.3747716201,_100,4,>100
13436,wolff,121,30834465,99.3751615861,_100,5,>100
13437,hendrix,121,30834586,99.3755515522,_100,7,>100
13438,teague,121,30834707,99.3759415182,_100,6,>100
13439,hoosiers,121,30834828,99.3763314843,_100,8,>100
13440,snead,121,30834949,99.3767214503,_100,5,>100
13441,disclosing,121,30835070,99.3771114164,_100,10,>100
13442,shady,121,30835191,99.3775013824,_100,5,>100
13443,schroeder,121,30835312,99.3778913485,_100,9,>100
13444,kyrie,121,30835433,99.3782813145,_100,5,>100
13445,unpleasant,121,30835554,99.3786712806,_100,10,>100
13446,businessmen,121,30835675,99.3790612466,_100,11,>100
13447,poly,121,30835796,99.3794512127,_100,4,>100
13448,browser,121,30835917,99.3798411788,_100,7,>100
13449,predecessors,121,30836038,99.3802311448,_100,12,>100
13450,megawatts,121,30836159,99.3806211109,_100,9,>100
13451,skipping,121,30836280,99.3810110769,_100,8,>100
13452,navigating,121,30836401,99.381401043,_100,10,>100
13453,herd,121,30836522,99.381791009,_100,4,>100
13454,sabathia,121,30836643,99.3821809751,_100,8,>100
13455,surging,121,30836764,99.3825709411,_100,7,>100
13456,121,121,30836885,99.3829609072,_100,3,>100
13457,thanking,121,30837006,99.3833508732,_100,8,>100
13458,forehead,121,30837127,99.3837408393,_100,8,>100
13459,commuting,121,30837248,99.3841308053,_100,9,>100
13460,tightened,121,30837369,99.3845207714,_100,9,>100
13461,ballad,121,30837490,99.3849107374,_100,6,>100
13462,tierney,121,30837611,99.3853007035,_100,7,>100
13463,calvert,121,30837732,99.3856906695,_100,7,>100
13464,duplicate,121,30837853,99.3860806356,_100,9,>100
13465,haunt,121,30837974,99.3864706016,_100,5,>100
13466,glover,121,30838095,99.3868605677,_100,6,>100
13467,signaling,121,30838216,99.3872505337,_100,9,>100
13468,biting,121,30838337,99.3876404998,_100,6,>100
13469,vianney,121,30838458,99.3880304658,_100,7,>100
13470,prevailing,121,30838579,99.3884204319,_100,10,>100
13471,winemaking,121,30838700,99.3888103979,_100,10,>100
13472,ironically,121,30838821,99.389200364,_100,10,>100
13473,showcased,121,30838942,99.38959033,_100,9,>100
13474,albuquerque,121,30839063,99.3899802961,_100,11,>100
13475,briggs,121,30839184,99.3903702621,_100,6,>100
13476,fundamentals,121,30839305,99.3907602282,_100,12,>100
13477,mcclellan,121,30839426,99.3911501942,_100,9,>100
13478,notch,121,30839547,99.3915401603,_100,5,>100
13479,sleeves,121,30839668,99.3919301263,_100,7,>100
13480,raisins,121,30839789,99.3923200924,_100,7,>100
13481,medieval,121,30839910,99.3927100584,_100,8,>100
13482,slater,121,30840031,99.3931000245,_100,6,>100
13483,dissolve,121,30840152,99.3934899905,_100,8,>100
13484,hagan,121,30840273,99.3938799566,_100,5,>100
13485,apprehension,121,30840394,99.3942699226,_100,12,>100
13486,hugely,121,30840515,99.3946598887,_100,6,>100
13487,parlor,121,30840636,99.3950498547,_100,6,>100
13488,metlife,121,30840757,99.3954398208,_100,7,>100
13489,appreciative,121,30840878,99.3958297868,_100,12,>100
13490,bitterness,121,30840999,99.3962197529,_100,10,>100
13491,deserving,121,30841120,99.3966097189,_100,9,>100
13492,mcintyre,121,30841241,99.396999685,_100,8,>100
13493,ballwin,121,30841362,99.397389651,_100,7,>100
13494,hamlin,121,30841483,99.3977796171,_100,6,>100
13495,doherty,121,30841604,99.3981695832,_100,7,>100
13496,harmony,121,30841725,99.3985595492,_100,7,>100
13497,integrate,121,30841846,99.3989495153,_100,9,>100
13498,hopefuls,121,30841967,99.3993394813,_100,8,>100
13499,facade,121,30842088,99.3997294474,_100,6,>100
13500,husbands,121,30842209,99.4001194134,_100,8,>100
13501,commentator,121,30842330,99.4005093795,_100,11,>100
13502,getty,121,30842451,99.4008993455,_100,5,>100
13503,hamid,120,30842571,99.4012860887,_100,5,>100
13504,tatum,120,30842691,99.4016728319,_100,5,>100
13505,winslow,120,30842811,99.4020595751,_100,7,>100
13506,currencies,120,30842931,99.4024463183,_100,10,>100
13507,waive,120,30843051,99.4028330615,_100,5,>100
13508,broadcasts,120,30843171,99.4032198047,_100,10,>100
13509,menlo,120,30843291,99.4036065478,_100,5,>100
13510,dictator,120,30843411,99.403993291,_100,8,>100
13511,looms,120,30843531,99.4043800342,_100,5,>100
13512,slaves,120,30843651,99.4047667774,_100,6,>100
13513,choking,120,30843771,99.4051535206,_100,7,>100
13514,tara,120,30843891,99.4055402638,_100,4,>100
13515,carmona,120,30844011,99.405927007,_100,7,>100
13516,imaginative,120,30844131,99.4063137502,_100,11,>100
13517,fumbles,120,30844251,99.4067004934,_100,7,>100
13518,jeopardize,120,30844371,99.4070872366,_100,10,>100
13519,adelman,120,30844491,99.4074739798,_100,7,>100
13520,abandoning,120,30844611,99.4078607229,_100,10,>100
13521,coples,120,30844731,99.4082474661,_100,6,>100
13522,excel,120,30844851,99.4086342093,_100,5,>100
13523,decorate,120,30844971,99.4090209525,_100,8,>100
13524,yacht,120,30845091,99.4094076957,_100,5,>100
13525,inland,120,30845211,99.4097944389,_100,6,>100
13526,jetblue,120,30845331,99.4101811821,_100,7,>100
13527,colony,120,30845451,99.4105679253,_100,6,>100
13528,deposited,120,30845571,99.4109546685,_100,9,>100
13529,mannion,120,30845691,99.4113414117,_100,7,>100
13530,nagging,120,30845811,99.4117281549,_100,7,>100
13531,mckenna,120,30845931,99.4121148981,_100,7,>100
13532,apt,120,30846051,99.4125016412,_100,3,>100
13533,locking,120,30846171,99.4128883844,_100,7,>100
13534,erratic,120,30846291,99.4132751276,_100,7,>100
13535,darvish,120,30846411,99.4136618708,_100,7,>100
13536,humber,120,30846531,99.414048614,_100,6,>100
13537,butcher,120,30846651,99.4144353572,_100,7,>100
13538,gunned,120,30846771,99.4148221004,_100,6,>100
13539,batman,120,30846891,99.4152088436,_100,6,>100
13540,herzog,120,30847011,99.4155955868,_100,6,>100
13541,mustang,120,30847131,99.41598233,_100,7,>100
13542,afternoons,120,30847251,99.4163690732,_100,10,>100
13543,eyebrows,120,30847371,99.4167558163,_100,8,>100
13544,120,120,30847491,99.4171425595,_100,3,>100
13545,squads,120,30847611,99.4175293027,_100,6,>100
13546,cranberry,120,30847731,99.4179160459,_100,9,>100
13547,inequality,120,30847851,99.4183027891,_100,10,>100
13548,frightened,120,30847971,99.4186895323,_100,10,>100
13549,penned,120,30848091,99.4190762755,_100,6,>100
13550,souvenir,120,30848211,99.4194630187,_100,8,>100
13551,maid,120,30848331,99.4198497619,_100,4,>100
13552,tenderloin,120,30848451,99.4202365051,_100,10,>100
13553,swell,120,30848571,99.4206232483,_100,5,>100
13554,gigantic,120,30848691,99.4210099914,_100,8,>100
13555,captains,120,30848811,99.4213967346,_100,8,>100
13556,dianne,120,30848931,99.4217834778,_100,6,>100
13557,stigma,120,30849051,99.422170221,_100,6,>100
13558,concede,120,30849171,99.4225569642,_100,7,>100
13559,ajc,120,30849291,99.4229437074,_100,3,>100
13560,adrenaline,120,30849411,99.4233304506,_100,10,>100
13561,fraser,120,30849531,99.4237171938,_100,6,>100
13562,telecommunications,120,30849651,99.424103937,_100,18,>100
13563,rihanna,120,30849771,99.4244906802,_100,7,>100
13564,geoff,120,30849891,99.4248774234,_100,5,>100
13565,helton,120,30850011,99.4252641665,_100,6,>100
13566,explode,120,30850131,99.4256509097,_100,7,>100
13567,presiding,120,30850251,99.4260376529,_100,9,>100
13568,renacci,120,30850371,99.4264243961,_100,7,>100
13569,reluctance,120,30850491,99.4268111393,_100,10,>100
13570,mcgraw,120,30850611,99.4271978825,_100,6,>100
13571,soothing,120,30850731,99.4275846257,_100,8,>100
13572,wed,120,30850851,99.4279713689,_100,3,>100
13573,exquisite,120,30850971,99.4283581121,_100,9,>100
13574,davenport,119,30851090,99.4287416324,_100,9,>100
13575,il,119,30851209,99.4291251527,_100,2,>100
13576,ems,119,30851328,99.4295086731,_100,3,>100
13577,tightening,119,30851447,99.4298921934,_100,10,>100
13578,carlisle,119,30851566,99.4302757137,_100,8,>100
13579,constellation,119,30851685,99.4306592341,_100,13,>100
13580,audrey,119,30851804,99.4310427544,_100,6,>100
13581,fuss,119,30851923,99.4314262747,_100,4,>100
13582,rees,119,30852042,99.4318097951,_100,4,>100
13583,factset,119,30852161,99.4321933154,_100,7,>100
13584,consolidated,119,30852280,99.4325768357,_100,12,>100
13585,minicamp,119,30852399,99.4329603561,_100,8,>100
13586,skins,119,30852518,99.4333438764,_100,5,>100
13587,specially,119,30852637,99.4337273967,_100,9,>100
13588,adorned,119,30852756,99.434110917,_100,7,>100
13589,mimic,119,30852875,99.4344944374,_100,5,>100
13590,flanked,119,30852994,99.4348779577,_100,7,>100
13591,whitecaps,119,30853113,99.435261478,_100,9,>100
13592,administer,119,30853232,99.4356449984,_100,10,>100
13593,toppled,119,30853351,99.4360285187,_100,7,>100
13594,willard,119,30853470,99.436412039,_100,7,>100
13595,mick,119,30853589,99.4367955594,_100,4,>100
13596,aromatic,119,30853708,99.4371790797,_100,8,>100
13597,dyer,119,30853827,99.4375626,_100,4,>100
13598,checkpoint,119,30853946,99.4379461204,_100,10,>100
13599,modeling,119,30854065,99.4383296407,_100,8,>100
13600,beforehand,119,30854184,99.438713161,_100,10,>100
13601,franzen,119,30854303,99.4390966814,_100,7,>100
13602,lpga,119,30854422,99.4394802017,_100,4,>100
13603,guantanamo,119,30854541,99.439863722,_100,10,>100
13604,annoyed,119,30854660,99.4402472423,_100,7,>100
13605,directive,119,30854779,99.4406307627,_100,9,>100
13606,quaint,119,30854898,99.441014283,_100,6,>100
13607,scars,119,30855017,99.4413978033,_100,5,>100
13608,injustice,119,30855136,99.4417813237,_100,9,>100
13609,stat,119,30855255,99.442164844,_100,4,>100
13610,resurgence,119,30855374,99.4425483643,_100,10,>100
13611,jams,119,30855493,99.4429318847,_100,4,>100
13612,119,119,30855612,99.443315405,_100,3,>100
13613,loophole,119,30855731,99.4436989253,_100,8,>100
13614,dramas,119,30855850,99.4440824457,_100,6,>100
13615,philanthropic,119,30855969,99.444465966,_100,13,>100
13616,manageable,119,30856088,99.4448494863,_100,10,>100
13617,worrisome,119,30856207,99.4452330066,_100,9,>100
13618,professionalism,119,30856326,99.445616527,_100,15,>100
13619,paving,119,30856445,99.4460000473,_100,6,>100
13620,revered,119,30856564,99.4463835676,_100,7,>100
13621,rothman,119,30856683,99.446767088,_100,7,>100
13622,sykes,119,30856802,99.4471506083,_100,5,>100
13623,evergreen,119,30856921,99.4475341286,_100,9,>100
13624,sidney,119,30857040,99.447917649,_100,6,>100
13625,rsvp,119,30857159,99.4483011693,_100,4,>100
13626,racetrack,119,30857278,99.4486846896,_100,9,>100
13627,faux,119,30857397,99.44906821,_100,4,>100
13628,bbq,119,30857516,99.4494517303,_100,3,>100
13629,reeves,119,30857635,99.4498352506,_100,6,>100
13630,privileges,119,30857754,99.450218771,_100,10,>100
13631,privileged,119,30857873,99.4506022913,_100,10,>100
13632,jackman,119,30857992,99.4509858116,_100,7,>100
13633,paramount,119,30858111,99.4513693319,_100,9,>100
13634,margaritas,119,30858230,99.4517528523,_100,10,>100
13635,laborers,119,30858349,99.4521363726,_100,8,>100
13636,blazing,119,30858468,99.4525198929,_100,7,>100
13637,melting,119,30858587,99.4529034133,_100,7,>100
13638,occupies,119,30858706,99.4532869336,_100,8,>100
13639,generals,119,30858825,99.4536704539,_100,8,>100
13640,mohammad,119,30858944,99.4540539743,_100,8,>100
13641,coincide,119,30859063,99.4544374946,_100,8,>100
13642,dangerously,119,30859182,99.4548210149,_100,11,>100
13643,embraces,119,30859301,99.4552045353,_100,8,>100
13644,lunchtime,119,30859420,99.4555880556,_100,9,>100
13645,guru,119,30859539,99.4559715759,_100,4,>100
13646,showcasing,119,30859658,99.4563550963,_100,10,>100
13647,calderon,119,30859777,99.4567386166,_100,8,>100
13648,coloring,119,30859896,99.4571221369,_100,8,>100
13649,busted,119,30860015,99.4575056572,_100,6,>100
13650,raven,119,30860134,99.4578891776,_100,5,>100
13651,distances,119,30860253,99.4582726979,_100,9,>100
13652,insert,119,30860372,99.4586562182,_100,6,>100
13653,margarita,119,30860491,99.4590397386,_100,9,>100
13654,anchors,119,30860610,99.4594232589,_100,7,>100
13655,deploy,119,30860729,99.4598067792,_100,6,>100
13656,overflow,119,30860848,99.4601902996,_100,8,>100
13657,stella,118,30860966,99.460570597,_100,6,>100
13658,lp,118,30861084,99.4609508945,_100,2,>100
13659,clement,118,30861202,99.461331192,_100,7,>100
13660,cantor,118,30861320,99.4617114895,_100,6,>100
13661,foreigners,118,30861438,99.4620917869,_100,10,>100
13662,jfk,118,30861556,99.4624720844,_100,3,>100
13663,hannahan,118,30861674,99.4628523819,_100,8,>100
13664,flier,118,30861792,99.4632326793,_100,5,>100
13665,cautiously,118,30861910,99.4636129768,_100,10,>100
13666,aioli,118,30862028,99.4639932743,_100,5,>100
13667,sync,118,30862146,99.4643735717,_100,4,>100
13668,mourning,118,30862264,99.4647538692,_100,8,>100
13669,statutes,118,30862382,99.4651341667,_100,8,>100
13670,merging,118,30862500,99.4655144642,_100,7,>100
13671,hanley,118,30862618,99.4658947616,_100,6,>100
13672,goofy,118,30862736,99.4662750591,_100,5,>100
13673,governed,118,30862854,99.4666553566,_100,8,>100
13674,counterterrorism,118,30862972,99.467035654,_100,16,>100
13675,parchment,118,30863090,99.4674159515,_100,9,>100
13676,118,118,30863208,99.467796249,_100,3,>100
13677,decorating,118,30863326,99.4681765465,_100,10,>100
13678,juror,118,30863444,99.4685568439,_100,5,>100
13679,sparking,118,30863562,99.4689371414,_100,8,>100
13680,interrogation,118,30863680,99.4693174389,_100,13,>100
13681,kellogg,118,30863798,99.4696977363,_100,7,>100
13682,turkeys,118,30863916,99.4700780338,_100,7,>100
13683,fumbled,118,30864034,99.4704583313,_100,7,>100
13684,stump,118,30864152,99.4708386288,_100,5,>100
13685,storefronts,118,30864270,99.4712189262,_100,11,>100
13686,berglund,118,30864388,99.4715992237,_100,8,>100
13687,buckley,118,30864506,99.4719795212,_100,7,>100
13688,lays,118,30864624,99.4723598186,_100,4,>100
13689,blade,118,30864742,99.4727401161,_100,5,>100
13690,raging,118,30864860,99.4731204136,_100,6,>100
13691,composers,118,30864978,99.4735007111,_100,9,>100
13692,mathis,118,30865096,99.4738810085,_100,6,>100
13693,sa,118,30865214,99.474261306,_100,2,>100
13694,monsters,118,30865332,99.4746416035,_100,8,>100
13695,clicked,118,30865450,99.4750219009,_100,7,>100
13696,illini,118,30865568,99.4754021984,_100,6,>100
13697,sweatshirt,118,30865686,99.4757824959,_100,10,>100
13698,db,118,30865804,99.4761627934,_100,2,>100
13699,toni,118,30865922,99.4765430908,_100,4,>100
13700,guessed,118,30866040,99.4769233883,_100,7,>100
13701,kosher,118,30866158,99.4773036858,_100,6,>100
13702,telecast,118,30866276,99.4776839832,_100,8,>100
13703,pretending,118,30866394,99.4780642807,_100,10,>100
13704,themed,118,30866512,99.4784445782,_100,6,>100
13705,skype,118,30866630,99.4788248757,_100,5,>100
13706,hardwood,118,30866748,99.4792051731,_100,8,>100
13707,garry,118,30866866,99.4795854706,_100,5,>100
13708,darn,118,30866984,99.4799657681,_100,4,>100
13709,bursting,118,30867102,99.4803460655,_100,8,>100
13710,lesniak,118,30867220,99.480726363,_100,7,>100
13711,danish,117,30867337,99.4811034376,_100,6,>100
13712,termed,117,30867454,99.4814805122,_100,6,>100
13713,bencivengo,117,30867571,99.4818575868,_100,10,>100
13714,recorder,117,30867688,99.4822346615,_100,8,>100
13715,vera,117,30867805,99.4826117361,_100,4,>100
13716,nigeria,117,30867922,99.4829888107,_100,7,>100
13717,modification,117,30868039,99.4833658853,_100,12,>100
13718,nuns,117,30868156,99.4837429599,_100,4,>100
13719,circular,117,30868273,99.4841200345,_100,8,>100
13720,bundle,117,30868390,99.4844971091,_100,6,>100
13721,dolores,117,30868507,99.4848741837,_100,7,>100
13722,confit,117,30868624,99.4852512583,_100,6,>100
13723,responsive,117,30868741,99.485628333,_100,10,>100
13724,chives,117,30868858,99.4860054076,_100,6,>100
13725,devastation,117,30868975,99.4863824822,_100,11,>100
13726,marshal,117,30869092,99.4867595568,_100,7,>100
13727,legalization,117,30869209,99.4871366314,_100,12,>100
13728,curley,117,30869326,99.487513706,_100,6,>100
13729,pickles,117,30869443,99.4878907806,_100,7,>100
13730,peppered,117,30869560,99.4882678552,_100,8,>100
13731,hates,117,30869677,99.4886449299,_100,5,>100
13732,compost,117,30869794,99.4890220045,_100,7,>100
13733,depaul,117,30869911,99.4893990791,_100,6,>100
13734,doughnut,117,30870028,99.4897761537,_100,8,>100
13735,viejo,117,30870145,99.4901532283,_100,5,>100
13736,premiered,117,30870262,99.4905303029,_100,9,>100
13737,sweetened,117,30870379,99.4909073775,_100,9,>100
13738,freezes,117,30870496,99.4912844521,_100,7,>100
13739,chocolates,117,30870613,99.4916615267,_100,10,>100
13740,lore,117,30870730,99.4920386014,_100,4,>100
13741,parishes,117,30870847,99.492415676,_100,8,>100
13742,reflective,117,30870964,99.4927927506,_100,10,>100
13743,claus,117,30871081,99.4931698252,_100,5,>100
13744,novice,117,30871198,99.4935468998,_100,6,>100
13745,salts,117,30871315,99.4939239744,_100,5,>100
13746,ruptured,117,30871432,99.494301049,_100,8,>100
13747,alleviate,117,30871549,99.4946781236,_100,9,>100
13748,worsened,117,30871666,99.4950551982,_100,8,>100
13749,longstanding,117,30871783,99.4954322729,_100,12,>100
13750,baca,117,30871900,99.4958093475,_100,4,>100
13751,roaring,117,30872017,99.4961864221,_100,7,>100
13752,lily,117,30872134,99.4965634967,_100,4,>100
13753,donnelly,117,30872251,99.4969405713,_100,8,>100
13754,eduardo,117,30872368,99.4973176459,_100,7,>100
13755,maldonado,117,30872485,99.4976947205,_100,9,>100
13756,lacy,117,30872602,99.4980717951,_100,4,>100
13757,routines,117,30872719,99.4984488697,_100,8,>100
13758,shout,117,30872836,99.4988259444,_100,5,>100
13759,negotiators,117,30872953,99.499203019,_100,11,>100
13760,gus,117,30873070,99.4995800936,_100,3,>100
13761,curse,117,30873187,99.4999571682,_100,5,>100
13762,bracing,117,30873304,99.5003342428,_100,7,>100
13763,goose,117,30873421,99.5007113174,_100,5,>100
13764,welsh,117,30873538,99.501088392,_100,5,>100
13765,racially,117,30873655,99.5014654666,_100,8,>100
13766,buzzing,117,30873772,99.5018425412,_100,7,>100
13767,117,117,30873889,99.5022196159,_100,3,>100
13768,untouched,117,30874006,99.5025966905,_100,9,>100
13769,cerebral,117,30874123,99.5029737651,_100,8,>100
13770,unstable,117,30874240,99.5033508397,_100,8,>100
13771,attic,117,30874357,99.5037279143,_100,5,>100
13772,weld,117,30874474,99.5041049889,_100,4,>100
13773,conspiring,117,30874591,99.5044820635,_100,10,>100
13774,extradition,117,30874708,99.5048591381,_100,11,>100
13775,grammys,117,30874825,99.5052362128,_100,7,>100
13776,argentine,117,30874942,99.5056132874,_100,9,>100
13777,advertise,117,30875059,99.505990362,_100,9,>100
13778,carlton,116,30875175,99.5063642137,_100,7,>100
13779,chuckle,116,30875291,99.5067380655,_100,7,>100
13780,outpatient,116,30875407,99.5071119172,_100,10,>100
13781,imprisoned,116,30875523,99.507485769,_100,10,>100
13782,contestant,116,30875639,99.5078596207,_100,10,>100
13783,colby,116,30875755,99.5082334725,_100,5,>100
13784,lieberman,116,30875871,99.5086073242,_100,9,>100
13785,nonsense,116,30875987,99.508981176,_100,8,>100
13786,diversion,116,30876103,99.5093550277,_100,9,>100
13787,pancake,116,30876219,99.5097288795,_100,7,>100
13788,excerpts,116,30876335,99.5101027312,_100,8,>100
13789,residences,116,30876451,99.510476583,_100,10,>100
13790,deposition,116,30876567,99.5108504347,_100,10,>100
13791,skated,116,30876683,99.5112242865,_100,6,>100
13792,womack,116,30876799,99.5115981382,_100,6,>100
13793,choreographer,116,30876915,99.51197199,_100,13,>100
13794,tabs,116,30877031,99.5123458417,_100,4,>100
13795,fister,116,30877147,99.5127196935,_100,6,>100
13796,derail,116,30877263,99.5130935452,_100,6,>100
13797,michaels,116,30877379,99.513467397,_100,8,>100
13798,compton,116,30877495,99.5138412488,_100,7,>100
13799,ocampo,116,30877611,99.5142151005,_100,6,>100
13800,ornate,116,30877727,99.5145889523,_100,6,>100
13801,cornerstone,116,30877843,99.514962804,_100,11,>100
13802,gleaming,116,30877959,99.5153366558,_100,8,>100
13803,brookings,116,30878075,99.5157105075,_100,9,>100
13804,osweiler,116,30878191,99.5160843593,_100,8,>100
13805,schumer,116,30878307,99.516458211,_100,7,>100
13806,leaping,116,30878423,99.5168320628,_100,7,>100
13807,somber,116,30878539,99.5172059145,_100,6,>100
13808,coli,116,30878655,99.5175797663,_100,4,>100
13809,nods,116,30878771,99.517953618,_100,4,>100
13810,enclosed,116,30878887,99.5183274698,_100,8,>100
13811,watermelon,116,30879003,99.5187013215,_100,10,>100
13812,brilliantly,116,30879119,99.5190751733,_100,11,>100
13813,116,116,30879235,99.519449025,_100,3,>100
13814,observer,116,30879351,99.5198228768,_100,8,>100
13815,sovereign,116,30879467,99.5201967285,_100,9,>100
13816,allied,116,30879583,99.5205705803,_100,6,>100
13817,raptors,116,30879699,99.520944432,_100,7,>100
13818,dawkins,116,30879815,99.5213182838,_100,7,>100
13819,abbey,116,30879931,99.5216921355,_100,5,>100
13820,accolades,116,30880047,99.5220659873,_100,9,>100
13821,capping,116,30880163,99.522439839,_100,7,>100
13822,ticked,116,30880279,99.5228136908,_100,6,>100
13823,hess,116,30880395,99.5231875425,_100,4,>100
13824,suu,116,30880511,99.5235613943,_100,3,>100
13825,sunscreen,116,30880627,99.523935246,_100,9,>100
13826,mastercard,116,30880743,99.5243090978,_100,10,>100
13827,mgm,116,30880859,99.5246829495,_100,3,>100
13828,johan,116,30880975,99.5250568013,_100,5,>100
13829,modifications,116,30881091,99.525430653,_100,13,>100
13830,drifted,116,30881207,99.5258045048,_100,7,>100
13831,lamps,116,30881323,99.5261783565,_100,5,>100
13832,clinging,116,30881439,99.5265522083,_100,8,>100
13833,barrage,116,30881555,99.5269260601,_100,7,>100
13834,gerard,116,30881671,99.5272999118,_100,6,>100
13835,hd,116,30881787,99.5276737636,_100,2,>100
13836,misery,116,30881903,99.5280476153,_100,6,>100
13837,mcclure,116,30882019,99.5284214671,_100,7,>100
13838,katniss,116,30882135,99.5287953188,_100,7,>100
13839,lorenzo,116,30882251,99.5291691706,_100,7,>100
13840,brut,116,30882367,99.5295430223,_100,4,>100
13841,accusation,116,30882483,99.5299168741,_100,10,>100
13842,camped,116,30882599,99.5302907258,_100,6,>100
13843,regency,116,30882715,99.5306645776,_100,7,>100
13844,streamline,116,30882831,99.5310384293,_100,10,>100
13845,macomb,116,30882947,99.5314122811,_100,6,>100
13846,ohsu,116,30883063,99.5317861328,_100,4,>100
13847,servants,116,30883179,99.5321599846,_100,8,>100
13848,swimmer,116,30883295,99.5325338363,_100,7,>100
13849,bye,116,30883411,99.5329076881,_100,3,>100
13850,bragging,116,30883527,99.5332815398,_100,8,>100
13851,transmitted,116,30883643,99.5336553916,_100,11,>100
13852,piper,115,30883758,99.5340260205,_100,5,>100
13853,petersen,115,30883873,99.5343966494,_100,8,>100
13854,diplomacy,115,30883988,99.5347672783,_100,9,>100
13855,mouths,115,30884103,99.5351379071,_100,6,>100
13856,vocabulary,115,30884218,99.535508536,_100,10,>100
13857,royalty,115,30884333,99.5358791649,_100,7,>100
13858,definite,115,30884448,99.5362497938,_100,8,>100
13859,redesigned,115,30884563,99.5366204227,_100,10,>100
13860,perth,115,30884678,99.5369910516,_100,5,>100
13861,halves,115,30884793,99.5373616805,_100,6,>100
13862,dividing,115,30884908,99.5377323094,_100,8,>100
13863,pickups,115,30885023,99.5381029383,_100,7,>100
13864,huddle,115,30885138,99.5384735672,_100,6,>100
13865,lessen,115,30885253,99.5388441961,_100,6,>100
13866,leafy,115,30885368,99.5392148249,_100,5,>100
13867,adolescent,115,30885483,99.5395854538,_100,10,>100
13868,greenwald,115,30885598,99.5399560827,_100,9,>100
13869,horizontal,115,30885713,99.5403267116,_100,10,>100
13870,115,115,30885828,99.5406973405,_100,3,>100
13871,entice,115,30885943,99.5410679694,_100,6,>100
13872,canopy,115,30886058,99.5414385983,_100,6,>100
13873,perceptions,115,30886173,99.5418092272,_100,11,>100
13874,misunderstood,115,30886288,99.5421798561,_100,13,>100
13875,stalking,115,30886403,99.542550485,_100,8,>100
13876,arrow,115,30886518,99.5429211139,_100,5,>100
13877,unnoticed,115,30886633,99.5432917428,_100,9,>100
13878,seitz,115,30886748,99.5436623716,_100,5,>100
13879,rip,115,30886863,99.5440330005,_100,3,>100
13880,hartman,115,30886978,99.5444036294,_100,7,>100
13881,prescott,115,30887093,99.5447742583,_100,8,>100
13882,unconventional,115,30887208,99.5451448872,_100,14,>100
13883,confederate,115,30887323,99.5455155161,_100,11,>100
13884,coma,115,30887438,99.545886145,_100,4,>100
13885,nichol,115,30887553,99.5462567739,_100,6,>100
13886,spelling,115,30887668,99.5466274028,_100,8,>100
13887,iq,115,30887783,99.5469980317,_100,2,>100
13888,colton,115,30887898,99.5473686606,_100,6,>100
13889,bipolar,115,30888013,99.5477392895,_100,7,>100
13890,illusion,115,30888128,99.5481099183,_100,8,>100
13891,sprain,115,30888243,99.5484805472,_100,6,>100
13892,asylum,115,30888358,99.5488511761,_100,6,>100
13893,allure,115,30888473,99.549221805,_100,6,>100
13894,deceptive,115,30888588,99.5495924339,_100,9,>100
13895,grossman,115,30888703,99.5499630628,_100,8,>100
13896,noel,115,30888818,99.5503336917,_100,4,>100
13897,tailback,115,30888933,99.5507043206,_100,8,>100
13898,hello,115,30889048,99.5510749495,_100,5,>100
13899,exelon,115,30889163,99.5514455784,_100,6,>100
13900,twilight,115,30889278,99.5518162073,_100,8,>100
13901,vail,115,30889393,99.5521868362,_100,4,>100
13902,crossings,115,30889508,99.552557465,_100,9,>100
13903,incorporates,115,30889623,99.5529280939,_100,12,>100
13904,johansson,115,30889738,99.5532987228,_100,9,>100
13905,helena,115,30889853,99.5536693517,_100,6,>100
13906,booze,115,30889968,99.5540399806,_100,5,>100
13907,trophies,115,30890083,99.5544106095,_100,8,>100
13908,mice,115,30890198,99.5547812384,_100,4,>100
13909,controllers,115,30890313,99.5551518673,_100,11,>100
13910,lofty,115,30890428,99.5555224962,_100,5,>100
13911,congo,115,30890543,99.5558931251,_100,5,>100
13912,cribbs,115,30890658,99.556263754,_100,6,>100
13913,endowment,115,30890773,99.5566343828,_100,9,>100
13914,bpa,115,30890888,99.5570050117,_100,3,>100
13915,discoveries,115,30891003,99.5573756406,_100,11,>100
13916,parcels,115,30891118,99.5577462695,_100,7,>100
13917,kahn,115,30891233,99.5581168984,_100,4,>100
13918,oregano,115,30891348,99.5584875273,_100,7,>100
13919,zac,115,30891463,99.5588581562,_100,3,>100
13920,smelled,115,30891578,99.5592287851,_100,7,>100
13921,xl,115,30891693,99.559599414,_100,2,>100
13922,gamblers,115,30891808,99.5599700429,_100,8,>100
13923,moderately,114,30891922,99.5603374489,_100,10,>100
13924,crabs,114,30892036,99.5607048549,_100,5,>100
13925,downplayed,114,30892150,99.561072261,_100,10,>100
13926,bogus,114,30892264,99.561439667,_100,5,>100
13927,protester,114,30892378,99.561807073,_100,9,>100
13928,debuts,114,30892492,99.5621744791,_100,6,>100
13929,modot,114,30892606,99.5625418851,_100,5,>100
13930,whirlwind,114,30892720,99.5629092911,_100,9,>100
13931,resilient,114,30892834,99.5632766972,_100,9,>100
13932,broomfield,114,30892948,99.5636441032,_100,10,>100
13933,rifles,114,30893062,99.5640115092,_100,6,>100
13934,floats,114,30893176,99.5643789153,_100,6,>100
13935,pediatrician,114,30893290,99.5647463213,_100,12,>100
13936,chan,114,30893404,99.5651137273,_100,4,>100
13937,crow,114,30893518,99.5654811333,_100,4,>100
13938,righthander,114,30893632,99.5658485394,_100,11,>100
13939,winston,114,30893746,99.5662159454,_100,7,>100
13940,expressions,114,30893860,99.5665833514,_100,11,>100
13941,robbing,114,30893974,99.5669507575,_100,7,>100
13942,icy,114,30894088,99.5673181635,_100,3,>100
13943,roared,114,30894202,99.5676855695,_100,6,>100
13944,darron,114,30894316,99.5680529756,_100,6,>100
13945,hash,114,30894430,99.5684203816,_100,4,>100
13946,arvada,114,30894544,99.5687877876,_100,6,>100
13947,adhere,114,30894658,99.5691551937,_100,6,>100
13948,savannah,114,30894772,99.5695225997,_100,8,>100
13949,encore,114,30894886,99.5698900057,_100,6,>100
13950,chaparral,114,30895000,99.5702574118,_100,9,>100
13951,mardi,114,30895114,99.5706248178,_100,5,>100
13952,goodies,114,30895228,99.5709922238,_100,7,>100
13953,invoked,114,30895342,99.5713596299,_100,7,>100
13954,crease,114,30895456,99.5717270359,_100,6,>100
13955,ceramic,114,30895570,99.5720944419,_100,7,>100
13956,collin,114,30895684,99.5724618479,_100,6,>100
13957,114,114,30895798,99.572829254,_100,3,>100
13958,disposable,114,30895912,99.57319666,_100,10,>100
13959,resentment,114,30896026,99.573564066,_100,10,>100
13960,scales,114,30896140,99.5739314721,_100,6,>100
13961,gadhafi,114,30896254,99.5742988781,_100,7,>100
13962,capsule,114,30896368,99.5746662841,_100,7,>100
13963,hose,114,30896482,99.5750336902,_100,4,>100
13964,procedural,114,30896596,99.5754010962,_100,10,>100
13965,pastas,114,30896710,99.5757685022,_100,6,>100
13966,antics,114,30896824,99.5761359083,_100,6,>100
13967,arapahoe,114,30896938,99.5765033143,_100,8,>100
13968,denmark,114,30897052,99.5768707203,_100,7,>100
13969,defeats,114,30897166,99.5772381264,_100,7,>100
13970,cahill,114,30897280,99.5776055324,_100,6,>100
13971,exiting,114,30897394,99.5779729384,_100,7,>100
13972,flaw,114,30897508,99.5783403445,_100,4,>100
13973,stewardship,114,30897622,99.5787077505,_100,11,>100
13974,insanity,114,30897736,99.5790751565,_100,8,>100
13975,employing,114,30897850,99.5794425625,_100,9,>100
13976,bunker,114,30897964,99.5798099686,_100,6,>100
13977,relentlessly,114,30898078,99.5801773746,_100,12,>100
13978,outlining,114,30898192,99.5805447806,_100,9,>100
13979,escalated,114,30898306,99.5809121867,_100,9,>100
13980,proficiency,114,30898420,99.5812795927,_100,11,>100
13981,uranium,114,30898534,99.5816469987,_100,7,>100
13982,hatcher,114,30898648,99.5820144048,_100,7,>100
13983,coping,114,30898762,99.5823818108,_100,6,>100
13984,bentley,114,30898876,99.5827492168,_100,7,>100
13985,alerts,114,30898990,99.5831166229,_100,6,>100
13986,givens,113,30899103,99.583480806,_100,6,>100
13987,sin,113,30899216,99.5838449892,_100,3,>100
13988,pattonville,113,30899329,99.5842091724,_100,11,>100
13989,pesticides,113,30899442,99.5845733555,_100,10,>100
13990,shoved,113,30899555,99.5849375387,_100,6,>100
13991,baja,113,30899668,99.5853017219,_100,4,>100
13992,curtains,113,30899781,99.5856659051,_100,8,>100
13993,winger,113,30899894,99.5860300882,_100,6,>100
13994,heroine,113,30900007,99.5863942714,_100,7,>100
13995,specified,113,30900120,99.5867584546,_100,9,>100
13996,trader,113,30900233,99.5871226377,_100,6,>100
13997,pint,113,30900346,99.5874868209,_100,4,>100
13998,tilt,113,30900459,99.5878510041,_100,4,>100
13999,confronting,113,30900572,99.5882151873,_100,11,>100
14000,dart,113,30900685,99.5885793704,_100,4,>100
14001,bondholders,113,30900798,99.5889435536,_100,11,>100
14002,seoul,113,30900911,99.5893077368,_100,5,>100
14003,yell,113,30901024,99.5896719199,_100,4,>100
14004,buildup,113,30901137,99.5900361031,_100,7,>100
14005,symbols,113,30901250,99.5904002863,_100,7,>100
14006,mug,113,30901363,99.5907644695,_100,3,>100
14007,swagger,113,30901476,99.5911286526,_100,7,>100
14008,peres,113,30901589,99.5914928358,_100,5,>100
14009,113,113,30901702,99.591857019,_100,3,>100
14010,buddhist,113,30901815,99.5922212022,_100,8,>100
14011,alarmed,113,30901928,99.5925853853,_100,7,>100
14012,invitations,113,30902041,99.5929495685,_100,11,>100
14013,interpreted,113,30902154,99.5933137517,_100,11,>100
14014,sanctioned,113,30902267,99.5936779348,_100,10,>100
14015,pennington,113,30902380,99.594042118,_100,10,>100
14016,spying,113,30902493,99.5944063012,_100,6,>100
14017,reservoirs,113,30902606,99.5947704844,_100,10,>100
14018,carjacking,113,30902719,99.5951346675,_100,10,>100
14019,edgy,113,30902832,99.5954988507,_100,4,>100
14020,mullin,113,30902945,99.5958630339,_100,6,>100
14021,flowed,113,30903058,99.596227217,_100,6,>100
14022,lancaster,113,30903171,99.5965914002,_100,9,>100
14023,nuisance,113,30903284,99.5969555834,_100,8,>100
14024,catastrophe,113,30903397,99.5973197666,_100,11,>100
14025,mcnamara,113,30903510,99.5976839497,_100,8,>100
14026,equals,113,30903623,99.5980481329,_100,6,>100
14027,waking,113,30903736,99.5984123161,_100,6,>100
14028,marquis,113,30903849,99.5987764992,_100,7,>100
14029,esther,113,30903962,99.5991406824,_100,6,>100
14030,tweaked,113,30904075,99.5995048656,_100,7,>100
14031,clientele,113,30904188,99.5998690488,_100,9,>100
14032,outburst,113,30904301,99.6002332319,_100,8,>100
14033,neb,113,30904414,99.6005974151,_100,3,>100
14034,guangcheng,113,30904527,99.6009615983,_100,10,>100
14035,savor,113,30904640,99.6013257814,_100,5,>100
14036,realization,113,30904753,99.6016899646,_100,11,>100
14037,siding,113,30904866,99.6020541478,_100,6,>100
14038,bret,113,30904979,99.602418331,_100,4,>100
14039,teddy,113,30905092,99.6027825141,_100,5,>100
14040,endorsing,113,30905205,99.6031466973,_100,9,>100
14041,sci,113,30905318,99.6035108805,_100,3,>100
14042,labeling,113,30905431,99.6038750636,_100,8,>100
14043,eviction,113,30905544,99.6042392468,_100,8,>100
14044,laurence,113,30905657,99.60460343,_100,8,>100
14045,criticisms,113,30905770,99.6049676132,_100,10,>100
14046,dislike,113,30905883,99.6053317963,_100,7,>100
14047,funnel,113,30905996,99.6056959795,_100,6,>100
14048,sir,113,30906109,99.6060601627,_100,3,>100
14049,systemic,113,30906222,99.6064243458,_100,8,>100
14050,colombian,113,30906335,99.606788529,_100,9,>100
14051,smyly,113,30906448,99.6071527122,_100,5,>100
14052,remnants,113,30906561,99.6075168954,_100,8,>100
14053,delaney,113,30906674,99.6078810785,_100,7,>100
14054,cupcake,113,30906787,99.6082452617,_100,7,>100
14055,steakhouse,113,30906900,99.6086094449,_100,10,>100
14056,cliffs,113,30907013,99.608973628,_100,6,>100
14057,cheated,113,30907126,99.6093378112,_100,7,>100
14058,critique,113,30907239,99.6097019944,_100,8,>100
14059,xbox,113,30907352,99.6100661776,_100,4,>100
14060,completes,113,30907465,99.6104303607,_100,9,>100
14061,earmarked,113,30907578,99.6107945439,_100,9,>100
14062,pervasive,113,30907691,99.6111587271,_100,9,>100
14063,terrified,113,30907804,99.6115229102,_100,9,>100
14064,bargains,112,30907916,99.6118838706,_100,8,>100
14065,zinfandel,112,30908028,99.6122448309,_100,9,>100
14066,mosley,112,30908140,99.6126057912,_100,6,>100
14067,zeller,112,30908252,99.6129667515,_100,6,>100
14068,addictive,112,30908364,99.6133277118,_100,9,>100
14069,wiggins,112,30908476,99.6136886721,_100,7,>100
14070,snowfall,112,30908588,99.6140496324,_100,8,>100
14071,crescent,112,30908700,99.6144105927,_100,8,>100
14072,premises,112,30908812,99.6147715531,_100,8,>100
14073,toews,112,30908924,99.6151325134,_100,5,>100
14074,melbourne,112,30909036,99.6154934737,_100,9,>100
14075,drawer,112,30909148,99.615854434,_100,6,>100
14076,msnbc,112,30909260,99.6162153943,_100,5,>100
14077,leeks,112,30909372,99.6165763546,_100,5,>100
14078,angst,112,30909484,99.6169373149,_100,5,>100
14079,hargrove,112,30909596,99.6172982752,_100,8,>100
14080,forecasting,112,30909708,99.6176592355,_100,11,>100
14081,uptown,112,30909820,99.6180201959,_100,6,>100
14082,finn,112,30909932,99.6183811562,_100,4,>100
14083,transitional,112,30910044,99.6187421165,_100,12,>100
14084,percentages,112,30910156,99.6191030768,_100,11,>100
14085,cronin,112,30910268,99.6194640371,_100,6,>100
14086,mladic,112,30910380,99.6198249974,_100,6,>100
14087,mangini,112,30910492,99.6201859577,_100,7,>100
14088,fondly,112,30910604,99.620546918,_100,6,>100
14089,perjury,112,30910716,99.6209078784,_100,7,>100
14090,izod,112,30910828,99.6212688387,_100,4,>100
14091,chatted,112,30910940,99.621629799,_100,7,>100
14092,streep,112,30911052,99.6219907593,_100,6,>100
14093,deficiencies,112,30911164,99.6223517196,_100,12,>100
14094,gymnasium,112,30911276,99.6227126799,_100,9,>100
14095,mergers,112,30911388,99.6230736402,_100,7,>100
14096,sharper,112,30911500,99.6234346005,_100,7,>100
14097,jobsohio,112,30911612,99.6237955608,_100,8,>100
14098,positives,112,30911724,99.6241565212,_100,9,>100
14099,grease,112,30911836,99.6245174815,_100,6,>100
14100,incarcerated,112,30911948,99.6248784418,_100,12,>100
14101,rewrite,112,30912060,99.6252394021,_100,7,>100
14102,gears,112,30912172,99.6256003624,_100,5,>100
14103,fairs,112,30912284,99.6259613227,_100,5,>100
14104,entrenched,112,30912396,99.626322283,_100,10,>100
14105,heyday,112,30912508,99.6266832433,_100,6,>100
14106,guitars,112,30912620,99.6270442037,_100,7,>100
14107,groce,112,30912732,99.627405164,_100,5,>100
14108,konerko,112,30912844,99.6277661243,_100,7,>100
14109,cosmetic,112,30912956,99.6281270846,_100,8,>100
14110,gardener,112,30913068,99.6284880449,_100,8,>100
14111,sliders,112,30913180,99.6288490052,_100,7,>100
14112,nikki,112,30913292,99.6292099655,_100,5,>100
14113,submission,112,30913404,99.6295709258,_100,10,>100
14114,ovechkin,112,30913516,99.6299318861,_100,8,>100
14115,nokia,112,30913628,99.6302928465,_100,5,>100
14116,abdomen,112,30913740,99.6306538068,_100,7,>100
14117,suzuki,112,30913852,99.6310147671,_100,6,>100
14118,emerald,112,30913964,99.6313757274,_100,7,>100
14119,exposition,112,30914076,99.6317366877,_100,10,>100
14120,capitalism,112,30914188,99.632097648,_100,10,>100
14121,caterpillar,112,30914300,99.6324586083,_100,11,>100
14122,calmly,112,30914412,99.6328195686,_100,6,>100
14123,handwritten,112,30914524,99.6331805289,_100,11,>100
14124,tulowitzki,112,30914636,99.6335414893,_100,10,>100
14125,levied,112,30914748,99.6339024496,_100,6,>100
14126,timeless,112,30914860,99.6342634099,_100,8,>100
14127,shumpert,112,30914972,99.6346243702,_100,8,>100
14128,regulating,112,30915084,99.6349853305,_100,10,>100
14129,112,112,30915196,99.6353462908,_100,3,>100
14130,utter,112,30915308,99.6357072511,_100,5,>100
14131,jolie,112,30915420,99.6360682114,_100,5,>100
14132,midterm,112,30915532,99.6364291718,_100,7,>100
14133,dougherty,112,30915644,99.6367901321,_100,9,>100
14134,rosario,112,30915756,99.6371510924,_100,7,>100
14135,forbidden,112,30915868,99.6375120527,_100,9,>100
14136,bouquet,112,30915980,99.637873013,_100,7,>100
14137,melody,112,30916092,99.6382339733,_100,6,>100
14138,cheat,112,30916204,99.6385949336,_100,5,>100
14139,cos,112,30916316,99.6389558939,_100,3,>100
14140,maritime,112,30916428,99.6393168542,_100,8,>100
14141,doris,112,30916540,99.6396778146,_100,5,>100
14142,deliveries,112,30916652,99.6400387749,_100,10,>100
14143,pastors,112,30916764,99.6403997352,_100,7,>100
14144,dissident,112,30916876,99.6407606955,_100,9,>100
14145,reproductive,112,30916988,99.6411216558,_100,12,>100
14146,hewitt,112,30917100,99.6414826161,_100,6,>100
14147,111,111,30917211,99.6418403536,_100,3,>100
14148,thad,111,30917322,99.642198091,_100,4,>100
14149,perseverance,111,30917433,99.6425558285,_100,12,>100
14150,implied,111,30917544,99.6429135659,_100,7,>100
14151,bash,111,30917655,99.6432713034,_100,4,>100
14152,outshot,111,30917766,99.6436290408,_100,7,>100
14153,bureaucrats,111,30917877,99.6439867783,_100,11,>100
14154,commenting,111,30917988,99.6443445157,_100,10,>100
14155,restriction,111,30918099,99.6447022532,_100,11,>100
14156,yuma,111,30918210,99.6450599906,_100,4,>100
14157,seekers,111,30918321,99.6454177281,_100,7,>100
14158,seymour,111,30918432,99.6457754655,_100,7,>100
14159,gigs,111,30918543,99.646133203,_100,4,>100
14160,gracious,111,30918654,99.6464909404,_100,8,>100
14161,blueberries,111,30918765,99.6468486779,_100,11,>100
14162,edible,111,30918876,99.6472064153,_100,6,>100
14163,klamath,111,30918987,99.6475641528,_100,7,>100
14164,fedex,111,30919098,99.6479218903,_100,5,>100
14165,reliability,111,30919209,99.6482796277,_100,11,>100
14166,depressing,111,30919320,99.6486373652,_100,10,>100
14167,novelty,111,30919431,99.6489951026,_100,7,>100
14168,swipe,111,30919542,99.6493528401,_100,5,>100
14169,siegel,111,30919653,99.6497105775,_100,6,>100
14170,hauling,111,30919764,99.650068315,_100,7,>100
14171,stamping,111,30919875,99.6504260524,_100,8,>100
14172,demarco,111,30919986,99.6507837899,_100,7,>100
14173,treadmill,111,30920097,99.6511415273,_100,9,>100
14174,riverfront,111,30920208,99.6514992648,_100,10,>100
14175,knockout,111,30920319,99.6518570022,_100,8,>100
14176,wheating,111,30920430,99.6522147397,_100,8,>100
14177,mansfield,111,30920541,99.6525724771,_100,9,>100
14178,poise,111,30920652,99.6529302146,_100,5,>100
14179,lakeside,111,30920763,99.653287952,_100,8,>100
14180,reign,111,30920874,99.6536456895,_100,5,>100
14181,wrestle,111,30920985,99.6540034269,_100,7,>100
14182,rubbed,111,30921096,99.6543611644,_100,6,>100
14183,meadow,111,30921207,99.6547189018,_100,6,>100
14184,excursion,111,30921318,99.6550766393,_100,9,>100
14185,dina,111,30921429,99.6554343767,_100,4,>100
14186,crepes,111,30921540,99.6557921142,_100,6,>100
14187,ecosystem,111,30921651,99.6561498516,_100,9,>100
14188,recruiter,111,30921762,99.6565075891,_100,9,>100
14189,moe,111,30921873,99.6568653265,_100,3,>100
14190,redondo,111,30921984,99.657223064,_100,7,>100
14191,forfeit,111,30922095,99.6575808014,_100,7,>100
14192,okla,111,30922206,99.6579385389,_100,4,>100
14193,rocker,111,30922317,99.6582962764,_100,6,>100
14194,flawless,111,30922428,99.6586540138,_100,8,>100
14195,dempsey,111,30922539,99.6590117513,_100,7,>100
14196,renters,111,30922650,99.6593694887,_100,7,>100
14197,teamwork,111,30922761,99.6597272262,_100,8,>100
14198,constructive,111,30922872,99.6600849636,_100,12,>100
14199,orton,111,30922983,99.6604427011,_100,5,>100
14200,fluke,111,30923094,99.6608004385,_100,5,>100
14201,algae,111,30923205,99.661158176,_100,5,>100
14202,greeley,111,30923316,99.6615159134,_100,7,>100
14203,alexandra,111,30923427,99.6618736509,_100,9,>100
14204,carve,111,30923538,99.6622313883,_100,5,>100
14205,doan,111,30923649,99.6625891258,_100,4,>100
14206,wired,111,30923760,99.6629468632,_100,5,>100
14207,poke,111,30923871,99.6633046007,_100,4,>100
14208,whitfield,111,30923982,99.6636623381,_100,9,>100
14209,seriousness,111,30924093,99.6640200756,_100,11,>100
14210,furloughs,111,30924204,99.664377813,_100,9,>100
14211,javelin,111,30924315,99.6647355505,_100,7,>100
14212,intimacy,111,30924426,99.6650932879,_100,8,>100
14213,curtail,110,30924536,99.6654478025,_100,7,>100
14214,asbestos,110,30924646,99.6658023171,_100,8,>100
14215,nominate,110,30924756,99.6661568317,_100,8,>100
14216,boozer,110,30924866,99.6665113463,_100,6,>100
14217,ramifications,110,30924976,99.6668658609,_100,13,>100
14218,tremendously,110,30925086,99.6672203755,_100,12,>100
14219,orthodox,110,30925196,99.6675748901,_100,8,>100
14220,finisher,110,30925306,99.6679294047,_100,8,>100
14221,dunham,110,30925416,99.6682839193,_100,6,>100
14222,calculation,110,30925526,99.6686384339,_100,11,>100
14223,diehl,110,30925636,99.6689929484,_100,5,>100
14224,catonsville,110,30925746,99.669347463,_100,11,>100
14225,wellington,110,30925856,99.6697019776,_100,10,>100
14226,inject,110,30925966,99.6700564922,_100,6,>100
14227,casket,110,30926076,99.6704110068,_100,6,>100
14228,objection,110,30926186,99.6707655214,_100,9,>100
14229,lamp,110,30926296,99.671120036,_100,4,>100
14230,addicts,110,30926406,99.6714745506,_100,7,>100
14231,catfish,110,30926516,99.6718290652,_100,7,>100
14232,supplying,110,30926626,99.6721835798,_100,9,>100
14233,syndicated,110,30926736,99.6725380944,_100,10,>100
14234,110,110,30926846,99.672892609,_100,3,>100
14235,toilets,110,30926956,99.6732471235,_100,7,>100
14236,refineries,110,30927066,99.6736016381,_100,10,>100
14237,violet,110,30927176,99.6739561527,_100,6,>100
14238,rout,110,30927286,99.6743106673,_100,4,>100
14239,spikes,110,30927396,99.6746651819,_100,6,>100
14240,slamming,110,30927506,99.6750196965,_100,8,>100
14241,fiscally,110,30927616,99.6753742111,_100,8,>100
14242,beleaguered,110,30927726,99.6757287257,_100,11,>100
14243,inactive,110,30927836,99.6760832403,_100,8,>100
14244,grimm,110,30927946,99.6764377549,_100,5,>100
14245,darlington,110,30928056,99.6767922695,_100,10,>100
14246,afterthought,110,30928166,99.6771467841,_100,12,>100
14247,migrants,110,30928276,99.6775012987,_100,8,>100
14248,beethoven,110,30928386,99.6778558132,_100,9,>100
14249,corbett,110,30928496,99.6782103278,_100,7,>100
14250,oasis,110,30928606,99.6785648424,_100,5,>100
14251,yr,110,30928716,99.678919357,_100,2,>100
14252,incarceration,110,30928826,99.6792738716,_100,13,>100
14253,precautions,110,30928936,99.6796283862,_100,11,>100
14254,rolle,110,30929046,99.6799829008,_100,5,>100
14255,praising,110,30929156,99.6803374154,_100,8,>100
14256,repercussions,110,30929266,99.68069193,_100,13,>100
14257,discusses,110,30929376,99.6810464446,_100,9,>100
14258,payrolls,110,30929486,99.6814009592,_100,8,>100
14259,eccentric,110,30929596,99.6817554738,_100,9,>100
14260,erica,110,30929706,99.6821099883,_100,5,>100
14261,faried,110,30929816,99.6824645029,_100,6,>100
14262,armour,110,30929926,99.6828190175,_100,6,>100
14263,returner,110,30930036,99.6831735321,_100,8,>100
14264,reversing,110,30930146,99.6835280467,_100,9,>100
14265,conditional,110,30930256,99.6838825613,_100,11,>100
14266,parkinson,110,30930366,99.6842370759,_100,9,>100
14267,hay,110,30930476,99.6845915905,_100,3,>100
14268,punter,110,30930586,99.6849461051,_100,6,>100
14269,bashar,110,30930696,99.6853006197,_100,6,>100
14270,fugitives,110,30930806,99.6856551343,_100,9,>100
14271,blazer,110,30930916,99.6860096489,_100,6,>100
14272,crist,110,30931026,99.6863641634,_100,5,>100
14273,payback,110,30931136,99.686718678,_100,7,>100
14274,resemblance,110,30931246,99.6870731926,_100,11,>100
14275,saddled,110,30931356,99.6874277072,_100,7,>100
14276,cooperated,110,30931466,99.6877822218,_100,10,>100
14277,somalia,110,30931576,99.6881367364,_100,7,>100
14278,fashioned,110,30931686,99.688491251,_100,9,>100
14279,deutsche,110,30931796,99.6888457656,_100,8,>100
14280,stressing,110,30931906,99.6892002802,_100,9,>100
14281,tulsa,110,30932016,99.6895547948,_100,5,>100
14282,choreographed,110,30932126,99.6899093094,_100,13,>100
14283,fraternity,110,30932236,99.690263824,_100,10,>100
14284,villaraigosa,110,30932346,99.6906183385,_100,12,>100
14285,nestled,110,30932456,99.6909728531,_100,7,>100
14286,defiant,110,30932566,99.6913273677,_100,7,>100
14287,darius,110,30932676,99.6916818823,_100,6,>100
14288,impromptu,110,30932786,99.6920363969,_100,9,>100
14289,overruns,110,30932896,99.6923909115,_100,8,>100
14290,philharmonic,110,30933006,99.6927454261,_100,12,>100
14291,servant,110,30933116,99.6930999407,_100,7,>100
14292,stoppage,110,30933226,99.6934544553,_100,8,>100
14293,crowned,110,30933336,99.6938089699,_100,7,>100
14294,sioux,109,30933445,99.6941602616,_100,5,>100
14295,nonmembers,109,30933554,99.6945115533,_100,10,>100
14296,homecoming,109,30933663,99.6948628451,_100,10,>100
14297,upstate,109,30933772,99.6952141368,_100,7,>100
14298,eco,109,30933881,99.6955654285,_100,3,>100
14299,forgo,109,30933990,99.6959167203,_100,5,>100
14300,autonomy,109,30934099,99.696268012,_100,8,>100
14301,suppress,109,30934208,99.6966193037,_100,8,>100
14302,cypress,109,30934317,99.6969705955,_100,7,>100
14303,railing,109,30934426,99.6973218872,_100,7,>100
14304,mmpi,109,30934535,99.6976731789,_100,4,>100
14305,decreasing,109,30934644,99.6980244707,_100,10,>100
14306,diamonds,109,30934753,99.6983757624,_100,8,>100
14307,christy,109,30934862,99.6987270541,_100,7,>100
14308,broadview,109,30934971,99.6990783459,_100,9,>100
14309,procession,109,30935080,99.6994296376,_100,10,>100
14310,unearned,109,30935189,99.6997809293,_100,8,>100
14311,submerged,109,30935298,99.7001322211,_100,9,>100
14312,bach,109,30935407,99.7004835128,_100,4,>100
14313,attrition,109,30935516,99.7008348045,_100,9,>100
14314,arranging,109,30935625,99.7011860962,_100,9,>100
14315,pleasing,109,30935734,99.701537388,_100,8,>100
14316,contrasts,109,30935843,99.7018886797,_100,9,>100
14317,striped,109,30935952,99.7022399714,_100,7,>100
14318,exploited,109,30936061,99.7025912632,_100,9,>100
14319,fearing,109,30936170,99.7029425549,_100,7,>100
14320,geary,109,30936279,99.7032938466,_100,5,>100
14321,uniquely,109,30936388,99.7036451384,_100,8,>100
14322,stared,109,30936497,99.7039964301,_100,6,>100
14323,damp,109,30936606,99.7043477218,_100,4,>100
14324,greenspan,109,30936715,99.7046990136,_100,9,>100
14325,fir,109,30936824,99.7050503053,_100,3,>100
14326,doubted,109,30936933,99.705401597,_100,7,>100
14327,shores,109,30937042,99.7057528888,_100,6,>100
14328,hough,109,30937151,99.7061041805,_100,5,>100
14329,geneva,109,30937260,99.7064554722,_100,6,>100
14330,hungary,109,30937369,99.706806764,_100,7,>100
14331,lopsided,109,30937478,99.7071580557,_100,8,>100
14332,circulating,109,30937587,99.7075093474,_100,11,>100
14333,richie,109,30937696,99.7078606392,_100,6,>100
14334,palms,109,30937805,99.7082119309,_100,5,>100
14335,blasting,109,30937914,99.7085632226,_100,8,>100
14336,disappearing,109,30938023,99.7089145143,_100,12,>100
14337,lotus,109,30938132,99.7092658061,_100,5,>100
14338,ned,109,30938241,99.7096170978,_100,3,>100
14339,banged,109,30938350,99.7099683895,_100,6,>100
14340,godinez,109,30938459,99.7103196813,_100,7,>100
14341,wrongly,109,30938568,99.710670973,_100,7,>100
14342,universally,109,30938677,99.7110222647,_100,11,>100
14343,complying,109,30938786,99.7113735565,_100,9,>100
14344,taps,109,30938895,99.7117248482,_100,4,>100
14345,superstars,109,30939004,99.7120761399,_100,10,>100
14346,forgiven,109,30939113,99.7124274317,_100,8,>100
14347,richter,109,30939222,99.7127787234,_100,7,>100
14348,motorsports,109,30939331,99.7131300151,_100,11,>100
14349,er,109,30939440,99.7134813069,_100,2,>100
14350,gould,109,30939549,99.7138325986,_100,5,>100
14351,landslide,109,30939658,99.7141838903,_100,9,>100
14352,sonny,109,30939767,99.7145351821,_100,5,>100
14353,proponent,109,30939876,99.7148864738,_100,9,>100
14354,visibly,109,30939985,99.7152377655,_100,7,>100
14355,cocoa,109,30940094,99.7155890573,_100,5,>100
14356,mayhem,109,30940203,99.715940349,_100,6,>100
14357,patriotic,109,30940312,99.7162916407,_100,9,>100
14358,tin,109,30940421,99.7166429325,_100,3,>100
14359,banging,109,30940530,99.7169942242,_100,7,>100
14360,bookstores,109,30940639,99.7173455159,_100,10,>100
14361,bubba,109,30940748,99.7176968076,_100,5,>100
14362,abducted,109,30940857,99.7180480994,_100,8,>100
14363,curveball,109,30940966,99.7183993911,_100,9,>100
14364,109,109,30941075,99.7187506828,_100,3,>100
14365,gronkowski,109,30941184,99.7191019746,_100,10,>100
14366,disagrees,109,30941293,99.7194532663,_100,9,>100
14367,commencement,109,30941402,99.719804558,_100,12,>100
14368,manipulate,109,30941511,99.7201558498,_100,10,>100
14369,soprano,109,30941620,99.7205071415,_100,7,>100
14370,prejudice,109,30941729,99.7208584332,_100,9,>100
14371,erosion,109,30941838,99.721209725,_100,7,>100
14372,transcripts,108,30941946,99.7215577938,_100,11,>100
14373,reset,108,30942054,99.7219058627,_100,5,>100
14374,mole,108,30942162,99.7222539316,_100,4,>100
14375,canceling,108,30942270,99.7226020005,_100,9,>100
14376,impulse,108,30942378,99.7229500693,_100,7,>100
14377,apache,108,30942486,99.7232981382,_100,6,>100
14378,cranberries,108,30942594,99.7236462071,_100,11,>100
14379,leach,108,30942702,99.7239942759,_100,5,>100
14380,powerball,108,30942810,99.7243423448,_100,9,>100
14381,spilling,108,30942918,99.7246904137,_100,8,>100
14382,pomegranate,108,30943026,99.7250384826,_100,11,>100
14383,genetically,108,30943134,99.7253865514,_100,11,>100
14384,airy,108,30943242,99.7257346203,_100,4,>100
14385,rendering,108,30943350,99.7260826892,_100,9,>100
14386,hillman,108,30943458,99.726430758,_100,7,>100
14387,billionaires,108,30943566,99.7267788269,_100,12,>100
14388,blu,108,30943674,99.7271268958,_100,3,>100
14389,108,108,30943782,99.7274749647,_100,3,>100
14390,circled,108,30943890,99.7278230335,_100,7,>100
14391,dwell,108,30943998,99.7281711024,_100,5,>100
14392,spoiled,108,30944106,99.7285191713,_100,7,>100
14393,invaluable,108,30944214,99.7288672402,_100,10,>100
14394,sufficiently,108,30944322,99.729215309,_100,12,>100
14395,radius,108,30944430,99.7295633779,_100,6,>100
14396,sweetheart,108,30944538,99.7299114468,_100,10,>100
14397,concordia,108,30944646,99.7302595156,_100,9,>100
14398,prepaid,108,30944754,99.7306075845,_100,7,>100
14399,cherished,108,30944862,99.7309556534,_100,9,>100
14400,decreases,108,30944970,99.7313037223,_100,9,>100
14401,resonate,108,30945078,99.7316517911,_100,8,>100
14402,shattenkirk,108,30945186,99.73199986,_100,11,>100
14403,consultation,108,30945294,99.7323479289,_100,12,>100
14404,peralta,108,30945402,99.7326959977,_100,7,>100
14405,sawyer,108,30945510,99.7330440666,_100,6,>100
14406,redfern,108,30945618,99.7333921355,_100,7,>100
14407,swimmers,108,30945726,99.7337402044,_100,8,>100
14408,falcon,108,30945834,99.7340882732,_100,6,>100
14409,manipulated,108,30945942,99.7344363421,_100,11,>100
14410,rundown,108,30946050,99.734784411,_100,7,>100
14411,vitals,108,30946158,99.7351324798,_100,6,>100
14412,amr,108,30946266,99.7354805487,_100,3,>100
14413,retreated,108,30946374,99.7358286176,_100,9,>100
14414,rhubarb,108,30946482,99.7361766865,_100,7,>100
14415,enrichment,108,30946590,99.7365247553,_100,10,>100
14416,mcclain,108,30946698,99.7368728242,_100,7,>100
14417,djs,108,30946806,99.7372208931,_100,3,>100
14418,desmet,108,30946914,99.737568962,_100,6,>100
14419,lionel,108,30947022,99.7379170308,_100,6,>100
14420,backbone,108,30947130,99.7382650997,_100,8,>100
14421,angelina,108,30947238,99.7386131686,_100,8,>100
14422,audubon,108,30947346,99.7389612374,_100,7,>100
14423,nerinx,108,30947454,99.7393093063,_100,6,>100
14424,plastics,108,30947562,99.7396573752,_100,8,>100
14425,contingency,108,30947670,99.7400054441,_100,11,>100
14426,vaguely,108,30947778,99.7403535129,_100,7,>100
14427,resilience,108,30947886,99.7407015818,_100,10,>100
14428,headlined,108,30947994,99.7410496507,_100,9,>100
14429,removes,108,30948102,99.7413977195,_100,7,>100
14430,hopped,108,30948210,99.7417457884,_100,6,>100
14431,huddled,108,30948318,99.7420938573,_100,7,>100
14432,tactical,108,30948426,99.7424419262,_100,8,>100
14433,artisan,108,30948534,99.742789995,_100,7,>100
14434,disparate,108,30948642,99.7431380639,_100,9,>100
14435,clusters,108,30948750,99.7434861328,_100,8,>100
14436,preserves,108,30948858,99.7438342016,_100,9,>100
14437,peruvian,108,30948966,99.7441822705,_100,8,>100
14438,guggenheim,108,30949074,99.7445303394,_100,10,>100
14439,convict,108,30949182,99.7448784083,_100,7,>100
14440,callers,108,30949290,99.7452264771,_100,7,>100
14441,enrolling,108,30949398,99.745574546,_100,9,>100
14442,attachment,108,30949506,99.7459226149,_100,10,>100
14443,cinematic,108,30949614,99.7462706838,_100,9,>100
14444,bridgewater,108,30949722,99.7466187526,_100,11,>100
14445,rockefeller,108,30949830,99.7469668215,_100,11,>100
14446,waikiki,108,30949938,99.7473148904,_100,7,>100
14447,rossi,108,30950046,99.7476629592,_100,5,>100
14448,justification,108,30950154,99.7480110281,_100,13,>100
14449,thrived,108,30950262,99.748359097,_100,7,>100
14450,splits,108,30950370,99.7487071659,_100,6,>100
14451,stainless,108,30950478,99.7490552347,_100,9,>100
14452,criminally,108,30950586,99.7494033036,_100,10,>100
14453,friendships,108,30950694,99.7497513725,_100,11,>100
14454,ruben,108,30950802,99.7500994413,_100,5,>100
14455,hillsborough,108,30950910,99.7504475102,_100,12,>100
14456,bicyclists,107,30951017,99.7507923562,_100,10,>100
14457,charcoal,107,30951124,99.7511372022,_100,8,>100
14458,alignment,107,30951231,99.7514820483,_100,9,>100
14459,naacp,107,30951338,99.7518268943,_100,5,>100
14460,beacon,107,30951445,99.7521717403,_100,6,>100
14461,resembled,107,30951552,99.7525165863,_100,9,>100
14462,wildfire,107,30951659,99.7528614323,_100,8,>100
14463,calculating,107,30951766,99.7532062783,_100,11,>100
14464,irvin,107,30951873,99.7535511243,_100,5,>100
14465,withdrawals,107,30951980,99.7538959703,_100,11,>100
14466,declares,107,30952087,99.7542408163,_100,8,>100
14467,tractor,107,30952194,99.7545856624,_100,7,>100
14468,workload,107,30952301,99.7549305084,_100,8,>100
14469,template,107,30952408,99.7552753544,_100,8,>100
14470,jealous,107,30952515,99.7556202004,_100,7,>100
14471,goucher,107,30952622,99.7559650464,_100,7,>100
14472,107,107,30952729,99.7563098924,_100,3,>100
14473,liking,107,30952836,99.7566547384,_100,6,>100
14474,andersen,107,30952943,99.7569995844,_100,8,>100
14475,disadvantaged,107,30953050,99.7573444305,_100,13,>100
14476,acceleration,107,30953157,99.7576892765,_100,12,>100
14477,ridership,107,30953264,99.7580341225,_100,9,>100
14478,patiently,107,30953371,99.7583789685,_100,9,>100
14479,rpg,107,30953478,99.7587238145,_100,3,>100
14480,turbulent,107,30953585,99.7590686605,_100,9,>100
14481,depleted,107,30953692,99.7594135065,_100,8,>100
14482,vigilant,107,30953799,99.7597583525,_100,8,>100
14483,confinement,107,30953906,99.7601031986,_100,11,>100
14484,kyrillos,107,30954013,99.7604480446,_100,8,>100
14485,disagreements,107,30954120,99.7607928906,_100,13,>100
14486,quipped,107,30954227,99.7611377366,_100,7,>100
14487,capita,107,30954334,99.7614825826,_100,6,>100
14488,deteriorating,107,30954441,99.7618274286,_100,13,>100
14489,marley,107,30954548,99.7621722746,_100,6,>100
14490,rethink,107,30954655,99.7625171206,_100,7,>100
14491,picturesque,107,30954762,99.7628619666,_100,11,>100
14492,citi,107,30954869,99.7632068127,_100,4,>100
14493,arroyo,107,30954976,99.7635516587,_100,6,>100
14494,propel,107,30955083,99.7638965047,_100,6,>100
14495,absorbing,107,30955190,99.7642413507,_100,9,>100
14496,geese,107,30955297,99.7645861967,_100,5,>100
14497,breeds,107,30955404,99.7649310427,_100,6,>100
14498,backwards,107,30955511,99.7652758887,_100,9,>100
14499,swollen,107,30955618,99.7656207347,_100,7,>100
14500,drift,107,30955725,99.7659655808,_100,5,>100
14501,jen,107,30955832,99.7663104268,_100,3,>100
14502,darling,107,30955939,99.7666552728,_100,7,>100
14503,moreland,107,30956046,99.7670001188,_100,8,>100
14504,soliciting,107,30956153,99.7673449648,_100,10,>100
14505,internship,107,30956260,99.7676898108,_100,10,>100
14506,tamales,107,30956367,99.7680346568,_100,7,>100
14507,kanye,107,30956474,99.7683795028,_100,5,>100
14508,detached,107,30956581,99.7687243489,_100,8,>100
14509,ancestors,107,30956688,99.7690691949,_100,9,>100
14510,cusack,107,30956795,99.7694140409,_100,6,>100
14511,ike,107,30956902,99.7697588869,_100,3,>100
14512,succeeding,107,30957009,99.7701037329,_100,10,>100
14513,putnam,107,30957116,99.7704485789,_100,6,>100
14514,drying,107,30957223,99.7707934249,_100,6,>100
14515,arenas,107,30957330,99.7711382709,_100,6,>100
14516,medically,107,30957437,99.771483117,_100,9,>100
14517,aggression,107,30957544,99.771827963,_100,10,>100
14518,irresistible,107,30957651,99.772172809,_100,12,>100
14519,kershaw,107,30957758,99.772517655,_100,7,>100
14520,proportions,107,30957865,99.772862501,_100,11,>100
14521,afl,107,30957972,99.773207347,_100,3,>100
14522,sacrificed,107,30958079,99.773552193,_100,10,>100
14523,whispered,107,30958186,99.773897039,_100,9,>100
14524,inspires,107,30958293,99.774241885,_100,8,>100
14525,solicit,107,30958400,99.7745867311,_100,7,>100
14526,wrestlers,107,30958507,99.7749315771,_100,9,>100
14527,watchers,107,30958614,99.7752764231,_100,8,>100
14528,restructure,107,30958721,99.7756212691,_100,11,>100
14529,koster,107,30958828,99.7759661151,_100,6,>100
14530,flooring,107,30958935,99.7763109611,_100,8,>100
14531,baum,107,30959042,99.7766558071,_100,4,>100
14532,boosters,107,30959149,99.7770006531,_100,8,>100
14533,selective,107,30959256,99.7773454992,_100,9,>100
14534,disappoint,107,30959363,99.7776903452,_100,10,>100
14535,dove,107,30959470,99.7780351912,_100,4,>100
14536,hauled,107,30959577,99.7783800372,_100,6,>100
14537,trusting,107,30959684,99.7787248832,_100,8,>100
14538,garner,107,30959791,99.7790697292,_100,6,>100
14539,crippling,107,30959898,99.7794145752,_100,9,>100
14540,bullock,107,30960005,99.7797594212,_100,7,>100
14541,outfitted,106,30960111,99.7801010444,_100,9,>100
14542,maher,106,30960217,99.7804426675,_100,5,>100
14543,shortfalls,106,30960323,99.7807842907,_100,10,>100
14544,cartoons,106,30960429,99.7811259138,_100,8,>100
14545,friction,106,30960535,99.781467537,_100,8,>100
14546,upsets,106,30960641,99.7818091602,_100,6,>100
14547,106,106,30960747,99.7821507833,_100,3,>100
14548,initiate,106,30960853,99.7824924065,_100,8,>100
14549,impatient,106,30960959,99.7828340296,_100,9,>100
14550,boating,106,30961065,99.7831756528,_100,7,>100
14551,stocking,106,30961171,99.7835172759,_100,8,>100
14552,carmichael,106,30961277,99.7838588991,_100,10,>100
14553,fillmore,106,30961383,99.7842005222,_100,8,>100
14554,intern,106,30961489,99.7845421454,_100,6,>100
14555,lerner,106,30961595,99.7848837685,_100,6,>100
14556,sous,106,30961701,99.7852253917,_100,4,>100
14557,silently,106,30961807,99.7855670148,_100,8,>100
14558,remarked,106,30961913,99.785908638,_100,8,>100
14559,lakefront,106,30962019,99.7862502611,_100,9,>100
14560,ratepayers,106,30962125,99.7865918843,_100,10,>100
14561,birthplace,106,30962231,99.7869335074,_100,10,>100
14562,rampage,106,30962337,99.7872751306,_100,7,>100
14563,lava,106,30962443,99.7876167537,_100,4,>100
14564,detour,106,30962549,99.7879583769,_100,6,>100
14565,duct,106,30962655,99.7883,_100,4,>100
14566,portraying,106,30962761,99.7886416232,_100,10,>100
14567,accredited,106,30962867,99.7889832463,_100,10,>100
14568,accord,106,30962973,99.7893248695,_100,6,>100
14569,muddy,106,30963079,99.7896664927,_100,5,>100
14570,rand,106,30963185,99.7900081158,_100,4,>100
14571,sanitation,106,30963291,99.790349739,_100,10,>100
14572,natives,106,30963397,99.7906913621,_100,7,>100
14573,phased,106,30963503,99.7910329853,_100,6,>100
14574,philanthropist,106,30963609,99.7913746084,_100,14,>100
14575,whiting,106,30963715,99.7917162316,_100,7,>100
14576,sigh,106,30963821,99.7920578547,_100,4,>100
14577,pitino,106,30963927,99.7923994779,_100,6,>100
14578,taxation,106,30964033,99.792741101,_100,8,>100
14579,vow,106,30964139,99.7930827242,_100,3,>100
14580,harmless,106,30964245,99.7934243473,_100,8,>100
14581,piling,106,30964351,99.7937659705,_100,6,>100
14582,limbo,106,30964457,99.7941075936,_100,5,>100
14583,sal,106,30964563,99.7944492168,_100,3,>100
14584,javier,106,30964669,99.7947908399,_100,6,>100
14585,vineland,106,30964775,99.7951324631,_100,8,>100
14586,portrays,106,30964881,99.7954740862,_100,8,>100
14587,barnabas,106,30964987,99.7958157094,_100,8,>100
14588,kiley,106,30965093,99.7961573325,_100,5,>100
14589,artichokes,106,30965199,99.7964989557,_100,10,>100
14590,contra,106,30965305,99.7968405788,_100,6,>100
14591,brigham,106,30965411,99.797182202,_100,7,>100
14592,awaited,106,30965517,99.7975238252,_100,7,>100
14593,storing,106,30965623,99.7978654483,_100,7,>100
14594,terrelle,106,30965729,99.7982070715,_100,8,>100
14595,tick,106,30965835,99.7985486946,_100,4,>100
14596,yang,106,30965941,99.7988903178,_100,4,>100
14597,cheek,106,30966047,99.7992319409,_100,5,>100
14598,gearing,106,30966153,99.7995735641,_100,7,>100
14599,alderman,106,30966259,99.7999151872,_100,8,>100
14600,overcoming,106,30966365,99.8002568104,_100,10,>100
14601,roommates,106,30966471,99.8005984335,_100,9,>100
14602,mattress,106,30966577,99.8009400567,_100,8,>100
14603,taft,106,30966683,99.8012816798,_100,4,>100
14604,dion,106,30966789,99.801623303,_100,4,>100
14605,yeast,106,30966895,99.8019649261,_100,5,>100
14606,surcharge,106,30967001,99.8023065493,_100,9,>100
14607,emory,106,30967107,99.8026481724,_100,5,>100
14608,melanoma,106,30967213,99.8029897956,_100,8,>100
14609,precaution,106,30967319,99.8033314187,_100,10,>100
14610,budweiser,106,30967425,99.8036730419,_100,9,>100
14611,perspectives,106,30967531,99.804014665,_100,12,>100
14612,elbows,106,30967637,99.8043562882,_100,6,>100
14613,glamour,106,30967743,99.8046979113,_100,7,>100
14614,clown,106,30967849,99.8050395345,_100,5,>100
14615,huffman,106,30967955,99.8053811577,_100,7,>100
14616,vegetation,106,30968061,99.8057227808,_100,10,>100
14617,adulthood,106,30968167,99.806064404,_100,9,>100
14618,nutty,106,30968273,99.8064060271,_100,5,>100
14619,mastered,106,30968379,99.8067476503,_100,8,>100
14620,sprayed,106,30968485,99.8070892734,_100,7,>100
14621,jessie,106,30968591,99.8074308966,_100,6,>100
14622,pitted,106,30968697,99.8077725197,_100,6,>100
14623,arabic,105,30968802,99.80811092,_100,6,>100
14624,fractures,105,30968907,99.8084493203,_100,9,>100
14625,pinkel,105,30969012,99.8087877206,_100,6,>100
14626,publicist,105,30969117,99.8091261209,_100,9,>100
14627,quentin,105,30969222,99.8094645212,_100,7,>100
14628,notched,105,30969327,99.8098029215,_100,7,>100
14629,exhaust,105,30969432,99.8101413218,_100,7,>100
14630,pines,105,30969537,99.8104797221,_100,5,>100
14631,rehearsals,105,30969642,99.8108181223,_100,10,>100
14632,loveland,105,30969747,99.8111565226,_100,8,>100
14633,unrealistic,105,30969852,99.8114949229,_100,11,>100
14634,rory,105,30969957,99.8118333232,_100,4,>100
14635,subpoenas,105,30970062,99.8121717235,_100,9,>100
14636,darwin,105,30970167,99.8125101238,_100,6,>100
14637,grille,105,30970272,99.8128485241,_100,6,>100
14638,speculative,105,30970377,99.8131869244,_100,11,>100
14639,taser,105,30970482,99.8135253247,_100,5,>100
14640,mcdaniels,105,30970587,99.813863725,_100,9,>100
14641,leash,105,30970692,99.8142021253,_100,5,>100
14642,thwart,105,30970797,99.8145405256,_100,6,>100
14643,105,105,30970902,99.8148789259,_100,3,>100
14644,restricting,105,30971007,99.8152173261,_100,11,>100
14645,gerry,105,30971112,99.8155557264,_100,5,>100
14646,stormwater,105,30971217,99.8158941267,_100,10,>100
14647,comerica,105,30971322,99.816232527,_100,8,>100
14648,hahn,105,30971427,99.8165709273,_100,4,>100
14649,ph,105,30971532,99.8169093276,_100,2,>100
14650,ignorance,105,30971637,99.8172477279,_100,9,>100
14651,extremists,105,30971742,99.8175861282,_100,10,>100
14652,verbally,105,30971847,99.8179245285,_100,8,>100
14653,arrieta,105,30971952,99.8182629288,_100,7,>100
14654,internally,105,30972057,99.8186013291,_100,10,>100
14655,gabrielle,105,30972162,99.8189397294,_100,9,>100
14656,fema,105,30972267,99.8192781297,_100,4,>100
14657,suspense,105,30972372,99.8196165299,_100,8,>100
14658,striving,105,30972477,99.8199549302,_100,8,>100
14659,annan,105,30972582,99.8202933305,_100,5,>100
14660,rucker,105,30972687,99.8206317308,_100,6,>100
14661,oberlin,105,30972792,99.8209701311,_100,7,>100
14662,giddy,105,30972897,99.8213085314,_100,5,>100
14663,impressions,105,30973002,99.8216469317,_100,11,>100
14664,wheaton,105,30973107,99.821985332,_100,7,>100
14665,umdnj,105,30973212,99.8223237323,_100,5,>100
14666,entrepreneurship,105,30973317,99.8226621326,_100,16,>100
14667,repealed,105,30973422,99.8230005329,_100,8,>100
14668,mccaskill,105,30973527,99.8233389332,_100,9,>100
14669,defect,105,30973632,99.8236773335,_100,6,>100
14670,ahmed,105,30973737,99.8240157337,_100,5,>100
14671,arrogance,105,30973842,99.824354134,_100,9,>100
14672,anton,105,30973947,99.8246925343,_100,5,>100
14673,portage,105,30974052,99.8250309346,_100,7,>100
14674,bombings,105,30974157,99.8253693349,_100,8,>100
14675,graceful,105,30974262,99.8257077352,_100,8,>100
14676,acosta,105,30974367,99.8260461355,_100,6,>100
14677,missteps,105,30974472,99.8263845358,_100,8,>100
14678,tribunal,105,30974577,99.8267229361,_100,8,>100
14679,useless,105,30974682,99.8270613364,_100,7,>100
14680,sweating,105,30974787,99.8273997367,_100,8,>100
14681,fluids,105,30974892,99.827738137,_100,6,>100
14682,dogged,105,30974997,99.8280765373,_100,6,>100
14683,attribute,105,30975102,99.8284149375,_100,9,>100
14684,pau,105,30975207,99.8287533378,_100,3,>100
14685,byu,105,30975312,99.8290917381,_100,3,>100
14686,pep,105,30975417,99.8294301384,_100,3,>100
14687,vcu,105,30975522,99.8297685387,_100,3,>100
14688,nitrogen,105,30975627,99.830106939,_100,8,>100
14689,naples,105,30975732,99.8304453393,_100,6,>100
14690,pedigree,105,30975837,99.8307837396,_100,8,>100
14691,fray,105,30975942,99.8311221399,_100,4,>100
14692,transporting,105,30976047,99.8314605402,_100,12,>100
14693,pennies,105,30976152,99.8317989405,_100,7,>100
14694,scratching,105,30976257,99.8321373408,_100,10,>100
14695,dispatchers,105,30976362,99.832475741,_100,11,>100
14696,begged,105,30976467,99.8328141413,_100,6,>100
14697,heir,105,30976572,99.8331525416,_100,4,>100
14698,librarian,105,30976677,99.8334909419,_100,9,>100
14699,hershey,105,30976782,99.8338293422,_100,7,>100
14700,withhold,105,30976887,99.8341677425,_100,8,>100
14701,dissent,105,30976992,99.8345061428,_100,7,>100
14702,bergrin,105,30977097,99.8348445431,_100,7,>100
14703,ensued,105,30977202,99.8351829434,_100,6,>100
14704,vinny,105,30977307,99.8355213437,_100,5,>100
14705,fairmont,105,30977412,99.835859744,_100,8,>100
14706,clad,105,30977517,99.8361981443,_100,4,>100
14707,ernest,105,30977622,99.8365365446,_100,6,>100
14708,excelled,105,30977727,99.8368749448,_100,8,>100
14709,cosgrove,105,30977832,99.8372133451,_100,8,>100
14710,germans,105,30977937,99.8375517454,_100,7,>100
14711,soulful,105,30978042,99.8378901457,_100,7,>100
14712,stamped,105,30978147,99.838228546,_100,7,>100
14713,valdez,104,30978251,99.8385637234,_100,6,>100
14714,soloist,104,30978355,99.8388989009,_100,7,>100
14715,arcadia,104,30978459,99.8392340783,_100,7,>100
14716,tame,104,30978563,99.8395692557,_100,4,>100
14717,duel,104,30978667,99.8399044332,_100,4,>100
14718,humbled,104,30978771,99.8402396106,_100,7,>100
14719,hurd,104,30978875,99.840574788,_100,4,>100
14720,ripping,104,30978979,99.8409099655,_100,7,>100
14721,bbb,104,30979083,99.8412451429,_100,3,>100
14722,guarding,104,30979187,99.8415803203,_100,8,>100
14723,surgically,104,30979291,99.8419154978,_100,10,>100
14724,anterior,104,30979395,99.8422506752,_100,8,>100
14725,fearless,104,30979499,99.8425858526,_100,8,>100
14726,congregations,104,30979603,99.8429210301,_100,13,>100
14727,pacing,104,30979707,99.8432562075,_100,6,>100
14728,heady,104,30979811,99.8435913849,_100,5,>100
14729,aau,104,30979915,99.8439265624,_100,3,>100
14730,vivian,104,30980019,99.8442617398,_100,6,>100
14731,presses,104,30980123,99.8445969172,_100,7,>100
14732,vein,104,30980227,99.8449320947,_100,4,>100
14733,goodwill,104,30980331,99.8452672721,_100,8,>100
14734,hugging,104,30980435,99.8456024495,_100,7,>100
14735,profoundly,104,30980539,99.845937627,_100,10,>100
14736,outbreaks,104,30980643,99.8462728044,_100,9,>100
14737,samson,104,30980747,99.8466079818,_100,6,>100
14738,noses,104,30980851,99.8469431593,_100,5,>100
14739,pours,104,30980955,99.8472783367,_100,5,>100
14740,shaquille,104,30981059,99.8476135141,_100,9,>100
14741,strangely,104,30981163,99.8479486916,_100,9,>100
14742,baths,104,30981267,99.848283869,_100,5,>100
14743,coral,104,30981371,99.8486190464,_100,5,>100
14744,heater,104,30981475,99.8489542239,_100,6,>100
14745,skeptics,104,30981579,99.8492894013,_100,8,>100
14746,rinse,104,30981683,99.8496245787,_100,5,>100
14747,indigenous,104,30981787,99.8499597561,_100,10,>100
14748,cajun,104,30981891,99.8502949336,_100,5,>100
14749,confuse,104,30981995,99.850630111,_100,7,>100
14750,tweak,104,30982099,99.8509652884,_100,5,>100
14751,marches,104,30982203,99.8513004659,_100,7,>100
14752,jeffery,104,30982307,99.8516356433,_100,7,>100
14753,maneuvering,104,30982411,99.8519708207,_100,11,>100
14754,carly,104,30982515,99.8523059982,_100,5,>100
14755,prescribe,104,30982619,99.8526411756,_100,9,>100
14756,mcqueary,104,30982723,99.852976353,_100,8,>100
14757,supervise,104,30982827,99.8533115305,_100,9,>100
14758,slicing,104,30982931,99.8536467079,_100,7,>100
14759,beginnings,104,30983035,99.8539818853,_100,10,>100
14760,restaurateur,104,30983139,99.8543170628,_100,12,>100
14761,overlooks,104,30983243,99.8546522402,_100,9,>100
14762,variable,104,30983347,99.8549874176,_100,8,>100
14763,hovering,104,30983451,99.8553225951,_100,8,>100
14764,bruising,104,30983555,99.8556577725,_100,8,>100
14765,wicked,104,30983659,99.8559929499,_100,6,>100
14766,coincided,104,30983763,99.8563281274,_100,9,>100
14767,boils,104,30983867,99.8566633048,_100,5,>100
14768,emcee,104,30983971,99.8569984822,_100,5,>100
14769,fuzzy,104,30984075,99.8573336597,_100,5,>100
14770,cupertino,104,30984179,99.8576688371,_100,9,>100
14771,104,104,30984283,99.8580040145,_100,3,>100
14772,goaltending,104,30984387,99.858339192,_100,11,>100
14773,patrolling,104,30984491,99.8586743694,_100,10,>100
14774,browsing,104,30984595,99.8590095468,_100,8,>100
14775,waterfall,104,30984699,99.8593447243,_100,9,>100
14776,calamari,104,30984803,99.8596799017,_100,8,>100
14777,playmaker,104,30984907,99.8600150791,_100,9,>100
14778,resides,104,30985011,99.8603502565,_100,7,>100
14779,companions,104,30985115,99.860685434,_100,10,>100
14780,blonde,104,30985219,99.8610206114,_100,6,>100
14781,uneasy,104,30985323,99.8613557888,_100,6,>100
14782,varejao,104,30985427,99.8616909663,_100,7,>100
14783,summons,104,30985531,99.8620261437,_100,7,>100
14784,seas,104,30985635,99.8623613211,_100,4,>100
14785,panicked,104,30985739,99.8626964986,_100,8,>100
14786,rods,104,30985843,99.863031676,_100,4,>100
14787,helpless,104,30985947,99.8633668534,_100,8,>100
14788,streamlined,104,30986051,99.8637020309,_100,11,>100
14789,conglomerate,104,30986155,99.8640372083,_100,12,>100
14790,nicer,104,30986259,99.8643723857,_100,5,>100
14791,capers,104,30986363,99.8647075632,_100,6,>100
14792,rarity,104,30986467,99.8650427406,_100,6,>100
14793,reins,104,30986571,99.865377918,_100,5,>100
14794,sleepy,104,30986675,99.8657130955,_100,6,>100
14795,oc,104,30986779,99.8660482729,_100,2,>100
14796,booed,104,30986883,99.8663834503,_100,5,>100
14797,filmmaking,104,30986987,99.8667186278,_100,10,>100
14798,admirable,103,30987090,99.8670505823,_100,9,>100
14799,duet,103,30987193,99.8673825369,_100,4,>100
14800,biotech,103,30987296,99.8677144915,_100,7,>100
14801,juliet,103,30987399,99.8680464461,_100,6,>100
14802,adept,103,30987502,99.8683784006,_100,5,>100
14803,swine,103,30987605,99.8687103552,_100,5,>100
14804,engulfed,103,30987708,99.8690423098,_100,8,>100
14805,andres,103,30987811,99.8693742643,_100,6,>100
14806,unlicensed,103,30987914,99.8697062189,_100,10,>100
14807,viking,103,30988017,99.8700381735,_100,6,>100
14808,bailed,103,30988120,99.8703701281,_100,6,>100
14809,winters,103,30988223,99.8707020826,_100,7,>100
14810,hardships,103,30988326,99.8710340372,_100,9,>100
14811,jude,103,30988429,99.8713659918,_100,4,>100
14812,fend,103,30988532,99.8716979463,_100,4,>100
14813,dolls,103,30988635,99.8720299009,_100,5,>100
14814,gibbons,103,30988738,99.8723618555,_100,7,>100
14815,wholly,103,30988841,99.8726938101,_100,6,>100
14816,pebble,103,30988944,99.8730257646,_100,6,>100
14817,lumber,103,30989047,99.8733577192,_100,6,>100
14818,christensen,103,30989150,99.8736896738,_100,11,>100
14819,decks,103,30989253,99.8740216284,_100,5,>100
14820,weehawken,103,30989356,99.8743535829,_100,9,>100
14821,zellers,103,30989459,99.8746855375,_100,7,>100
14822,rabbits,103,30989562,99.8750174921,_100,7,>100
14823,loft,103,30989665,99.8753494466,_100,4,>100
14824,maryville,103,30989768,99.8756814012,_100,9,>100
14825,chateau,103,30989871,99.8760133558,_100,7,>100
14826,chewing,103,30989974,99.8763453104,_100,7,>100
14827,clears,103,30990077,99.8766772649,_100,6,>100
14828,rat,103,30990180,99.8770092195,_100,3,>100
14829,squarely,103,30990283,99.8773411741,_100,8,>100
14830,alvin,103,30990386,99.8776731287,_100,5,>100
14831,brewed,103,30990489,99.8780050832,_100,6,>100
14832,detector,103,30990592,99.8783370378,_100,8,>100
14833,brawl,103,30990695,99.8786689924,_100,5,>100
14834,rahm,103,30990798,99.8790009469,_100,4,>100
14835,apologizing,103,30990901,99.8793329015,_100,11,>100
14836,burbank,103,30991004,99.8796648561,_100,7,>100
14837,lois,103,30991107,99.8799968107,_100,4,>100
14838,distraught,103,30991210,99.8803287652,_100,10,>100
14839,spanning,103,30991313,99.8806607198,_100,8,>100
14840,chilean,103,30991416,99.8809926744,_100,7,>100
14841,finalize,103,30991519,99.8813246289,_100,8,>100
14842,seacrest,103,30991622,99.8816565835,_100,8,>100
14843,loin,103,30991725,99.8819885381,_100,4,>100
14844,diligence,103,30991828,99.8823204927,_100,9,>100
14845,vitality,103,30991931,99.8826524472,_100,8,>100
14846,spalding,103,30992034,99.8829844018,_100,8,>100
14847,blackburn,103,30992137,99.8833163564,_100,9,>100
14848,prosecutions,103,30992240,99.883648311,_100,12,>100
14849,revoke,103,30992343,99.8839802655,_100,6,>100
14850,delmar,103,30992446,99.8843122201,_100,6,>100
14851,authorization,103,30992549,99.8846441747,_100,13,>100
14852,trusts,103,30992652,99.8849761292,_100,6,>100
14853,probability,103,30992755,99.8853080838,_100,11,>100
14854,authorizing,103,30992858,99.8856400384,_100,11,>100
14855,feldman,103,30992961,99.885971993,_100,7,>100
14856,referrals,103,30993064,99.8863039475,_100,9,>100
14857,bbc,103,30993167,99.8866359021,_100,3,>100
14858,reel,103,30993270,99.8869678567,_100,4,>100
14859,airtran,103,30993373,99.8872998112,_100,7,>100
14860,biblical,103,30993476,99.8876317658,_100,8,>100
14861,townsend,103,30993579,99.8879637204,_100,8,>100
14862,farmhouse,103,30993682,99.888295675,_100,9,>100
14863,103,103,30993785,99.8886276295,_100,3,>100
14864,owls,103,30993888,99.8889595841,_100,4,>100
14865,unfolds,103,30993991,99.8892915387,_100,7,>100
14866,indulge,103,30994094,99.8896234933,_100,7,>100
14867,monsanto,103,30994197,99.8899554478,_100,8,>100
14868,perceive,103,30994300,99.8902874024,_100,8,>100
14869,addison,103,30994403,99.890619357,_100,7,>100
14870,administrations,103,30994506,99.8909513115,_100,15,>100
14871,cyrus,103,30994609,99.8912832661,_100,5,>100
14872,healed,103,30994712,99.8916152207,_100,6,>100
14873,spitzer,103,30994815,99.8919471753,_100,7,>100
14874,pottery,103,30994918,99.8922791298,_100,7,>100
14875,bolstered,103,30995021,99.8926110844,_100,9,>100
14876,stalls,103,30995124,99.892943039,_100,6,>100
14877,galen,103,30995227,99.8932749936,_100,5,>100
14878,diarrhea,103,30995330,99.8936069481,_100,8,>100
14879,decay,103,30995433,99.8939389027,_100,5,>100
14880,raceway,103,30995536,99.8942708573,_100,7,>100
14881,greedy,103,30995639,99.8946028118,_100,6,>100
14882,astronauts,103,30995742,99.8949347664,_100,10,>100
14883,leah,103,30995845,99.895266721,_100,4,>100
14884,segel,103,30995948,99.8955986756,_100,5,>100
14885,eyeing,103,30996051,99.8959306301,_100,6,>100
14886,mooney,103,30996154,99.8962625847,_100,6,>100
14887,sampled,103,30996257,99.8965945393,_100,7,>100
14888,felon,103,30996360,99.8969264938,_100,5,>100
14889,minerals,103,30996463,99.8972584484,_100,8,>100
14890,hebrew,103,30996566,99.897590403,_100,6,>100
14891,suspending,103,30996669,99.8979223576,_100,10,>100
14892,frog,103,30996772,99.8982543121,_100,4,>100
14893,seam,103,30996875,99.8985862667,_100,4,>100
14894,romeo,103,30996978,99.8989182213,_100,5,>100
14895,proprietary,102,30997080,99.899246953,_100,11,>100
14896,refining,102,30997182,99.8995756847,_100,8,>100
14897,promoters,102,30997284,99.8999044164,_100,9,>100
14898,complied,102,30997386,99.9002331481,_100,8,>100
14899,inbev,102,30997488,99.9005618798,_100,5,>100
14900,exploitation,102,30997590,99.9008906116,_100,12,>100
14901,plump,102,30997692,99.9012193433,_100,5,>100
14902,tout,102,30997794,99.901548075,_100,4,>100
14903,hues,102,30997896,99.9018768067,_100,4,>100
14904,cpl,102,30997998,99.9022055384,_100,3,>100
14905,rags,102,30998100,99.9025342701,_100,4,>100
14906,candle,102,30998202,99.9028630018,_100,6,>100
14907,horner,102,30998304,99.9031917335,_100,6,>100
14908,partying,102,30998406,99.9035204653,_100,8,>100
14909,cooke,102,30998508,99.903849197,_100,5,>100
14910,102,102,30998610,99.9041779287,_100,3,>100
14911,heirloom,102,30998712,99.9045066604,_100,8,>100
14912,freedoms,102,30998814,99.9048353921,_100,8,>100
14913,silky,102,30998916,99.9051641238,_100,5,>100
14914,strategically,102,30999018,99.9054928555,_100,13,>100
14915,avert,102,30999120,99.9058215872,_100,5,>100
14916,conspired,102,30999222,99.906150319,_100,9,>100
14917,waged,102,30999324,99.9064790507,_100,5,>100
14918,publicized,102,30999426,99.9068077824,_100,10,>100
14919,penske,102,30999528,99.9071365141,_100,6,>100
14920,addict,102,30999630,99.9074652458,_100,6,>100
14921,lucia,102,30999732,99.9077939775,_100,5,>100
14922,solidarity,102,30999834,99.9081227092,_100,10,>100
14923,shortest,102,30999936,99.9084514409,_100,8,>100
14924,celebratory,102,31000038,99.9087801727,_100,11,>100
14925,epicenter,102,31000140,99.9091089044,_100,9,>100
14926,fashionable,102,31000242,99.9094376361,_100,11,>100
14927,gymnastics,102,31000344,99.9097663678,_100,10,>100
14928,tanner,102,31000446,99.9100950995,_100,6,>100
14929,magnetic,102,31000548,99.9104238312,_100,8,>100
14930,mclean,102,31000650,99.9107525629,_100,6,>100
14931,databases,102,31000752,99.9110812946,_100,9,>100
14932,perlaza,102,31000854,99.9114100264,_100,7,>100
14933,groundwork,102,31000956,99.9117387581,_100,10,>100
14934,revel,102,31001058,99.9120674898,_100,5,>100
14935,reconciliation,102,31001160,99.9123962215,_100,14,>100
14936,angie,102,31001262,99.9127249532,_100,5,>100
14937,weeklong,102,31001364,99.9130536849,_100,8,>100
14938,valet,102,31001466,99.9133824166,_100,5,>100
14939,veered,102,31001568,99.9137111483,_100,6,>100
14940,melinda,102,31001670,99.9140398801,_100,7,>100
14941,axelrod,102,31001772,99.9143686118,_100,7,>100
14942,rowland,102,31001874,99.9146973435,_100,7,>100
14943,genres,102,31001976,99.9150260752,_100,6,>100
14944,quieter,102,31002078,99.9153548069,_100,7,>100
14945,fairfax,102,31002180,99.9156835386,_100,7,>100
14946,budgeting,102,31002282,99.9160122703,_100,9,>100
14947,dill,102,31002384,99.916341002,_100,4,>100
14948,hallmark,102,31002486,99.9166697338,_100,8,>100
14949,barr,102,31002588,99.9169984655,_100,4,>100
14950,churning,102,31002690,99.9173271972,_100,8,>100
14951,expiring,102,31002792,99.9176559289,_100,8,>100
14952,nhtsa,102,31002894,99.9179846606,_100,5,>100
14953,leftovers,102,31002996,99.9183133923,_100,9,>100
14954,pulpit,102,31003098,99.918642124,_100,6,>100
14955,unthinkable,102,31003200,99.9189708557,_100,11,>100
14956,burdens,102,31003302,99.9192995875,_100,7,>100
14957,actresses,102,31003404,99.9196283192,_100,9,>100
14958,ssm,102,31003506,99.9199570509,_100,3,>100
14959,shellfish,102,31003608,99.9202857826,_100,9,>100
14960,romo,102,31003710,99.9206145143,_100,4,>100
14961,ghosts,102,31003812,99.920943246,_100,6,>100
14962,registering,102,31003914,99.9212719777,_100,11,>100
14963,terrifying,102,31004016,99.9216007094,_100,10,>100
14964,serb,102,31004118,99.9219294412,_100,4,>100
14965,lighted,102,31004220,99.9222581729,_100,7,>100
14966,youngster,101,31004321,99.9225836817,_100,9,>100
14967,courageous,101,31004422,99.9229091906,_100,10,>100
14968,downstream,101,31004523,99.9232346994,_100,10,>100
14969,envy,101,31004624,99.9235602083,_100,4,>100
14970,tweeting,101,31004725,99.9238857171,_100,8,>100
14971,upsetting,101,31004826,99.924211226,_100,9,>100
14972,capitalist,101,31004927,99.9245367348,_100,10,>100
14973,brutality,101,31005028,99.9248622437,_100,9,>100
14974,quinoa,101,31005129,99.9251877525,_100,6,>100
14975,trucking,101,31005230,99.9255132614,_100,8,>100
14976,ponds,101,31005331,99.9258387702,_100,5,>100
14977,budgeted,101,31005432,99.9261642791,_100,8,>100
14978,101,101,31005533,99.9264897879,_100,3,>100
14979,aisles,101,31005634,99.9268152968,_100,6,>100
14980,doctrine,101,31005735,99.9271408057,_100,8,>100
14981,hooks,101,31005836,99.9274663145,_100,5,>100
14982,pre,101,31005937,99.9277918234,_100,3,>100
14983,cee,101,31006038,99.9281173322,_100,3,>100
14984,songwriting,101,31006139,99.9284428411,_100,11,>100
14985,kauai,101,31006240,99.9287683499,_100,5,>100
14986,compensated,101,31006341,99.9290938588,_100,11,>100
14987,standouts,101,31006442,99.9294193676,_100,9,>100
14988,cheeks,101,31006543,99.9297448765,_100,6,>100
14989,purses,101,31006644,99.9300703853,_100,6,>100
14990,keane,101,31006745,99.9303958942,_100,5,>100
14991,buns,101,31006846,99.930721403,_100,4,>100
14992,cautions,101,31006947,99.9310469119,_100,8,>100
14993,seneca,101,31007048,99.9313724207,_100,6,>100
14994,freddy,101,31007149,99.9316979296,_100,6,>100
14995,roam,101,31007250,99.9320234384,_100,4,>100
14996,desktop,101,31007351,99.9323489473,_100,7,>100
14997,disconnect,101,31007452,99.9326744561,_100,10,>100
14998,tweaks,101,31007553,99.932999965,_100,6,>100
14999,dictated,101,31007654,99.9333254739,_100,8,>100
15000,leonardo,101,31007755,99.9336509827,_100,8,>100
15001,polenta,101,31007856,99.9339764916,_100,7,>100
15002,egregious,101,31007957,99.9343020004,_100,9,>100
15003,parochial,101,31008058,99.9346275093,_100,9,>100
15004,vazquez,101,31008159,99.9349530181,_100,7,>100
15005,favoring,101,31008260,99.935278527,_100,8,>100
15006,sotheby,101,31008361,99.9356040358,_100,7,>100
15007,thicker,101,31008462,99.9359295447,_100,7,>100
15008,pragmatic,101,31008563,99.9362550535,_100,9,>100
15009,pse,101,31008664,99.9365805624,_100,3,>100
15010,disk,101,31008765,99.9369060712,_100,4,>100
15011,tolerated,101,31008866,99.9372315801,_100,9,>100
15012,vehicular,101,31008967,99.9375570889,_100,9,>100
15013,fodder,101,31009068,99.9378825978,_100,6,>100
15014,norcross,101,31009169,99.9382081066,_100,8,>100
15015,vilma,101,31009270,99.9385336155,_100,5,>100
15016,diagnostic,101,31009371,99.9388591243,_100,10,>100
15017,jolt,101,31009472,99.9391846332,_100,4,>100
15018,stain,101,31009573,99.9395101421,_100,5,>100
15019,reluctantly,101,31009674,99.9398356509,_100,11,>100
15020,scissors,101,31009775,99.9401611598,_100,8,>100
15021,poetic,101,31009876,99.9404866686,_100,6,>100
15022,millennium,101,31009977,99.9408121775,_100,10,>100
15023,eisenhower,101,31010078,99.9411376863,_100,10,>100
15024,sweets,101,31010179,99.9414631952,_100,6,>100
15025,gladys,101,31010280,99.941788704,_100,6,>100
15026,volcanic,101,31010381,99.9421142129,_100,8,>100
15027,redesign,101,31010482,99.9424397217,_100,8,>100
15028,sylvia,101,31010583,99.9427652306,_100,6,>100
15029,simmering,101,31010684,99.9430907394,_100,9,>100
15030,bumpy,101,31010785,99.9434162483,_100,5,>100
15031,grandma,101,31010886,99.9437417571,_100,7,>100
15032,scorsese,101,31010987,99.944067266,_100,8,>100
15033,rosenberg,101,31011088,99.9443927748,_100,9,>100
15034,disparities,101,31011189,99.9447182837,_100,11,>100
15035,beasley,101,31011290,99.9450437925,_100,7,>100
15036,ira,101,31011391,99.9453693014,_100,3,>100
15037,lehigh,101,31011492,99.9456948102,_100,6,>100
15038,peril,101,31011593,99.9460203191,_100,5,>100
15039,customary,101,31011694,99.946345828,_100,9,>100
15040,undercut,101,31011795,99.9466713368,_100,8,>100
15041,sammy,101,31011896,99.9469968457,_100,5,>100
15042,unfolding,101,31011997,99.9473223545,_100,9,>100
15043,feminist,101,31012098,99.9476478634,_100,8,>100
15044,irwin,101,31012199,99.9479733722,_100,5,>100
15045,nv,101,31012300,99.9482988811,_100,2,>100
15046,contagious,101,31012401,99.9486243899,_100,10,>100
15047,ticking,101,31012502,99.9489498988,_100,7,>100
15048,painfully,101,31012603,99.9492754076,_100,9,>100
15049,gel,101,31012704,99.9496009165,_100,3,>100
15050,syrah,101,31012805,99.9499264253,_100,5,>100
15051,sentimental,101,31012906,99.9502519342,_100,11,>100
15052,apologies,101,31013007,99.950577443,_100,9,>100
15053,thermometer,101,31013108,99.9509029519,_100,11,>100
15054,characteristic,101,31013209,99.9512284607,_100,14,>100
15055,nodded,101,31013310,99.9515539696,_100,6,>100
15056,plunging,101,31013411,99.9518794784,_100,8,>100
15057,sewing,101,31013512,99.9522049873,_100,6,>100
15058,blackwell,101,31013613,99.9525304962,_100,9,>100
15059,reclaimed,101,31013714,99.952856005,_100,9,>100
15060,necklace,101,31013815,99.9531815139,_100,8,>100
15061,infringement,100,31013915,99.9535037998,_100,12,>10
15062,possesses,100,31014015,99.9538260858,_100,9,>10
15063,chronically,100,31014115,99.9541483718,_100,11,>10
15064,seals,100,31014215,99.9544706578,_100,5,>10
15065,corridors,100,31014315,99.9547929438,_100,9,>10
15066,newsroom,100,31014415,99.9551152298,_100,8,>10
15067,legalize,100,31014515,99.9554375158,_100,8,>10
15068,changeup,100,31014615,99.9557598018,_100,8,>10
15069,percussion,100,31014715,99.9560820878,_100,10,>10
15070,fairgrounds,100,31014815,99.9564043738,_100,11,>10
15071,cruised,100,31014915,99.9567266598,_100,7,>10
15072,recruiters,100,31015015,99.9570489458,_100,10,>10
15073,accented,100,31015115,99.9573712318,_100,8,>10
15074,gladiators,100,31015215,99.9576935178,_100,10,>10
15075,fu,100,31015315,99.9580158037,_100,2,>10
15076,indicative,100,31015415,99.9583380897,_100,10,>10
15077,tariffs,100,31015515,99.9586603757,_100,7,>10
15078,dnr,100,31015615,99.9589826617,_100,3,>10
15079,derivatives,100,31015715,99.9593049477,_100,11,>10
15080,glossy,100,31015815,99.9596272337,_100,6,>10
15081,sunni,100,31015915,99.9599495197,_100,5,>10
15082,sorted,100,31016015,99.9602718057,_100,6,>10
15083,creighton,100,31016115,99.9605940917,_100,9,>10
15084,mourners,100,31016215,99.9609163777,_100,8,>10
15085,kaufman,100,31016315,99.9612386637,_100,7,>10
15086,missourians,100,31016415,99.9615609497,_100,11,>10
15087,chores,100,31016515,99.9618832357,_100,6,>10
15088,entirety,100,31016615,99.9622055216,_100,8,>10
15089,fong,100,31016715,99.9625278076,_100,4,>10
15090,rotate,100,31016815,99.9628500936,_100,6,>10
15091,thinner,100,31016915,99.9631723796,_100,7,>10
15092,eldest,100,31017015,99.9634946656,_100,6,>10
15093,loki,100,31017115,99.9638169516,_100,4,>10
15094,landry,100,31017215,99.9641392376,_100,6,>10
15095,murderer,100,31017315,99.9644615236,_100,8,>10
15096,tempered,100,31017415,99.9647838096,_100,8,>10
15097,regan,100,31017515,99.9651060956,_100,5,>10
15098,100,100,31017615,99.9654283816,_100,3,>10
15099,boon,100,31017715,99.9657506676,_100,4,>10
15100,straub,100,31017815,99.9660729536,_100,6,>10
15101,dominion,100,31017915,99.9663952396,_100,8,>10
15102,budgetary,100,31018015,99.9667175255,_100,9,>10
15103,hines,100,31018115,99.9670398115,_100,5,>10
15104,tancredo,100,31018215,99.9673620975,_100,8,>10
15105,hardworking,100,31018315,99.9676843835,_100,11,>10
15106,battalion,100,31018415,99.9680066695,_100,9,>10
15107,overlap,100,31018515,99.9683289555,_100,7,>10
15108,clocked,100,31018615,99.9686512415,_100,7,>10
15109,cellular,100,31018715,99.9689735275,_100,8,>10
15110,hoynsie,100,31018815,99.9692958135,_100,7,>10
15111,wilmington,100,31018915,99.9696180995,_100,10,>10
15112,vending,100,31019015,99.9699403855,_100,7,>10
15113,posture,100,31019115,99.9702626715,_100,7,>10
15114,cirque,100,31019215,99.9705849575,_100,6,>10
15115,onset,100,31019315,99.9709072434,_100,5,>10
15116,blur,100,31019415,99.9712295294,_100,4,>10
15117,cater,100,31019515,99.9715518154,_100,5,>10
15118,brockers,100,31019615,99.9718741014,_100,8,>10
15119,solos,100,31019715,99.9721963874,_100,5,>10
15120,saratoga,100,31019815,99.9725186734,_100,8,>10
15121,cheesecake,100,31019915,99.9728409594,_100,10,>10
15122,realignment,100,31020015,99.9731632454,_100,11,>10
15123,velvet,100,31020115,99.9734855314,_100,6,>10
15124,careless,100,31020215,99.9738078174,_100,8,>10
15125,milligrams,100,31020315,99.9741301034,_100,10,>10
15126,mehlville,100,31020415,99.9744523894,_100,9,>10
15127,maze,100,31020515,99.9747746754,_100,4,>10
15128,splendid,100,31020615,99.9750969614,_100,8,>10
15129,dads,100,31020715,99.9754192473,_100,4,>10
15130,gunmen,100,31020815,99.9757415333,_100,6,>10
15131,dunks,100,31020915,99.9760638193,_100,5,>10
15132,deboer,100,31021015,99.9763861053,_100,6,>10
15133,persuasive,100,31021115,99.9767083913,_100,10,>10
15134,ihs,100,31021215,99.9770306773,_100,3,>10
15135,garza,100,31021315,99.9773529633,_100,5,>10
15136,inflicted,100,31021415,99.9776752493,_100,9,>10
15137,boisterous,100,31021515,99.9779975353,_100,10,>10
15138,doe,100,31021615,99.9783198213,_100,3,>10
15139,100th,100,31021715,99.9786421073,_100,5,>10
15140,cisco,100,31021815,99.9789643933,_100,5,>10
15141,woven,100,31021915,99.9792866793,_100,5,>10
15142,immersion,100,31022015,99.9796089652,_100,9,>10
15143,99,99,31022114,99.9799280284,_100,2,>10
15144,98,98,31022212,99.9802438687,_100,2,>10
15145,97,97,31022309,99.9805564861,_100,2,>10
15146,96,96,31022405,99.9808658806,_100,2,>10
15147,95,95,31022500,99.9811720523,_100,2,>10
15148,94,94,31022594,99.9814750011,_100,2,>10
15149,93,93,31022687,99.9817747271,_100,2,>10
15150,92,92,31022779,99.9820712302,_100,2,>10
15151,91,91,31022870,99.9823645105,_100,2,>10
15152,90s,90,31022960,99.9826545679,_100,3,>10
15153,90,90,31023050,99.9829446253,_100,2,>10
15154,89,89,31023139,99.9832314598,_100,2,>10
15155,88,88,31023227,99.9835150715,_100,2,>10
15156,87,87,31023314,99.9837954603,_100,2,>10
15157,86,86,31023400,99.9840726262,_100,2,>10
15158,85,85,31023485,99.9843465693,_100,2,>10
15159,84,84,31023569,99.9846172896,_100,2,>10
15160,83,83,31023652,99.9848847869,_100,2,>10
15161,82nd,82,31023734,99.9851490615,_100,4,>10
15162,82,82,31023816,99.985413336,_100,2,>10
15163,81,81,31023897,99.9856743876,_100,2,>10
15164,80,80,31023977,99.9859322164,_100,2,>10
15165,80s,80,31024057,99.9861900452,_100,3,>10
15166,79,79,31024136,99.9864446512,_100,2,>10
15167,78,78,31024214,99.9866960342,_100,2,>10
15168,77,77,31024291,99.9869441944,_100,2,>10
15169,76,76,31024367,99.9871891318,_100,2,>10
15170,76ers,76,31024443,99.9874340691,_100,5,>10
15171,75,75,31024518,99.9876757836,_100,2,>10
15172,74,74,31024592,99.9879142753,_100,2,>10
15173,73,73,31024665,99.9881495441,_100,2,>10
15174,72,72,31024737,99.98838159,_100,2,>10
15175,71,71,31024808,99.988610413,_100,2,>10
15176,70s,70,31024878,99.9888360132,_100,3,>10
15177,70,70,31024948,99.9890616134,_100,2,>10
15178,69,69,31025017,99.9892839907,_100,2,>10
15179,68,68,31025085,99.9895031452,_100,2,>10
15180,67,67,31025152,99.9897190768,_100,2,>10
15181,66,66,31025218,99.9899317856,_100,2,>10
15182,65,65,31025283,99.9901412715,_100,2,>10
15183,64,64,31025347,99.9903475345,_100,2,>10
15184,63,63,31025410,99.9905505747,_100,2,>10
15185,62,62,31025472,99.990750392,_100,2,>10
15186,61,61,31025533,99.9909469865,_100,2,>10
15187,60,60,31025593,99.9911403581,_100,2,>10
15188,60s,60,31025653,99.9913337297,_100,3,>10
15189,59,59,31025712,99.9915238784,_100,2,>10
15190,58,58,31025770,99.9917108043,_100,2,>10
15191,57,57,31025827,99.9918945073,_100,2,>10
15192,56,56,31025883,99.9920749874,_100,2,>10
15193,55,55,31025938,99.9922522447,_100,2,>10
15194,54,54,31025992,99.9924262792,_100,2,>10
15195,53,53,31026045,99.9925970908,_100,2,>10
15196,52,52,31026097,99.9927646795,_100,2,>10
15197,51,51,31026148,99.9929290453,_100,2,>10
15198,50,50,31026198,99.9930901883,_100,2,>10
15199,50s,50,31026248,99.9932513313,_100,3,>10
15200,50th,50,31026298,99.9934124743,_100,4,>10
15201,49,49,31026347,99.9935703944,_100,2,>10
15202,49ers,49,31026396,99.9937283146,_100,5,>10
15203,48,48,31026444,99.9938830119,_100,2,>10
15204,47,47,31026491,99.9940344863,_100,2,>10
15205,46,46,31026537,99.9941827378,_100,2,>10
15206,45,45,31026582,99.9943277665,_100,2,>10
15207,44,44,31026626,99.9944695724,_100,2,>10
15208,43,43,31026669,99.9946081553,_100,2,>10
15209,42,42,31026711,99.9947435155,_100,2,>10
15210,41,41,31026752,99.9948756527,_100,2,>10
15211,40,40,31026792,99.9950045671,_100,2,>10
15212,40s,40,31026832,99.9951334815,_100,3,>10
15213,40th,40,31026872,99.9952623959,_100,4,>10
15214,39,39,31026911,99.9953880874,_100,2,>10
15215,38,38,31026949,99.9955105561,_100,2,>10
15216,37,37,31026986,99.9956298019,_100,2,>10
15217,36,36,31027022,99.9957458249,_100,2,>10
15218,35,35,31027057,99.995858625,_100,2,>10
15219,34th,34,31027091,99.9959682022,_100,4,>10
15220,34,34,31027125,99.9960777795,_100,2,>10
15221,33,33,31027158,99.9961841338,_100,2,>10
15222,32,32,31027190,99.9962872654,_100,2,>10
15223,32nd,32,31027222,99.9963903969,_100,4,>10
15224,31,31,31027253,99.9964903055,_100,2,>10
15225,31st,31,31027284,99.9965902142,_100,4,>10
15226,30,30,31027314,99.9966869,_100,2,>10
15227,30th,30,31027344,99.9967835858,_100,4,>10
15228,30s,30,31027374,99.9968802716,_100,3,>10
15229,29,29,31027403,99.9969737345,_100,2,>10
15230,29th,29,31027432,99.9970671975,_100,4,>10
15231,28,28,31027460,99.9971574375,_100,2,>10
15232,28th,28,31027488,99.9972476776,_100,4,>10
15233,27,27,31027515,99.9973346948,_100,2,>10
15234,27th,27,31027542,99.9974217121,_100,4,>10
15235,26th,26,31027568,99.9975055064,_100,4,>10
15236,26,26,31027594,99.9975893008,_100,2,>10
15237,25th,25,31027619,99.9976698723,_100,4,>10
15238,25,25,31027644,99.9977504438,_100,2,>10
15239,24,24,31027668,99.9978277924,_100,2,>10
15240,24th,24,31027692,99.997905141,_100,4,>10
15241,23,23,31027715,99.9979792668,_100,2,>10
15242,23rd,23,31027738,99.9980533926,_100,4,>10
15243,22nd,22,31027760,99.9981242955,_100,4,>10
15244,22,22,31027782,99.9981951984,_100,2,>10
15245,21st,21,31027803,99.9982628785,_100,4,>10
15246,21,21,31027824,99.9983305586,_100,2,>10
15247,20th,20,31027844,99.9983950158,_100,4,>10
15248,20,20,31027864,99.998459473,_100,2,>10
15249,20s,20,31027884,99.9985239302,_100,3,>10
15250,19,19,31027903,99.9985851645,_100,2,>10
15251,19th,19,31027922,99.9986463988,_100,4,>10
15252,18th,18,31027940,99.9987044103,_100,4,>10
15253,18,18,31027958,99.9987624218,_100,2,>10
15254,17,17,31027975,99.9988172104,_100,2,>10
15255,17th,17,31027992,99.998871999,_100,4,>10
15256,16th,16,31028008,99.9989235648,_100,4,>10
15257,16,16,31028024,99.9989751305,_100,2,>10
15258,15,15,31028039,99.9990234734,_100,2,>10
15259,15th,15,31028054,99.9990718163,_100,4,>10
15260,14th,14,31028068,99.9991169364,_100,4,>10
15261,14,14,31028082,99.9991620564,_100,2,>10
15262,13th,13,31028095,99.9992039536,_100,4,>10
15263,13,13,31028108,99.9992458508,_100,2,>10
15264,12th,12,31028120,99.9992845251,_100,4,>10
15265,12,12,31028132,99.9993231994,_100,2,>10
15266,11,11,31028143,99.9993586509,_100,2,>10
15267,11th,11,31028154,99.9993941023,_100,4,>10
15268,10,10,31028164,99.9994263309,_100,2,>=1
15269,10th,10,31028174,99.9994585595,_100,4,>=1
15270,09,9,31028183,99.9994875653,_100,2,>=1
15271,9th,9,31028192,99.999516571,_100,3,>=1
15272,9,9,31028201,99.9995455768,_100,1,>=1
15273,08,8,31028209,99.9995713596,_100,2,>=1
15274,8,8,31028217,99.9995971425,_100,1,>=1
15275,8th,8,31028225,99.9996229254,_100,3,>=1
15276,07,7,31028232,99.9996454854,_100,2,>=1
15277,7,7,31028239,99.9996680454,_100,1,>=1
15278,7th,7,31028246,99.9996906054,_100,3,>=1
15279,6,6,31028252,99.9997099426,_100,1,>=1
15280,06,6,31028258,99.9997292798,_100,2,>=1
15281,6th,6,31028264,99.9997486169,_100,3,>=1
15282,5,5,31028269,99.9997647312,_100,1,>=1
15283,5a,5,31028274,99.9997808455,_100,2,>=1
15284,5k,5,31028279,99.9997969598,_100,2,>=1
15285,5th,5,31028284,99.9998130741,_100,3,>=1
15286,05,5,31028289,99.9998291884,_100,2,>=1
15287,4th,4,31028293,99.9998420799,_100,3,>=1
15288,4g,4,31028297,99.9998549713,_100,2,>=1
15289,4,4,31028301,99.9998678627,_100,1,>=1
15290,4a,4,31028305,99.9998807542,_100,2,>=1
15291,04,4,31028309,99.9998936456,_100,2,>=1
15292,03,3,31028312,99.9999033142,_100,2,>=1
15293,3rd,3,31028315,99.9999129828,_100,3,>=1
15294,3b,3,31028318,99.9999226514,_100,2,>=1
15295,3a,3,31028321,99.9999323199,_100,2,>=1
15296,3,3,31028324,99.9999419885,_100,1,>=1
15297,3d,3,31028327,99.9999516571,_100,2,>=1
15298,02,2,31028329,99.9999581028,_100,2,>=1
15299,2,2,31028331,99.9999645485,_100,1,>=1
15300,2b,2,31028333,99.9999709943,_100,2,>=1
15301,2nd,2,31028335,99.99997744,_100,3,>=1
15302,2a,2,31028337,99.9999838857,_100,2,>=1
15303,01,1,31028338,99.9999871086,_100,2,>=1
15304,1a,1,31028339,99.9999903314,_100,2,>=1
15305,1,1,31028340,99.9999935543,_100,1,>=1
15306,1st,1,31028341,99.9999967771,_100,3,>=1
15307,1b,1,31028342,100.0,_100,2,>=1
15308,00,0,31028342,100.0,_100,2,
15309,000,0,31028342,100.0,_100,3,
15310,0,0,31028342,100.0,_100,1,
