,word,count,cum_freq,cum_perc,percentile,length,volume
0,the,934525,934525,3.45497336303,10,3,>100K
1,i,912746,1847271,6.82942896049,10,1,>100K
2,to,786961,2634232,9.73885277767,10,2,>100K
3,a,610242,3244474,11.9949399396,20,1,>100K
4,you,598028,3842502,14.2058714934,20,3,>100K
5,and,435941,4278443,15.8175614352,20,3,>100K
6,for,384630,4663073,17.2395527192,20,3,>100K
7,it,381565,5044638,18.6502125852,20,2,>100K
8,in,376866,5421504,20.043500075,30,2,>100K
9,of,358771,5780275,21.369889683,30,2,>100K
10,is,358355,6138630,22.6947413237,30,2,>100K
11,my,291501,6430131,23.7724312627,30,2,>100K
12,on,276581,6706712,24.794961412,30,2,>100K
13,that,269978,6976690,25.7930800269,30,4,>100K
14,me,201009,7177699,26.5362177073,30,2,>100K
15,do,197458,7375157,27.2662272098,30,2,>100K
16,be,187342,7562499,27.9588374875,30,2,>100K
17,at,185805,7748304,28.6457654195,30,2,>100K
18,with,172926,7921230,29.285079214,30,4,>100K
19,your,171148,8092378,29.917819677,30,4,>100K
20,have,168330,8260708,30.5401418901,40,4,>100K
21,we,164618,8425326,31.1487407024,40,2,>100K
22,this,163419,8588745,31.7529067675,40,4,>100K
23,so,162558,8751303,32.3538896839,40,2,>100K
24,are,158634,8909937,32.9403654277,40,3,>100K
25,know,155678,9065615,33.5159127306,40,4,>100K
26,just,151203,9216818,34.0749157935,40,4,>100K
27,can,135467,9352285,34.5757422846,40,3,>100K
28,but,127273,9479558,35.0462752557,40,3,>100K
29,what,127246,9606804,35.5167084068,40,4,>100K
30,not,123082,9729886,35.9717470965,40,3,>100K
31,like,121219,9851105,36.4198982065,40,4,>100K
32,all,121116,9972221,36.8676685218,40,3,>100K
33,was,117141,10089362,37.3007431155,40,3,>100K
34,out,114299,10203661,37.7233107305,40,3,>100K
35,up,113271,10316932,38.1420777916,40,2,>100K
36,get,112136,10429068,38.556648716,40,3,>100K
37,if,106269,10535337,38.9495291251,40,2,>100K
38,love,105665,10641002,39.3401765239,40,4,>100K
39,good,101060,10742062,39.713799068,40,4,>100K
40,will,94378,10836440,40.062718012,50,4,>10K
41,about,90972,10927412,40.3990448483,50,5,>10K
42,90210,90210,11017622,40.7325545427,50,5,>10K
43,day,89420,11107042,41.0631435779,50,3,>10K
44,rt,89084,11196126,41.3924904087,50,2,>10K
45,thanks,88895,11285021,41.7211384995,50,6,>10K
46,from,83522,11368543,42.0299224114,50,4,>10K
47,now,83147,11451690,42.3373199344,50,3,>10K
48,when,82801,11534491,42.6434382827,50,4,>10K
49,one,82311,11616802,42.947745083,50,3,>10K
50,they,80549,11697351,43.2455377042,50,4,>10K
51,u,78673,11776024,43.5363946844,50,1,>10K
52,don,77998,11854022,43.8247561647,50,3,>10K
53,how,77860,11931882,44.1126074539,50,3,>10K
54,no,76833,12008715,44.3966618863,50,2,>10K
55,today,75987,12084702,44.6775886255,50,5,>10K
56,great,75575,12160277,44.9569921855,50,5,>10K
57,time,74989,12235266,45.2342292819,50,4,>10K
58,as,72980,12308246,45.5040390312,50,2,>10K
59,go,72239,12380485,45.7711092763,50,2,>10K
60,he,72103,12452588,46.0376767244,50,2,>10K
61,there,70585,12523173,46.2986320705,50,5,>10K
62,lol,69702,12592875,46.5563229331,50,3,>10K
63,new,69250,12662125,46.812342735,50,3,>10K
64,or,68712,12730837,47.0663735311,50,2,>10K
65,see,66563,12797400,47.312459395,50,3,>10K
66,an,66275,12863675,47.5574805123,50,2,>10K
67,more,62460,12926135,47.788397434,50,4,>10K
68,who,61916,12988051,48.0173031676,50,3,>10K
69,our,61758,13049809,48.2456247695,50,3,>10K
70,some,61259,13111068,48.4721015499,50,4,>10K
71,by,58720,13169788,48.6891915538,50,2,>10K
72,too,58482,13228270,48.9054016629,50,3,>10K
73,back,57494,13285764,49.1179590996,50,4,>10K
74,got,55743,13341507,49.3240430248,50,3,>10K
75,going,55616,13397123,49.5296574263,50,5,>10K
76,think,53606,13450729,49.7278407837,50,5,>10K
77,would,52434,13503163,49.9216912139,50,5,>10K
78,people,52244,13555407,50.1148392072,60,6,>10K
79,need,50738,13606145,50.3024194629,60,4,>10K
80,us,48611,13654756,50.4821361213,60,2,>10K
81,happy,48449,13703205,50.6612538597,60,5,>10K
82,want,47798,13751003,50.8379648271,60,4,>10K
83,make,47295,13798298,51.0128161849,60,4,>10K
84,follow,46812,13845110,51.185881874,60,6,>10K
85,has,46371,13891481,51.3573171698,60,3,>10K
86,tonight,46090,13937571,51.5277135982,60,7,>10K
87,right,45771,13983342,51.6969306719,60,5,>10K
88,really,45323,14028665,51.8644914731,60,6,>10K
89,much,44286,14072951,52.0282184471,60,4,>10K
90,been,43807,14116758,52.1901745404,60,4,>10K
91,still,43143,14159901,52.3496758013,60,5,>10K
92,had,42088,14201989,52.5052766883,60,3,>10K
93,work,41537,14243526,52.6588405079,60,4,>10K
94,am,41248,14284774,52.811335884,60,2,>10K
95,night,40986,14325760,52.9628626363,60,5,>10K
96,come,40370,14366130,53.112112014,60,4,>10K
97,here,39720,14405850,53.2589583177,60,4,>10K
98,did,39649,14445499,53.4055421318,60,3,>10K
99,thank,39621,14485120,53.5520224289,60,5,>10K
100,only,39153,14524273,53.6967725127,60,4,>10K
101,why,38702,14562975,53.8398552329,60,3,>10K
102,them,38470,14601445,53.9820802406,60,4,>10K
103,well,38278,14639723,54.1235954171,60,4,>10K
104,she,37416,14677139,54.2619237479,60,3,>10K
105,should,37275,14714414,54.3997307966,60,6,>10K
106,last,37212,14751626,54.5373049319,60,4,>10K
107,let,36851,14788477,54.6735444368,60,3,>10K
108,its,36818,14825295,54.8096619396,60,3,>10K
109,way,36549,14861844,54.9447849395,60,3,>10K
110,best,35903,14897747,55.0775196535,60,4,>10K
111,off,35681,14933428,55.2094336254,60,3,>10K
112,hope,35370,14968798,55.3401978188,60,4,>10K
113,never,34036,15002834,55.4660301651,60,5,>10K
114,life,33949,15036783,55.5915408691,60,4,>10K
115,his,33910,15070693,55.7169073887,60,3,>10K
116,her,33607,15104300,55.8411537062,60,3,>10K
117,oh,32867,15137167,55.9626642164,60,2,>10K
118,then,32477,15169644,56.0827328822,60,4,>10K
119,say,31945,15201589,56.2008347244,60,3,>10K
120,than,31913,15233502,56.3188182614,60,4,>10K
121,over,31173,15264675,56.4340659911,60,4,>10K
122,first,31096,15295771,56.5490290491,60,5,>10K
123,show,30912,15326683,56.6633118522,60,4,>10K
124,next,30902,15357585,56.777557685,60,4,>10K
125,im,30419,15388004,56.8900178489,60,2,>10K
126,better,30075,15418079,57.0012062322,60,6,>10K
127,please,29870,15447949,57.1116367229,60,6,>10K
128,game,29844,15477793,57.2219710907,60,4,>10K
129,twitter,29560,15507353,57.3312555,60,7,>10K
130,week,29315,15536668,57.4396341353,60,4,>10K
131,always,29048,15565716,57.5470256618,60,6,>10K
132,tomorrow,28909,15594625,57.6539033001,60,8,>10K
133,where,28543,15623168,57.7594278229,60,5,>10K
134,take,28466,15651634,57.8646676739,60,4,>10K
135,their,28395,15680029,57.9696450353,60,5,>10K
136,yes,28032,15708061,58.0732803723,60,3,>10K
137,year,27741,15735802,58.1758398716,60,4,>10K
138,down,27503,15763305,58.2775194761,60,4,>10K
139,him,27482,15790787,58.3791214428,60,3,>10K
140,man,27293,15818080,58.4800246696,60,3,>10K
141,any,27004,15845084,58.5798594527,60,3,>10K
142,wait,27000,15872084,58.6796794477,60,4,>10K
143,haha,26887,15898971,58.7790816775,60,4,>10K
144,could,26808,15925779,58.8781918414,60,5,>10K
145,were,26432,15952211,58.9759119194,60,4,>10K
146,morning,26278,15978489,59.0730626538,60,7,>10K
147,away,26258,16004747,59.1701394474,60,4,>10K
148,hey,26185,16030932,59.2669463574,60,3,>10K
149,everyone,25885,16056817,59.3626441562,60,8,>10K
150,even,25821,16082638,59.4581053448,60,4,>10K
151,getting,25695,16108333,59.5531007067,60,7,>10K
152,looking,25388,16133721,59.6469610782,60,7,>10K
153,very,25334,16159055,59.7406218098,60,4,>10K
154,sure,24956,16184011,59.8328850615,60,4,>10K
155,ever,24837,16208848,59.9247083657,60,4,>10K
156,look,24748,16233596,60.0162026337,70,4,>10K
157,awesome,24510,16258106,60.1068170069,70,7,>10K
158,feel,24445,16282551,60.1971910727,70,4,>10K
159,home,24017,16306568,60.2859828068,70,4,>10K
160,after,23613,16330181,60.3732809379,70,5,>10K
161,big,23434,16353615,60.4599172995,70,3,>10K
162,being,23363,16376978,60.5462911715,70,5,>10K
163,because,23105,16400083,60.6317112079,70,7,>10K
164,d,22941,16423024,60.7165249303,70,1,>10K
165,fun,22757,16445781,60.8006583979,70,3,>10K
166,weekend,22412,16468193,60.8835163878,70,7,>10K
167,keep,22381,16490574,60.9662597696,70,4,>10K
168,again,22340,16512914,61.0488515728,70,5,>10K
169,nice,22210,16535124,61.1309627613,70,4,>10K
170,something,22160,16557284,61.2128890979,70,9,>10K
171,those,22047,16579331,61.2943976693,70,5,>10K
172,yeah,21760,16601091,61.3748451912,70,4,>10K
173,gonna,21683,16622774,61.4550080412,70,5,>10K
174,into,21645,16644419,61.5350304039,70,4,>10K
175,www,21398,16665817,61.6141395984,70,3,>10K
176,thing,21382,16687199,61.6931896404,70,5,>10K
177,world,21161,16708360,61.7714226372,70,5,>10K
178,doing,21152,16729512,61.8496223606,70,5,>10K
179,someone,21088,16750600,61.9275854737,70,7,>10K
180,things,21033,16771633,62.0053452498,70,6,>10K
181,guys,20824,16792457,62.0823323452,70,4,>10K
182,school,20708,16813165,62.1588905843,70,6,>10K
183,w,20634,16833799,62.2351752427,70,1,>10K
184,bad,20512,16854311,62.3110088626,70,3,>10K
185,check,20296,16874607,62.3860439225,70,5,>10K
186,live,20281,16894888,62.4610235269,70,4,>10K
187,help,20084,16914972,62.535274815,70,4,>10K
188,miss,19896,16934868,62.6088310602,70,4,>10K
189,free,19812,16954680,62.6820767543,70,4,>10K
190,every,19672,16974352,62.7548048632,70,5,>10K
191,does,19647,16993999,62.8274405462,70,4,>10K
192,watching,19534,17013533,62.899658464,70,8,>10K
193,tell,19498,17033031,62.9717432886,70,4,>10K
194,soon,19466,17052497,63.0437098079,70,4,>10K
195,tweet,19335,17071832,63.1151920154,70,5,>10K
196,amazing,19178,17091010,63.1860937881,70,7,>10K
197,long,19073,17110083,63.256607372,70,4,>10K
198,give,19011,17129094,63.3268917396,70,4,>10K
199,music,18984,17148078,63.3970762871,70,5,>10K
200,call,18952,17167030,63.4671425295,70,4,>10K
201,coming,18928,17185958,63.537120043,70,6,>10K
202,many,18805,17204763,63.606642821,70,4,>10K
203,little,18752,17223515,63.6759696561,70,6,>10K
204,before,18643,17242158,63.7448935141,70,6,>10K
205,may,18498,17260656,63.8132813017,70,3,>10K
206,days,18336,17278992,63.8810701694,70,4,>10K
207,hate,18299,17297291,63.9487222468,70,4,>10K
208,stop,18227,17315518,64.0161081374,70,4,>10K
209,wish,18185,17333703,64.0833387526,70,4,>10K
210,most,18184,17351887,64.1505656707,70,4,>10K
211,same,18183,17370070,64.2177888917,70,4,>10K
212,didn,18066,17388136,64.2845795595,70,4,>10K
213,friends,18041,17406177,64.3512778013,70,7,>10K
214,said,17981,17424158,64.4177542209,70,4,>10K
215,r,17535,17441693,64.4825817621,70,1,>10K
216,god,17465,17459158,64.5471505107,70,3,>10K
217,start,17446,17476604,64.6116490156,70,5,>10K
218,girl,17412,17494016,64.6760218212,70,4,>10K
219,done,17399,17511415,64.7403465654,70,4,>10K
220,ready,17291,17528706,64.8042720296,70,5,>10K
221,find,17268,17545974,64.8681124619,70,4,>10K
222,cool,16866,17562840,64.9304666855,70,4,>10K
223,two,16803,17579643,64.9925879957,70,3,>10K
224,finally,16715,17596358,65.0543839666,70,7,>10K
225,another,16715,17613073,65.1161799376,70,7,>10K
226,watch,16681,17629754,65.1778502093,70,5,>10K
227,play,16657,17646411,65.2394317521,70,4,>10K
228,pretty,16651,17663062,65.3009911127,70,6,>10K
229,anyone,16249,17679311,65.3610642645,70,6,>10K
230,birthday,16156,17695467,65.4207935919,70,8,>10K
231,also,16120,17711587,65.4803898259,70,4,>10K
232,talk,16007,17727594,65.5395682948,70,4,>10K
233,old,16005,17743599,65.5987393696,70,3,>10K
234,these,15896,17759495,65.6575074674,70,5,>10K
235,real,15839,17775334,65.716064834,70,4,>10K
236,win,15814,17791148,65.7745297748,70,3,>10K
237,face,15801,17806949,65.8329466541,70,4,>10K
238,use,15770,17822719,65.8912489252,70,3,>10K
239,excited,15492,17838211,65.9485234201,70,7,>10K
240,friday,15336,17853547,66.0052211773,70,6,>10K
241,hear,15186,17868733,66.0613643789,70,4,>10K
242,working,15109,17883842,66.1172229087,70,7,>10K
243,hard,14965,17898807,66.1725490651,70,4,>10K
244,having,14883,17913690,66.2275720646,70,6,>10K
245,try,14869,17928559,66.2825433055,70,3,>10K
246,around,14822,17943381,66.3373407857,70,6,>10K
247,sorry,14749,17958130,66.3918683822,70,5,>10K
248,thought,14715,17972845,66.4462702795,70,7,>10K
249,ur,14706,17987551,66.5006389034,70,2,>10K
250,team,14474,18002025,66.5541498148,70,4,>10K
251,s,14461,18016486,66.6076126647,70,1,>10K
252,while,14408,18030894,66.6608795716,70,5,>10K
253,already,14405,18045299,66.7141353875,70,7,>10K
254,wanna,14242,18059541,66.7667885863,70,5,>10K
255,maybe,14193,18073734,66.8192606303,70,5,>10K
256,put,14129,18087863,66.871496064,70,3,>10K
257,though,14121,18101984,66.9237019214,70,6,>10K
258,ya,14066,18116050,66.9757044417,70,2,>10K
259,makes,14050,18130100,67.0276478095,70,5,>10K
260,glad,14013,18144113,67.0794543869,70,4,>10K
261,ok,13738,18157851,67.1302442791,70,2,>10K
262,trying,13619,18171470,67.180594224,70,6,>10K
263,house,13466,18184936,67.2303785222,70,5,>10K
264,lot,13429,18198365,67.2800260301,70,3,>10K
265,forward,13376,18211741,67.329477595,70,7,>10K
266,yet,13318,18225059,67.3787147318,70,3,>10K
267,nothing,13317,18238376,67.4279481715,70,7,>10K
268,beautiful,13296,18251672,67.4771039735,70,9,>10K
269,wow,13291,18264963,67.5262412903,70,3,>10K
270,won,13229,18278192,67.5751493908,70,3,>10K
271,dont,13223,18291415,67.6240353091,70,4,>10K
272,years,13163,18304578,67.6726994051,70,5,>10K
273,doesn,13096,18317674,67.7211157997,70,5,>10K
274,looks,13058,18330732,67.7693917069,70,5,>10K
275,friend,13024,18343756,67.8175419149,70,6,>10K
276,sleep,13006,18356762,67.8656255762,70,5,>10K
277,following,13000,18369762,67.9136870552,70,9,>10K
278,true,12986,18382748,67.9616967758,70,4,>10K
279,job,12972,18395720,68.0096547378,70,3,>10K
280,party,12862,18408582,68.0572060258,70,5,>10K
281,saw,12855,18421437,68.1047314345,70,3,>10K
282,welcome,12842,18434279,68.1522087817,70,7,>10K
283,everything,12757,18447036,68.1993718808,70,10,>10K
284,guy,12655,18459691,68.2461578822,70,3,>10K
285,song,12607,18472298,68.2927664258,70,4,>10K
286,through,12530,18484828,68.3390902975,70,7,>10K
287,mean,12523,18497351,68.38538829,70,4,>10K
288,favorite,12443,18509794,68.4313905195,70,8,>10K
289,might,12346,18522140,68.4770341365,70,5,>10K
290,com,12322,18534462,68.5225890246,70,3,>10K
291,must,12273,18546735,68.5679627578,70,4,>10K
292,until,12199,18558934,68.6130629104,70,5,>10K
293,making,12168,18571102,68.6580484548,70,6,>10K
294,p,12029,18583131,68.702520111,70,1,>10K
295,stay,11966,18595097,68.746758854,70,4,>10K
296,person,11898,18606995,68.7907461985,70,6,>10K
297,name,11893,18618888,68.8347150577,70,4,>10K
298,damn,11773,18630661,68.8782402726,70,4,>10K
299,food,11709,18642370,68.9215288771,70,4,>10K
300,mom,11703,18654073,68.9647952993,70,3,>10K
301,family,11675,18665748,69.0079582046,70,6,>10K
302,book,11647,18677395,69.0510175928,70,4,>10K
303,anything,11620,18689015,69.093977161,70,8,>10K
304,read,11607,18700622,69.1368886677,70,4,>10K
305,actually,11543,18712165,69.1795635641,70,8,>10K
306,end,11531,18723696,69.222194096,70,3,>10K
307,few,11527,18735223,69.2648098398,70,3,>10K
308,phone,11512,18746735,69.307370128,70,5,>10K
309,which,11489,18758224,69.3498453844,70,5,>10K
310,hit,11466,18769690,69.3922356089,70,3,>10K
311,omg,11355,18781045,69.4342154623,70,3,>10K
312,congrats,11311,18792356,69.4760326462,70,8,>10K
313,n,11279,18803635,69.5177315248,70,1,>10K
314,tickets,11237,18814872,69.5592751279,70,7,>10K
315,money,11211,18826083,69.600722608,70,5,>10K
316,place,11196,18837279,69.6421146326,70,5,>10K
317,since,11112,18848391,69.6831961061,70,5,>10K
318,gotta,11090,18859481,69.7241962448,70,5,>10K
319,open,11063,18870544,69.7650965635,70,4,>10K
320,guess,11063,18881607,69.8059968821,70,5,>10K
321,movie,10968,18892575,69.8465459823,70,5,>10K
322,baby,10893,18903468,69.8868178047,70,4,>10K
323,o,10859,18914327,69.9269639279,70,1,>10K
324,believe,10831,18925158,69.967006534,70,7,>10K
325,playing,10801,18935959,70.0069382291,80,7,>10K
326,season,10644,18946603,70.0462894893,80,6,>10K
327,both,10641,18957244,70.0856296584,80,4,>10K
328,such,10620,18967864,70.1248921898,80,4,>10K
329,crazy,10582,18978446,70.1640142337,80,5,>10K
330,video,10573,18989019,70.2031030044,80,5,>10K
331,own,10554,18999573,70.2421215313,80,3,>10K
332,change,10518,19010091,70.2810069649,80,6,>10K
333,support,10412,19020503,70.3195005126,80,7,>10K
334,sounds,10411,19030914,70.3579903632,80,6,>10K
335,hot,10393,19041307,70.3964136672,80,3,>10K
336,else,10370,19051677,70.4347519394,80,4,>10K
337,run,10334,19062011,70.4729571182,80,3,>10K
338,news,10331,19072342,70.5111512059,80,4,>10K
339,remember,10326,19082668,70.5493268084,80,8,>10K
340,funny,10257,19092925,70.5872473154,80,5,>10K
341,talking,10246,19103171,70.625127155,80,7,>10K
342,head,10207,19113378,70.6628628101,80,4,>10K
343,kids,10175,19123553,70.7004801601,80,4,>10K
344,sometimes,10153,19133706,70.7380161752,80,9,>10K
345,left,10143,19143849,70.77551522,80,4,>10K
346,went,10133,19153982,70.8129772944,80,4,>10K
347,enjoy,10107,19164089,70.8503432458,80,5,>10K
348,meet,10085,19174174,70.8876278625,80,4,>10K
349,followers,10065,19184239,70.9248385384,80,9,>10K
350,summer,10033,19194272,70.9619309091,80,6,>10K
351,says,10001,19204273,70.9989049747,80,4,>10K
352,without,9979,19214252,71.0357977054,80,7,>1K
353,stuff,9944,19224196,71.0725610398,80,5,>1K
354,thinking,9833,19234029,71.1089140032,80,8,>1K
355,enough,9787,19243816,71.1450969028,80,6,>1K
356,part,9768,19253584,71.1812095588,80,4,>1K
357,early,9710,19263294,71.2171077866,80,5,>1K
358,service,9685,19272979,71.2529135885,80,7,>1K
359,times,9635,19282614,71.2885345386,80,5,>1K
360,b,9604,19292218,71.3240408805,80,1,>1K
361,city,9593,19301811,71.359506555,80,4,>1K
362,word,9560,19311371,71.3948502273,80,4,>1K
363,facebook,9530,19320901,71.4300829885,80,8,>1K
364,far,9507,19330408,71.4652307178,80,3,>1K
365,email,9496,19339904,71.5003377798,80,5,>1K
366,luck,9492,19349396,71.5354300536,80,4,>1K
367,hours,9491,19358887,71.5705186303,80,5,>1K
368,mind,9488,19368375,71.605596116,80,4,>1K
369,hi,9459,19377834,71.6405663875,80,2,>1K
370,ask,9380,19387214,71.6752445932,80,3,>1K
371,high,9346,19396560,71.7097970996,80,4,>1K
372,needs,9292,19405852,71.744149966,80,5,>1K
373,hell,9267,19415119,71.7784104065,80,4,>1K
374,care,9258,19424377,71.8126375737,80,4,>1K
375,tweets,9244,19433621,71.8468129823,80,6,>1K
376,ha,9219,19442840,71.8808959651,80,2,>1K
377,cause,9208,19452048,71.9149382804,80,5,>1K
378,heart,9094,19461142,71.9485591335,80,5,>1K
379,heard,9071,19470213,71.9820949548,80,5,>1K
380,send,9050,19479263,72.0155531383,80,4,>1K
381,myself,9022,19488285,72.0489078047,80,6,>1K
382,isn,9013,19497298,72.0822291979,80,3,>1K
383,fan,8928,19506226,72.1152363429,80,3,>1K
384,almost,8889,19515115,72.1480993034,80,6,>1K
385,haven,8887,19524002,72.1809548699,80,5,>1K
386,bring,8830,19532832,72.2135997053,80,5,>1K
387,saturday,8784,19541616,72.246074477,80,8,>1K
388,idea,8740,19550356,72.2783865791,80,4,>1K
389,business,8704,19559060,72.3105655879,80,8,>1K
390,seen,8687,19567747,72.342681747,80,4,>1K
391,sunday,8678,19576425,72.3747646328,80,6,>1K
392,wrong,8673,19585098,72.4068290334,80,5,>1K
393,works,8652,19593750,72.4388157962,80,5,>1K
394,girls,8609,19602359,72.4706435865,80,5,>1K
395,car,8602,19610961,72.5024454975,80,3,>1K
396,feeling,8571,19619532,72.5341328003,80,7,>1K
397,eat,8549,19628081,72.5657387683,80,3,>1K
398,probably,8498,19636579,72.5971561875,80,8,>1K
399,bed,8496,19645075,72.6285662126,80,3,>1K
400,kind,8492,19653567,72.6599614495,80,4,>1K
401,fans,8436,19662003,72.6911496524,80,4,>1K
402,buy,8429,19670432,72.722311976,80,3,>1K
403,used,8425,19678857,72.7534595115,80,4,>1K
404,least,8408,19687265,72.7845441973,80,5,>1K
405,hour,8398,19695663,72.8155919128,80,4,>1K
406,cant,8398,19704061,72.8466396283,80,4,>1K
407,sweet,8276,19712337,72.8772363052,80,5,>1K
408,late,8262,19720599,72.9077812237,80,4,>1K
409,okay,8216,19728815,72.9381560785,80,4,>1K
410,dude,8183,19736998,72.968408931,80,4,>1K
411,hair,8164,19745162,72.9985915399,80,4,>1K
412,gets,8132,19753294,73.0286558435,80,4,>1K
413,full,8108,19761402,73.0586314183,80,4,>1K
414,found,8045,19769447,73.0883740798,80,5,>1K
415,yourself,8040,19777487,73.1180982561,80,8,>1K
416,taking,8019,19785506,73.1477447946,80,6,>1K
417,meeting,8004,19793510,73.1773358775,80,7,>1K
418,room,7998,19801508,73.2069047783,80,4,>1K
419,post,7963,19809471,73.2363442827,80,4,>1K
420,lmao,7952,19817423,73.2657431197,80,4,>1K
421,monday,7925,19825348,73.2950421368,80,6,>1K
422,yesterday,7896,19833244,73.3242339398,80,9,>1K
423,seeing,7878,19841122,73.3533591961,80,6,>1K
424,once,7853,19848975,73.3823920265,80,4,>1K
425,whole,7771,19856746,73.4111216998,80,5,>1K
426,event,7762,19864508,73.4398180999,80,5,>1K
427,sad,7724,19872232,73.4683740125,80,3,>1K
428,super,7695,19879927,73.4968227111,80,5,>1K
429,bro,7671,19887598,73.5251826808,80,3,>1K
430,story,7652,19895250,73.5534724067,80,5,>1K
431,together,7647,19902897,73.5817436475,80,8,>1K
432,listening,7642,19910539,73.6099964032,80,9,>1K
433,social,7614,19918153,73.6381456417,80,6,>1K
434,perfect,7611,19925764,73.6662837892,80,7,>1K
435,tv,7564,19933328,73.6942481759,80,2,>1K
436,break,7532,19940860,73.7220942575,80,5,>1K
437,lunch,7517,19948377,73.7498848835,80,5,>1K
438,top,7490,19955867,73.7775756895,80,3,>1K
439,forget,7480,19963347,73.8052295252,80,6,>1K
440,join,7473,19970820,73.8328574816,80,4,>1K
441,black,7445,19978265,73.8603819209,80,5,>1K
442,t,7435,19985700,73.8878693899,80,1,>1K
443,called,7412,19993112,73.915271827,80,6,>1K
444,told,7365,20000477,73.9425005034,80,4,>1K
445,reading,7350,20007827,73.9696737243,80,7,>1K
446,set,7343,20015170,73.9968210659,80,3,>1K
447,lost,7316,20022486,74.0238685875,80,4,>1K
448,text,7297,20029783,74.0508458654,80,4,>1K
449,point,7296,20037079,74.0778194463,80,5,>1K
450,y,7269,20044348,74.1046932071,80,1,>1K
451,la,7246,20051594,74.1314819361,80,2,>1K
452,saying,7236,20058830,74.1582336948,80,6,>1K
453,rock,7226,20066056,74.1849484831,80,4,>1K
454,coffee,7218,20073274,74.2116336951,80,6,>1K
455,games,7211,20080485,74.2382930278,80,5,>1K
456,women,7203,20087688,74.2649227842,80,5,>1K
457,dinner,7174,20094862,74.2914453266,80,6,>1K
458,waiting,7156,20102018,74.3179013223,80,7,>1K
459,came,7140,20109158,74.3442981654,80,4,>1K
460,definitely,7126,20116284,74.37064325,80,10,>1K
461,special,7093,20123377,74.3968663324,80,7,>1K
462,course,7038,20130415,74.4228860778,80,6,>1K
463,m,7017,20137432,74.4488281854,80,1,>1K
464,seriously,6986,20144418,74.4746556848,80,9,>1K
465,leave,6979,20151397,74.500457305,80,5,>1K
466,c,6951,20158348,74.5261554081,80,1,>1K
467,line,6863,20165211,74.551528172,80,4,>1K
468,starting,6843,20172054,74.5768269952,80,8,>1K
469,media,6836,20178890,74.6020999391,80,5,>1K
470,cute,6805,20185695,74.6272582749,80,4,>1K
471,goes,6800,20192495,74.6523981255,80,4,>1K
472,boy,6787,20199282,74.6774899146,80,3,>1K
473,minutes,6774,20206056,74.7025336422,80,7,>1K
474,agree,6770,20212826,74.7275625817,80,5,>1K
475,words,6763,20219589,74.7525656419,80,5,>1K
476,red,6746,20226335,74.7775058525,80,3,>1K
477,learn,6717,20233052,74.802338849,80,5,>1K
478,bit,6705,20239757,74.8271274811,80,3,>1K
479,thats,6698,20246455,74.8518902339,80,5,>1K
480,problem,6682,20253137,74.8765938342,80,7,>1K
481,state,6665,20259802,74.9012345848,80,5,>1K
482,moment,6657,20266459,74.9258457591,80,6,>1K
483,half,6649,20273108,74.9504273571,80,4,>1K
484,started,6632,20279740,74.9749461055,80,7,>1K
485,tired,6620,20286360,74.9994204895,80,5,>1K
486,move,6575,20292935,75.0237285068,80,4,>1K
487,month,6533,20299468,75.0478812485,80,5,>1K
488,question,6495,20305963,75.0718935029,80,8,>1K
489,interesting,6475,20312438,75.0958318165,80,11,>1K
490,wants,6453,20318891,75.1196887953,80,5,>1K
491,white,6432,20325323,75.1434681363,80,5,>1K
492,loved,6432,20331755,75.1672474773,80,5,>1K
493,totally,6412,20338167,75.1909528776,80,7,>1K
494,bout,6409,20344576,75.2146471868,80,4,>1K
495,during,6404,20350980,75.2383230108,80,6,>1K
496,drink,6400,20357380,75.2619840466,80,5,>1K
497,hahaha,6387,20363767,75.285597021,80,6,>1K
498,less,6368,20370135,75.3091397517,80,4,>1K
499,missed,6360,20376495,75.332652906,80,6,>1K
500,later,6348,20382843,75.356121696,80,5,>1K
501,each,6313,20389156,75.3794610896,80,4,>1K
502,wonder,6310,20395466,75.4027893921,80,6,>1K
503,wanted,6293,20401759,75.426054845,80,6,>1K
504,gone,6276,20408035,75.4492574483,80,4,>1K
505,comes,6264,20414299,75.4724156871,80,5,>1K
506,mother,6245,20420544,75.4955036823,80,6,>1K
507,pick,6245,20426789,75.5185916774,80,4,>1K
508,took,6227,20433016,75.5416131259,80,4,>1K
509,chance,6210,20439226,75.5645717247,80,6,>1K
510,list,6199,20445425,75.5874896562,80,4,>1K
511,office,6195,20451620,75.6103927994,80,6,>1K
512,happen,6185,20457805,75.6332589724,80,6,>1K
513,yea,6166,20463971,75.6560549016,80,3,>1K
514,using,6164,20470135,75.6788434367,80,5,>1K
515,wonderful,6163,20476298,75.7016282748,80,9,>1K
516,online,6113,20482411,75.7242282611,80,6,>1K
517,ago,6103,20488514,75.746791277,80,3,>1K
518,weeks,6103,20494617,75.7693542929,80,5,>1K
519,beer,6098,20500715,75.7918988236,80,4,>1K
520,listen,6085,20506800,75.8143952929,80,6,>1K
521,means,6084,20512884,75.8368880651,80,5,>1K
522,page,6077,20518961,75.859354958,80,4,>1K
523,either,6067,20525028,75.8817848806,80,6,>1K
524,close,5993,20531021,75.9039412224,80,5,>1K
525,hello,5989,20537010,75.9260827761,80,5,>1K
526,lots,5987,20542997,75.9482169358,80,4,>1K
527,between,5956,20548953,75.9702364872,80,7,>1K
528,ah,5946,20554899,75.9922190684,80,2,>1K
529,outside,5917,20560816,76.0140944354,80,7,>1K
530,fall,5906,20566722,76.035929135,80,4,>1K
531,info,5897,20572619,76.0577305614,80,4,>1K
532,running,5887,20578506,76.0794950173,80,7,>1K
533,future,5873,20584379,76.1012077147,80,6,>1K
534,different,5872,20590251,76.1229167151,80,9,>1K
535,seems,5866,20596117,76.1446035333,80,5,>1K
536,men,5821,20601938,76.1661239848,80,3,>1K
537,reason,5821,20607759,76.1876444363,80,6,>1K
538,yo,5813,20613572,76.2091353115,80,2,>1K
539,chicago,5782,20619354,76.2305115786,80,7,>1K
540,second,5769,20625123,76.2518397842,80,6,>1K
541,dog,5758,20630881,76.2731273224,80,3,>1K
542,walk,5748,20636629,76.2943778902,80,4,>1K
543,rest,5727,20642356,76.3155508202,80,4,>1K
544,past,5712,20648068,76.3366682947,80,4,>1K
545,ugh,5703,20653771,76.3577524959,80,3,>1K
546,visit,5702,20659473,76.378833,80,5,>1K
547,child,5695,20665168,76.3998876249,80,5,>1K
548,turn,5668,20670836,76.4208424297,80,4,>1K
549,mine,5658,20676494,76.4417602642,80,4,>1K
550,worth,5648,20682142,76.4626411284,80,5,>1K
551,others,5644,20687786,76.4835072044,80,6,>1K
552,students,5622,20693408,76.5042919455,80,8,>1K
553,rain,5618,20699026,76.5250618986,80,4,>1K
554,proud,5598,20704624,76.5457579109,80,5,>1K
555,dm,5585,20710209,76.5664058617,80,2,>1K
556,site,5569,20715778,76.5869946599,80,4,>1K
557,dream,5555,20721333,76.6075316996,80,5,>1K
558,plan,5551,20726884,76.6280539512,80,4,>1K
559,beat,5532,20732416,76.648505959,80,4,>1K
560,mad,5526,20737942,76.6689357847,80,3,>1K
561,christmas,5526,20743468,76.6893656103,80,9,>1K
562,stupid,5522,20748990,76.7097806478,80,6,>1K
563,till,5498,20754488,76.7301069564,80,4,>1K
564,austin,5492,20759980,76.7504110828,80,6,>1K
565,three,5460,20765440,76.770596904,80,5,>1K
566,wasn,5454,20770894,76.790760543,80,4,>1K
567,number,5450,20776344,76.8109093938,80,6,>1K
568,writing,5446,20781790,76.8310434565,80,7,>1K
569,share,5446,20787236,76.8511775192,80,5,>1K
570,basketball,5440,20792676,76.8712893996,80,10,>1K
571,busy,5434,20798110,76.8913790979,80,4,>1K
572,dance,5417,20803527,76.9114059465,80,5,>1K
573,boys,5414,20808941,76.931421704,80,4,>1K
574,st,5399,20814340,76.951382006,80,2,>1K
575,side,5392,20819732,76.9713164287,80,4,>1K
576,art,5382,20825114,76.991213881,80,3,>1K
577,cold,5376,20830490,77.0110891511,80,4,>1K
578,spring,5361,20835851,77.0309089657,80,6,>1K
579,ill,5328,20841179,77.050606778,80,3,>1K
580,power,5275,20846454,77.0701086474,80,5,>1K
581,college,5267,20851721,77.0895809405,80,7,>1K
582,understand,5264,20856985,77.1090421425,80,10,>1K
583,trip,5263,20862248,77.1284996474,80,4,>1K
584,shout,5254,20867502,77.147923879,80,5,>1K
585,pay,5223,20872725,77.1672335025,80,3,>1K
586,yay,5222,20877947,77.186539429,80,3,>1K
587,deal,5218,20883165,77.2058305672,80,4,>1K
588,appreciate,5200,20888365,77.2250551589,80,10,>1K
589,ppl,5198,20893563,77.2442723564,80,3,>1K
590,vs,5183,20898746,77.2634340984,80,2,>1K
591,tho,5173,20903919,77.28255887,80,3,>1K
592,easy,5163,20909082,77.3016466713,80,4,>1K
593,kid,5148,20914230,77.320679017,80,3,>1K
594,bar,5130,20919360,77.3396448161,80,3,>1K
595,giving,5129,20924489,77.3586069181,80,6,>1K
596,website,5126,20929615,77.377557929,80,7,>1K
597,young,5121,20934736,77.3964904547,80,5,>1K
598,able,5121,20939857,77.4154229804,80,4,>1K
599,lets,5118,20944975,77.434344415,80,4,>1K
600,club,5114,20950089,77.4532510614,80,4,>1K
601,cuz,5112,20955201,77.4721503138,80,3,>1K
602,drive,5111,20960312,77.4910458692,80,5,>1K
603,thx,5111,20965423,77.5099414245,80,3,>1K
604,park,5106,20970529,77.5288184947,80,4,>1K
605,huge,5101,20975630,77.5476770797,80,4,>1K
606,against,5095,20980725,77.5665134824,80,7,>1K
607,single,5068,20985793,77.5852500652,80,6,>1K
608,blog,5059,20990852,77.6039533746,80,4,>1K
609,taken,5042,20995894,77.6225938344,80,5,>1K
610,ain,5018,21000912,77.6411455653,80,3,>1K
611,san,5000,21005912,77.6596307496,80,3,>1K
612,5000,5000,21010912,77.6781159338,80,4,>1K
613,matter,4999,21015911,77.696597421,80,6,>1K
614,thursday,4989,21020900,77.7150419379,80,8,>1K
615,finished,4972,21025872,77.7334236051,80,8,>1K
616,instead,4969,21030841,77.7517941812,80,7,>1K
617,water,4929,21035770,77.7700168759,80,5,>1K
618,weird,4928,21040698,77.7882358735,80,5,>1K
619,account,4927,21045625,77.806451174,80,7,>1K
620,woman,4925,21050550,77.8246590805,80,5,>1K
621,app,4915,21055465,77.8428300166,80,3,>1K
622,dear,4892,21060357,77.8609159209,80,4,>1K
623,dad,4882,21065239,77.8789648548,80,3,>1K
624,under,4875,21070114,77.8969879095,80,5,>1K
625,town,4872,21074986,77.914999873,80,4,>1K
626,fine,4869,21079855,77.9330007454,80,4,>1K
627,sound,4837,21084692,77.9508833127,80,5,>1K
628,success,4812,21089504,77.968673454,80,7,>1K
629,knew,4789,21094293,77.9863785635,80,4,>1K
630,project,4783,21099076,78.0040614907,80,7,>1K
631,band,4771,21103847,78.0217000536,80,4,>1K
632,green,4739,21108586,78.0392203112,80,5,>1K
633,couple,4704,21113290,78.0566111725,80,6,>1K
634,small,4702,21117992,78.0739946398,80,5,>1K
635,date,4699,21122691,78.091367016,80,4,>1K
636,lady,4694,21127385,78.108720907,80,4,>1K
637,film,4693,21132078,78.1260711009,80,4,>1K
638,write,4688,21136766,78.1434028097,80,5,>1K
639,experience,4672,21141438,78.1606753658,80,10,>1K
640,shows,4667,21146105,78.1779294368,80,5,>1K
641,fight,4645,21150750,78.195102173,80,5,>1K
642,final,4635,21155385,78.2122379388,80,5,>1K
643,eyes,4633,21160018,78.2293663105,80,4,>1K
644,tweeting,4620,21164638,78.2464466208,80,8,>1K
645,mention,4620,21169258,78.263526931,80,7,>1K
646,catch,4618,21173876,78.2805998472,80,5,>1K
647,voice,4600,21178476,78.2976062167,80,5,>1K
648,store,4596,21183072,78.3145977981,80,5,>1K
649,series,4595,21187667,78.3315856824,80,6,>1K
650,couldn,4588,21192255,78.3485476875,80,6,>1K
651,john,4587,21196842,78.3655059955,80,4,>1K
652,fire,4576,21201418,78.3824236361,80,4,>1K
653,street,4573,21205991,78.3993301857,80,6,>1K
654,fast,4553,21210544,78.4161627944,80,4,>1K
655,picture,4547,21215091,78.432973221,80,7,>1K
656,forever,4546,21219637,78.4497799505,80,7,>1K
657,group,4544,21224181,78.466579286,80,5,>1K
658,living,4541,21228722,78.4833675303,80,6,>1K
659,dead,4540,21233262,78.5001520776,80,4,>1K
660,conference,4537,21237799,78.5169255338,80,10,>1K
661,sign,4537,21242336,78.53369899,80,4,>1K
662,anymore,4529,21246865,78.5504428699,80,7,>1K
663,safe,4528,21251393,78.5671830528,80,4,>1K
664,nyc,4524,21255917,78.5839084475,80,3,>1K
665,lose,4518,21260435,78.60061166,80,4,>1K
666,everybody,4517,21264952,78.6173111754,80,9,>1K
667,eating,4512,21269464,78.6339922057,80,6,>1K
668,wouldn,4491,21273955,78.6505955982,80,6,>1K
669,radio,4478,21278433,78.6671509292,80,5,>1K
670,become,4473,21282906,78.683687775,80,6,>1K
671,behind,4469,21287375,78.7002098327,80,6,>1K
672,order,4461,21291836,78.7167023141,80,5,>1K
673,wit,4457,21296293,78.7331800074,80,3,>1K
674,bet,4454,21300747,78.7496466095,80,3,>1K
675,important,4453,21305200,78.7661095146,80,9,>1K
676,smh,4452,21309652,78.7825687226,80,3,>1K
677,google,4448,21314100,78.7990131426,80,6,>1K
678,body,4442,21318542,78.8154353803,80,4,>1K
679,album,4432,21322974,78.8318206476,80,5,>1K
680,die,4430,21327404,78.8481985208,80,3,>1K
681,starts,4422,21331826,78.8645468178,80,6,>1K
682,american,4420,21336246,78.8808877207,80,8,>1K
683,smile,4407,21340653,78.8971805621,80,5,>1K
684,add,4404,21345057,78.9134623124,80,3,>1K
685,happened,4399,21349456,78.9297255775,80,8,>1K
686,wear,4398,21353854,78.9459851455,80,4,>1K
687,wine,4396,21358250,78.9622373195,80,4,>1K
688,shot,4376,21362626,78.9784155528,80,4,>1K
689,history,4375,21367001,78.994590089,80,7,>1K
690,library,4369,21371370,79.010742443,80,7,>1K
691,sun,4368,21375738,79.0268911,80,3,>1K
692,gave,4355,21380093,79.0429916955,80,4,>1K
693,books,4352,21384445,79.0590811998,80,5,>1K
694,local,4345,21388790,79.0751448249,80,5,>1K
695,hopefully,4325,21393115,79.0911345093,80,9,>1K
696,short,4324,21397439,79.1071204967,80,5,>1K
697,hand,4310,21401749,79.1230547255,80,4,>1K
698,aren,4308,21406057,79.1389815603,80,4,>1K
699,april,4299,21410356,79.1548751217,80,5,>1K
700,vote,4297,21414653,79.170761289,80,4,>1K
701,tried,4290,21418943,79.1866215771,80,5,>1K
702,worst,4289,21423232,79.2024781682,80,5,>1K
703,interested,4276,21427508,79.2182866977,80,10,>1K
704,brother,4270,21431778,79.2340730451,80,7,>1K
705,feels,4265,21436043,79.2498409073,80,5,>1K
706,followed,4264,21440307,79.2656050724,80,8,>1K
707,e,4260,21444567,79.2813544494,80,1,>1K
708,stand,4257,21448824,79.2970927353,80,5,>1K
709,public,4246,21453070,79.3127903537,80,6,>1K
710,tour,4241,21457311,79.328469487,80,4,>1K
711,sent,4236,21461547,79.3441301351,80,4,>1K
712,company,4233,21465780,79.3597796921,80,7,>1K
713,center,4231,21470011,79.375421855,80,6,>1K
714,da,4227,21474238,79.3910492298,80,2,>1K
715,learning,4226,21478464,79.4066729075,80,8,>1K
716,cut,4196,21482660,79.4221856741,80,3,>1K
717,answer,4190,21486850,79.4376762585,80,6,>1K
718,save,4188,21491038,79.4531594489,80,4,>1K
719,light,4185,21495223,79.4686315481,80,5,>1K
720,loving,4183,21499406,79.4840962532,80,6,>1K
721,ones,4182,21503588,79.4995572614,80,4,>1K
722,fact,4172,21507760,79.5149812991,80,4,>1K
723,via,4171,21511931,79.5304016398,80,3,>1K
724,tuesday,4166,21516097,79.5458034953,80,7,>1K
725,songs,4152,21520249,79.5611535923,80,5,>1K
726,justin,4151,21524400,79.5764999923,80,6,>1K
727,moving,4110,21528510,79.5916948137,80,6,>1K
728,months,4103,21532613,79.6068637559,80,6,>1K
729,heading,4090,21536703,79.6219846367,80,7,>1K
730,son,4075,21540778,79.6370500618,80,3,>1K
731,pic,4058,21544836,79.6520526374,80,3,>1K
732,met,4057,21548893,79.6670515159,80,3,>1K
733,takes,4053,21552946,79.6820356062,80,5,>1K
734,link,4050,21556996,79.6970086055,80,4,>1K
735,message,4050,21561046,79.7119816047,80,7,>1K
736,sitting,4046,21565092,79.7269398158,80,7,>1K
737,hold,4018,21569110,79.7417945099,80,4,>1K
738,shoot,3999,21573109,79.7565789603,80,5,>1K
739,hurt,3997,21577106,79.7713560166,80,4,>1K
740,folks,3996,21581102,79.7861293758,80,5,>1K
741,asked,3996,21585098,79.8009027351,80,5,>1K
742,blue,3990,21589088,79.8156539121,80,4,>1K
743,case,3987,21593075,79.830393998,80,4,>1K
744,knows,3981,21597056,79.8451119017,80,5,>1K
745,country,3979,21601035,79.8598224114,80,7,>1K
746,available,3978,21605013,79.8745292239,80,9,>1K
747,concert,3978,21608991,79.8892360365,80,7,>1K
748,front,3975,21612966,79.903931758,80,5,>1K
749,re,3970,21616936,79.9186089943,80,2,>1K
750,dreams,3961,21620897,79.9332529573,80,6,>1K
751,exactly,3960,21624857,79.9478932232,80,7,>1K
752,beach,3960,21628817,79.9625334891,80,5,>1K
753,sharing,3948,21632765,79.9771293906,80,7,>1K
754,fb,3946,21636711,79.991717898,90,2,>1K
755,played,3942,21640653,80.0062916173,90,6,>1K
756,lucky,3935,21644588,80.0208394573,90,5,>1K
757,dc,3935,21648523,80.0353872973,90,2,>1K
758,alone,3934,21652457,80.0499314403,90,5,>1K
759,coach,3933,21656390,80.0644718862,90,5,>1K
760,national,3928,21660318,80.078993847,90,8,>1K
761,thoughts,3928,21664246,80.0935158077,90,8,>1K
762,football,3928,21668174,80.1080377685,90,8,>1K
763,forgot,3910,21672084,80.1224931826,90,6,>1K
764,community,3897,21675981,80.1369005352,90,9,>1K
765,breakfast,3893,21679874,80.1512930996,90,9,>1K
766,ideas,3888,21683762,80.1656671789,90,5,>1K
767,huh,3887,21687649,80.1800375612,90,3,>1K
768,x,3883,21691532,80.1943931552,90,1,>1K
769,wearing,3878,21695410,80.2087302642,90,7,>1K
770,watched,3872,21699282,80.2230451908,90,7,>1K
771,ice,3872,21703154,80.2373601175,90,3,>1K
772,afternoon,3864,21707018,80.2516454679,90,9,>1K
773,act,3863,21710881,80.2659271213,90,3,>1K
774,surprisingly,3858,21714739,80.2801902894,90,12,>1K
775,opening,3848,21718587,80.2944164872,90,7,>1K
776,ball,3846,21722433,80.308635291,90,4,>1K
777,questions,3832,21726265,80.3228023362,90,9,>1K
778,pm,3832,21730097,80.3369693814,90,2,>1K
779,enjoyed,3831,21733928,80.3511327296,90,7,>1K
780,bored,3825,21737753,80.3652738955,90,5,>1K
781,area,3822,21741575,80.3794039704,90,4,>1K
782,road,3813,21745388,80.3935007719,90,4,>1K
783,hoping,3810,21749198,80.4075864823,90,6,>1K
784,loves,3807,21753005,80.4216611016,90,5,>1K
785,cannot,3805,21756810,80.4357283268,90,6,>1K
786,rather,3804,21760614,80.449791855,90,6,>1K
787,ride,3800,21764414,80.463840595,90,4,>1K
788,children,3795,21768209,80.4778708499,90,8,>1K
789,obama,3777,21771986,80.491834558,90,5,>1K
790,sports,3771,21775757,80.505776084,90,6,>1K
791,session,3758,21779515,80.5196695485,90,7,>1K
792,absolutely,3744,21783259,80.5335112545,90,10,>1K
793,america,3725,21786984,80.5472827167,90,7,>1K
794,gift,3722,21790706,80.5610430879,90,4,>1K
795,speak,3720,21794426,80.574796065,90,5,>1K
796,contact,3714,21798140,80.5885268598,90,7,>1K
797,ladies,3703,21801843,80.6022169873,90,6,>1K
798,wake,3701,21805544,80.6158997207,90,4,>1K
799,cover,3686,21809230,80.6295269985,90,5,>1K
800,test,3686,21812916,80.6431542763,90,4,>1K
801,needed,3682,21816598,80.656766766,90,6,>1K
802,sister,3668,21820266,80.6703274972,90,6,>1K
803,strong,3667,21823933,80.6838845313,90,6,>1K
804,kill,3666,21827599,80.6974378684,90,4,>1K
805,air,3649,21831248,80.7109283559,90,3,>1K
806,hang,3648,21834896,80.7244151463,90,4,>1K
807,tips,3640,21838536,80.7378723605,90,4,>1K
808,mr,3630,21842166,80.7512926042,90,2,>1K
809,iphone,3629,21845795,80.764709151,90,6,>1K
810,paper,3619,21849414,80.7780887273,90,5,>1K
811,missing,3612,21853026,80.7914424244,90,7,>1K
812,interview,3611,21856637,80.8047924245,90,9,>1K
813,wife,3609,21860246,80.8181350305,90,4,>1K
814,congratulations,3593,21863839,80.8314184839,90,15,>1K
815,lil,3588,21867427,80.8446834521,90,3,>1K
816,pizza,3585,21871012,80.8579373292,90,5,>1K
817,bought,3576,21874588,80.871157933,90,6,>1K
818,trust,3567,21878155,80.8843452635,90,5,>1K
819,gym,3566,21881721,80.8975288969,90,3,>1K
820,along,3555,21885276,80.9106718629,90,5,>1K
821,heat,3555,21888831,80.9238148289,90,4,>1K
822,enjoying,3546,21892377,80.9369245216,90,8,>1K
823,parents,3534,21895911,80.9499898498,90,7,>1K
824,quite,3515,21899426,80.9629849343,90,5,>1K
825,wednesday,3514,21902940,80.9759763218,90,9,>1K
826,happens,3506,21906446,80.988938133,90,7,>1K
827,especially,3503,21909949,81.0018888531,90,10,>1K
828,whats,3501,21913450,81.0148321791,90,5,>1K
829,often,3481,21916931,81.0277015644,90,5,>1K
830,sales,3474,21920405,81.0405450704,90,5,>1K
831,plans,3471,21923876,81.0533774853,90,5,>1K
832,star,3470,21927346,81.0662062032,90,4,>1K
833,truth,3458,21930804,81.0789905566,90,5,>1K
834,possible,3454,21934258,81.0917601219,90,8,>1K
835,movies,3453,21937711,81.1045259902,90,6,>1K
836,market,3448,21941159,81.1172733732,90,6,>1K
837,spend,3446,21944605,81.1300133622,90,5,>1K
838,mothers,3437,21948042,81.1427200779,90,7,>1K
839,bus,3435,21951477,81.1554193994,90,3,>1K
840,quick,3434,21954911,81.168115024,90,5,>1K
841,march,3432,21958343,81.1808032545,90,5,>1K
842,miami,3428,21961771,81.1934766968,90,5,>1K
843,program,3423,21965194,81.2061316539,90,7,>1K
844,vegas,3416,21968610,81.2187607318,90,5,>1K
845,realize,3415,21972025,81.2313861127,90,7,>1K
846,west,3399,21975424,81.2439523409,90,4,>1K
847,goal,3389,21978813,81.2564815988,90,4,>1K
848,finish,3387,21982200,81.2690034626,90,6,>1K
849,sense,3385,21985585,81.2815179323,90,5,>1K
850,holiday,3379,21988964,81.2940102199,90,7,>1K
851,laugh,3377,21992341,81.3064951133,90,5,>1K
852,evening,3371,21995712,81.3189578245,90,7,>1K
853,internet,3364,21999076,81.3313946565,90,8,>1K
854,yours,3361,22002437,81.3438203974,90,5,>1K
855,yep,3359,22005796,81.3562387441,90,3,>1K
856,snow,3349,22009145,81.3686201206,90,4,>1K
857,wtf,3348,22012493,81.3809977999,90,3,>1K
858,serious,3341,22015834,81.3933496,90,7,>1K
859,lead,3333,22019167,81.4056718239,90,4,>1K
860,health,3328,22022495,81.4179755625,90,6,>1K
861,chocolate,3317,22025812,81.4302386337,90,9,>1K
862,door,3315,22029127,81.4424943109,90,4,>1K
863,tip,3311,22032438,81.4547351999,90,3,>1K
864,details,3311,22035749,81.4669760889,90,7,>1K
865,whatever,3292,22039041,81.4791467342,90,8,>1K
866,studio,3278,22042319,81.491265621,90,6,>1K
867,driving,3272,22045591,81.5033623256,90,7,>1K
868,fantastic,3271,22048862,81.5154553332,90,9,>1K
869,inside,3269,22052131,81.5275409466,90,6,>1K
870,gay,3263,22055394,81.5396043779,90,3,>1K
871,practice,3261,22058655,81.551660415,90,8,>1K
872,design,3260,22061915,81.5637127552,90,6,>1K
873,xd,3253,22065168,81.575739216,90,2,>1K
874,baseball,3250,22068418,81.5877545858,90,8,>1K
875,round,3235,22071653,81.5997145,90,5,>1K
876,episode,3228,22074881,81.611648535,90,7,>1K
877,hands,3224,22078105,81.6235677818,90,5,>1K
878,straight,3220,22081325,81.6354722404,90,8,>1K
879,somebody,3215,22084540,81.6473582139,90,8,>1K
880,chris,3205,22087745,81.659207217,90,5,>1K
881,idk,3204,22090949,81.6710525231,90,3,>1K
882,card,3198,22094147,81.6828756469,90,4,>1K
883,chicken,3197,22097344,81.6946950738,90,7,>1K
884,shut,3197,22100541,81.7065145006,90,4,>1K
885,south,3188,22103729,81.7183006541,90,5,>1K
886,everyday,3178,22106907,81.7300498372,90,8,>1K
887,exciting,3177,22110084,81.7417953232,90,8,>1K
888,step,3177,22113261,81.7535408093,90,4,>1K
889,training,3176,22116437,81.7652825984,90,8,>1K
890,sat,3169,22119606,81.7769985081,90,3,>1K
891,million,3164,22122770,81.7886959327,90,7,>1K
892,near,3163,22125933,81.8003896603,90,4,>1K
893,looked,3163,22129096,81.8120833878,90,6,>1K
894,fat,3160,22132256,81.8237660243,90,3,>1K
895,walking,3159,22135415,81.8354449637,90,7,>1K
896,cry,3149,22138564,81.8470869328,90,3,>1K
897,seem,3145,22141709,81.8587141136,90,4,>1K
898,em,3140,22144849,81.8703228094,90,2,>1K
899,awkward,3140,22147989,81.8819315051,90,7,>1K
900,ny,3139,22151128,81.8935365037,90,2,>1K
901,drinking,3137,22154265,81.9051341083,90,8,>1K
902,peace,3129,22157394,81.9167021367,90,5,>1K
903,mt,3129,22160523,81.928270165,90,2,>1K
904,due,3119,22163642,81.9398012229,90,3,>1K
905,aw,3116,22166758,81.9513211897,90,2,>1K
906,bill,3108,22169866,81.9628115803,90,4,>1K
907,article,3106,22172972,81.9742945767,90,7,>1K
908,nobody,3098,22176070,81.9857479969,90,6,>1K
909,touch,3098,22179168,81.997201417,90,5,>1K
910,track,3097,22182265,82.0086511402,90,5,>1K
911,data,3096,22185361,82.0200971663,90,4,>1K
912,photo,3094,22188455,82.0315357983,90,5,>1K
913,player,3093,22191548,82.0429707333,90,6,>1K
914,lord,3087,22194635,82.054383486,90,4,>1K
915,shopping,3087,22197722,82.0657962388,90,8,>1K
916,sale,3079,22200801,82.0771794152,90,4,>1K
917,space,3074,22203875,82.0885441065,90,5,>1K
918,retweet,3073,22206948,82.0999051008,90,7,>1K
919,student,3072,22210020,82.111262398,90,7,>1K
920,shirt,3067,22213087,82.12260121,90,5,>1K
921,plus,3059,22216146,82.1339104457,90,4,>1K
922,marketing,3053,22219199,82.1451974992,90,9,>1K
923,building,3048,22222247,82.1564660675,90,8,>1K
924,headed,3044,22225291,82.1677198477,90,6,>1K
925,middle,3033,22228324,82.1789329605,90,6,>1K
926,pictures,3032,22231356,82.1901423762,90,8,>1K
927,longer,3026,22234382,82.2013296097,90,6,>1K
928,minute,3019,22237401,82.212490964,90,6,>1K
929,death,3011,22240412,82.2236227419,90,5,>1K
930,3000,3000,22243412,82.2347138525,90,4,>1K
931,extra,2997,22246409,82.2457938719,90,5,>1K
932,players,2996,22249405,82.2568701943,90,7,>1K
933,planning,2993,22252398,82.2679354256,90,8,>1K
934,lovely,2979,22255377,82.2789488984,90,6,>1K
935,cheese,2973,22258350,82.289940189,90,6,>1K
936,mark,2969,22261319,82.3009166914,90,4,>1K
937,web,2965,22264284,82.3118784056,90,3,>1K
938,jesus,2965,22267249,82.3228401199,90,5,>1K
939,jobs,2962,22270211,82.3337907431,90,4,>1K
940,pain,2962,22273173,82.3447413662,90,4,>1K
941,calling,2962,22276135,82.3556919894,90,7,>1K
942,etc,2957,22279092,82.3666241273,90,3,>1K
943,issue,2955,22282047,82.3775488712,90,5,>1K
944,york,2955,22285002,82.3884736151,90,4,>1K
945,youtube,2949,22287951,82.3993761768,90,7,>1K
946,church,2947,22290898,82.4102713444,90,6,>1K
947,choice,2946,22293844,82.421162815,90,6,>1K
948,pics,2941,22296785,82.4320358003,90,4,>1K
949,fair,2937,22299722,82.4428939976,90,4,>1K
950,boston,2932,22302654,82.4537337096,90,6,>1K
951,worry,2931,22305585,82.4645697246,90,5,>1K
952,apparently,2925,22308510,82.4753835574,90,10,>1K
953,celebrate,2917,22311427,82.4861678139,90,9,>1K
954,easter,2912,22314339,82.4969335852,90,6,>1K
955,personal,2909,22317248,82.5076882654,90,8,>1K
956,holy,2909,22320157,82.5184429456,90,4,>1K
957,computer,2907,22323064,82.5291902317,90,8,>1K
958,meant,2898,22325962,82.5399042445,90,5,>1K
959,type,2893,22328855,82.5505997721,90,4,>1K
960,attention,2890,22331745,82.5612842086,90,9,>1K
961,hearing,2890,22334635,82.5719686451,90,7,>1K
962,hungry,2889,22337524,82.5826493846,90,6,>1K
963,eye,2889,22340413,82.5933301241,90,3,>1K
964,jealous,2885,22343298,82.6039960754,90,7,>1K
965,lives,2885,22346183,82.6146620267,90,5,>1K
966,putting,2882,22349065,82.6253168869,90,7,>1K
967,self,2880,22351945,82.635964353,90,4,>1K
968,field,2877,22354822,82.646600728,90,5,>1K
969,winning,2875,22357697,82.657229709,90,7,>1K
970,singing,2874,22360571,82.6678549929,90,7,>1K
971,president,2874,22363445,82.6784802768,90,9,>1K
972,spot,2871,22366316,82.6890944696,90,4,>1K
973,tuned,2864,22369180,82.6996827831,90,5,>1K
974,throw,2858,22372038,82.7102489145,90,5,>1K
975,energy,2855,22374893,82.7208039547,90,6,>1K
976,liked,2855,22377748,82.7313589949,90,5,>1K
977,girlfriend,2855,22380603,82.7419140351,90,10,>1K
978,officially,2846,22383449,82.752435802,90,10,>1K
979,learned,2846,22386295,82.7629575688,90,7,>1K
980,um,2838,22389133,82.7734497594,90,2,>1K
981,rip,2836,22391969,82.7839345559,90,3,>1K
982,board,2833,22394802,82.7944082613,90,5,>1K
983,king,2831,22397633,82.8048745727,90,4,>1K
984,smart,2828,22400461,82.8153297929,90,5,>1K
985,sit,2826,22403287,82.825777619,90,3,>1K
986,stage,2818,22406105,82.8361958689,90,5,>1K
987,figure,2817,22408922,82.8466104217,90,6,>1K
988,texas,2815,22411737,82.8570175804,90,5,>1K
989,asking,2814,22414551,82.8674210421,90,6,>1K
990,posted,2812,22417363,82.8778171097,90,6,>1K
991,joke,2808,22420171,82.8881983892,90,4,>1K
992,til,2807,22422978,82.8985759716,90,3,>1K
993,kick,2800,22425778,82.9089276748,90,4,>1K
994,changed,2798,22428576,82.9192719839,90,7,>1K
995,box,2794,22431370,82.9296015049,90,3,>1K
996,de,2792,22434162,82.9399236318,90,2,>1K
997,teacher,2787,22436949,82.9502272735,90,7,>1K
998,cat,2787,22439736,82.9605309152,90,3,>1K
999,create,2783,22442519,82.9708197688,90,6,>1K
1000,problems,2783,22445302,82.9811086223,90,8,>1K
1001,slow,2782,22448084,82.9913937788,90,4,>1K
1002,leaving,2779,22450863,83.0016678442,90,7,>1K
1003,artist,2778,22453641,83.0119382126,90,6,>1K
1004,btw,2777,22456418,83.0222048839,90,3,>1K
1005,race,2776,22459194,83.0324678582,90,4,>1K
1006,sir,2772,22461966,83.0427160444,90,3,>1K
1007,fresh,2763,22464729,83.0529309572,90,5,>1K
1008,dr,2762,22467491,83.063142173,90,2,>1K
1009,brown,2759,22470250,83.0733422977,90,5,>1K
1010,didnt,2758,22473008,83.0835387253,90,5,>1K
1011,telling,2755,22475763,83.0937240618,90,7,>1K
1012,poor,2754,22478517,83.1039057013,90,4,>1K
1013,tough,2749,22481266,83.1140688556,90,5,>1K
1014,drop,2749,22484015,83.1242320099,90,4,>1K
1015,law,2747,22486762,83.1343877701,90,3,>1K
1016,g,2747,22489509,83.1445435304,90,1,>1K
1017,woke,2743,22492252,83.1546845025,90,4,>1K
1018,shop,2742,22494994,83.1648217775,90,4,>1K
1019,truly,2733,22497727,83.1749257792,90,5,>1K
1020,spent,2733,22500460,83.1850297809,90,5,>1K
1021,paul,2732,22503192,83.1951300856,90,4,>1K
1022,hm,2727,22505919,83.2052119051,90,2,>1K
1023,four,2725,22508644,83.2152863305,90,4,>1K
1024,l,2724,22511368,83.2253570589,90,1,>1K
1025,alright,2722,22514090,83.2354203932,90,7,>1K
1026,biggest,2720,22516810,83.2454763334,90,7,>1K
1027,hilarious,2718,22519528,83.2555248796,90,9,>1K
1028,action,2716,22522244,83.2655660317,90,6,>1K
1029,delicious,2714,22524958,83.2755997897,90,9,>1K
1030,advice,2711,22527669,83.2856224566,90,6,>1K
1031,mike,2704,22530373,83.2956192442,90,4,>1K
1032,dress,2701,22533074,83.3056049408,90,5,>1K
1033,downtown,2700,22535774,83.3155869403,90,8,>1K
1034,study,2699,22538473,83.3255652427,90,5,>1K
1035,north,2695,22541168,83.335528757,90,5,>1K
1036,clean,2689,22543857,83.3454700891,90,5,>1K
1037,human,2687,22546544,83.3554040272,90,5,>1K
1038,key,2687,22549231,83.3653379652,90,3,>1K
1039,aint,2687,22551918,83.3752719032,90,4,>1K
1040,cream,2684,22554602,83.3851947501,90,5,>1K
1041,sing,2684,22557286,83.395117597,90,4,>1K
1042,research,2683,22559969,83.4050367469,90,8,>1K
1043,bowl,2681,22562650,83.4149485027,90,4,>1K
1044,performance,2680,22565330,83.4248565614,90,11,>1K
1045,crap,2670,22568000,83.4347276498,90,4,>1K
1046,gives,2668,22570668,83.4445913441,90,5,>1K
1047,gorgeous,2663,22573331,83.4544365533,90,8,>1K
1048,chat,2659,22575990,83.4642669743,90,4,>1K
1049,piece,2653,22578643,83.474075213,90,5,>1K
1050,worse,2652,22581295,83.4838797548,90,5,>1K
1051,david,2651,22583946,83.4936805995,90,5,>1K
1052,system,2651,22586597,83.5034814441,90,6,>1K
1053,drunk,2641,22589238,83.5132453185,90,5,>1K
1054,events,2639,22591877,83.5230017987,90,6,>1K
1055,warm,2638,22594515,83.5327545819,90,4,>1K
1056,swear,2635,22597150,83.542496274,90,5,>1K
1057,respect,2627,22599777,83.5522083898,90,7,>1K
1058,ahead,2624,22602401,83.5619094145,90,5,>1K
1059,lie,2621,22605022,83.5715993481,90,3,>1K
1060,buddy,2616,22607638,83.5812707965,90,5,>1K
1061,unless,2613,22610251,83.5909311538,90,6,>1K
1062,content,2613,22612864,83.6005915111,90,7,>1K
1063,boo,2610,22615474,83.6102407773,90,3,>1K
1064,dark,2610,22618084,83.6198900435,90,4,>1K
1065,j,2606,22620690,83.6295245215,90,1,>1K
1066,daily,2599,22623289,83.6391331203,90,5,>1K
1067,grow,2599,22625888,83.6487417191,90,4,>1K
1068,age,2597,22628485,83.6583429238,90,3,>1K
1069,agreed,2597,22631082,83.6679441285,90,6,>1K
1070,wins,2596,22633678,83.6775416361,90,4,>1K
1071,apple,2593,22636271,83.6871280527,90,5,>1K
1072,ticket,2591,22638862,83.6967070752,90,6,>1K
1073,control,2588,22641450,83.7062750065,90,7,>1K
1074,performing,2587,22644037,83.7158392409,90,10,>1K
1075,excellent,2585,22646622,83.7253960811,90,9,>1K
1076,major,2579,22649201,83.7349307392,90,5,>1K
1077,random,2578,22651779,83.7444617002,90,6,>1K
1078,k,2578,22654357,83.7539926612,90,1,>1K
1079,issues,2577,22656934,83.7635199251,90,6,>1K
1080,tea,2574,22659508,83.773036098,90,3,>1K
1081,shoes,2573,22662081,83.7825485738,90,5,>1K
1082,low,2572,22664653,83.7920573526,90,3,>1K
1083,stuck,2572,22667225,83.8015661314,90,5,>1K
1084,helping,2571,22669796,83.8110712131,90,7,>1K
1085,across,2569,22672365,83.8205689008,90,6,>1K
1086,seattle,2568,22674933,83.8300628914,90,7,>1K
1087,mobile,2563,22677496,83.8395383969,90,6,>1K
1088,double,2563,22680059,83.8490139023,90,6,>1K
1089,expect,2561,22682620,83.8584820137,90,6,>1K
1090,anyway,2557,22685177,83.8679353369,90,6,>1K
1091,tech,2557,22687734,83.8773886601,90,4,>1K
1092,felt,2556,22690290,83.8868382863,90,4,>1K
1093,cup,2553,22692843,83.8962768214,90,3,>1K
1094,style,2552,22695395,83.9057116594,90,5,>1K
1095,digital,2551,22697946,83.9151428005,90,7,>1K
1096,boyfriend,2550,22700496,83.9245702444,90,9,>1K
1097,east,2545,22703041,83.9339792032,90,4,>1K
1098,videos,2543,22705584,83.9433807679,90,6,>1K
1099,count,2539,22708123,83.9527675445,90,5,>1K
1100,entire,2539,22710662,83.962154321,90,6,>1K
1101,release,2536,22713198,83.9715300065,90,7,>1K
1102,photos,2528,22715726,83.9808761157,90,6,>1K
1103,official,2528,22718254,83.9902222248,90,8,>1K
1104,update,2528,22720782,83.999568334,90,6,>1K
1105,james,2527,22723309,84.0089107461,90,5,>1K
1106,usually,2526,22725835,84.0182494612,90,7,>1K
1107,joe,2522,22728357,84.0275733881,90,3,>1K
1108,wondering,2522,22730879,84.0368973151,90,9,>1K
1109,teams,2518,22733397,84.0462064539,90,5,>1K
1110,workout,2516,22735913,84.0555081986,90,7,>1K
1111,wedding,2515,22738428,84.0648062462,90,7,>1K
1112,difference,2513,22740941,84.0740968999,90,10,>1K
1113,calls,2508,22743449,84.0833690683,90,5,>1K
1114,train,2507,22745956,84.0926375397,90,5,>1K
1115,broke,2506,22748462,84.101902314,90,5,>1K
1116,florida,2505,22750967,84.1111633913,90,7,>1K
1117,earth,2503,22753470,84.1204170746,90,5,>1K
1118,worked,2502,22755972,84.1296670608,90,6,>1K
1119,drinks,2489,22758461,84.1388689855,90,6,>1K
1120,quote,2487,22760948,84.1480635161,90,5,>1K
1121,commercial,2487,22763435,84.1572580468,90,10,>1K
1122,thinks,2485,22765920,84.1664451834,90,6,>1K
1123,offer,2484,22768404,84.1756286229,90,5,>1K
1124,network,2481,22770885,84.1848009713,90,7,>1K
1125,yall,2481,22773366,84.1939733197,90,4,>1K
1126,annoying,2476,22775842,84.203127183,90,8,>1K
1127,level,2475,22778317,84.2122773492,90,5,>1K
1128,focus,2475,22780792,84.2214275154,90,5,>1K
1129,fake,2474,22783266,84.2305739846,90,4,>1K
1130,supposed,2472,22785738,84.2397130597,90,8,>1K
1131,positive,2470,22788208,84.2488447407,90,8,>1K
1132,ugly,2467,22790675,84.2579653306,90,4,>1K
1133,turned,2467,22793142,84.2670859205,90,6,>1K
1134,relationship,2465,22795607,84.2761991163,90,12,>1K
1135,thru,2455,22798062,84.2852753418,90,4,>1K
1136,soo,2450,22800512,84.2943330821,90,3,>1K
1137,goin,2449,22802961,84.3033871253,90,4,>1K
1138,ways,2446,22805407,84.3124300775,90,4,>1K
1139,likes,2444,22807851,84.3214656355,90,5,>1K
1140,price,2443,22810294,84.3304974966,90,5,>1K
1141,july,2441,22812735,84.3395219635,90,4,>1K
1142,completely,2437,22815172,84.3485316423,90,10,>1K
1143,education,2434,22817606,84.35753023,90,9,>1K
1144,roll,2433,22820039,84.3665251207,90,4,>1K
1145,dumb,2430,22822469,84.3755089202,90,4,>1K
1146,milwaukee,2428,22824897,84.3844853257,90,9,>1K
1147,speaking,2420,22827317,84.3934321549,90,8,>1K
1148,traffic,2420,22829737,84.4023789841,90,7,>1K
1149,goodnight,2417,22832154,84.4113147221,90,9,>1K
1150,aww,2402,22834556,84.4201950046,90,3,>1K
1151,nap,2399,22836955,84.4290641961,90,3,>1K
1152,happening,2395,22839350,84.4379185993,90,9,>1K
1153,complete,2395,22841745,84.4467730026,90,8,>1K
1154,lmfao,2394,22844139,84.4556237088,90,5,>1K
1155,code,2394,22846533,84.464474415,90,4,>1K
1156,note,2393,22848926,84.4733214242,90,4,>1K
1157,conversation,2392,22851318,84.4821647363,90,12,>1K
1158,hanging,2392,22853710,84.4910080485,90,7,>1K
1159,hall,2392,22856102,84.4998513606,90,4,>1K
1160,color,2387,22858489,84.5086761876,90,5,>1K
1161,notice,2385,22860874,84.5174936205,90,6,>1K
1162,greatest,2385,22863259,84.5263110534,90,8,>1K
1163,brand,2380,22865639,84.5351100011,90,5,>1K
1164,mouth,2379,22868018,84.5439052517,90,5,>1K
1165,winner,2378,22870396,84.5526968054,90,6,>1K
1166,draft,2378,22872774,84.561488359,90,5,>1K
1167,flight,2373,22875147,84.5702614275,90,6,>1K
1168,sell,2372,22877519,84.5790307989,90,4,>1K
1169,asleep,2369,22879888,84.5877890792,90,6,>1K
1170,dj,2367,22882255,84.5965399654,90,2,>1K
1171,talent,2366,22884621,84.6052871546,90,6,>1K
1172,daughter,2366,22886987,84.6140343438,90,8,>1K
1173,brain,2361,22889348,84.6227630478,90,5,>1K
1174,deep,2357,22891705,84.6314769636,90,4,>1K
1175,fear,2354,22894059,84.6401797884,90,4,>1K
1176,soul,2352,22896411,84.6488752191,90,4,>1K
1177,paid,2349,22898760,84.6575595586,90,4,>1K
1178,anybody,2340,22901100,84.6662106248,90,7,>1K
1179,five,2339,22903439,84.674857994,90,4,>1K
1180,choose,2332,22905771,84.683479484,90,6,>1K
1181,table,2324,22908095,84.6920713976,90,5,>1K
1182,pleasure,2322,22910417,84.7006559172,90,8,>1K
1183,keeps,2320,22912737,84.7092330427,90,5,>1K
1184,hotel,2318,22915055,84.7178027741,90,5,>1K
1185,shouldn,2309,22917364,84.7263392322,90,7,>1K
1186,died,2304,22919668,84.7348572051,90,4,>1K
1187,boring,2303,22921971,84.743371481,90,6,>1K
1188,career,2295,22924266,84.7518561805,90,6,>1K
1189,taste,2293,22926559,84.760333486,90,5,>1K
1190,information,2291,22928850,84.7688033975,90,11,>1K
1191,michael,2288,22931138,84.7772622178,90,7,>1K
1192,blessed,2276,22933414,84.7856766736,90,7,>1K
1193,diego,2272,22935686,84.7940763414,90,5,>1K
1194,yup,2270,22937956,84.802468615,90,3,>1K
1195,showing,2268,22940224,84.8108534946,90,7,>1K
1196,realized,2265,22942489,84.8192272831,90,8,>1K
1197,terrible,2263,22944752,84.8275936775,90,8,>1K
1198,lately,2263,22947015,84.8359600719,90,6,>1K
1199,born,2262,22949277,84.8443227692,90,4,>1K
1200,secret,2257,22951534,84.8526669814,90,6,>1K
1201,report,2255,22953789,84.8610037995,90,6,>1K
1202,doubt,2254,22956043,84.8693369205,90,5,>1K
1203,crew,2251,22958294,84.8776589505,90,4,>1K
1204,keeping,2251,22960545,84.8859809804,90,7,>1K
1205,pants,2249,22962794,84.8942956163,90,5,>1K
1206,imagine,2247,22965041,84.9026028581,90,7,>1K
1207,contest,2243,22967284,84.9108953118,90,7,>1K
1208,floor,2243,22969527,84.9191877654,90,5,>1K
1209,opportunity,2241,22971768,84.927472825,90,11,>1K
1210,indeed,2240,22974008,84.9357541876,90,6,>1K
1211,version,2238,22976246,84.944028156,90,7,>1K
1212,caught,2236,22978482,84.9522947304,90,6,>1K
1213,loud,2236,22980718,84.9605613048,90,4,>1K
1214,steve,2235,22982953,84.9688241822,90,5,>1K
1215,build,2229,22985182,84.9770648773,90,5,>1K
1216,homework,2227,22987409,84.9852981784,90,8,>1K
1217,review,2226,22989635,84.9935277824,90,6,>1K
1218,checking,2225,22991860,85.0017536894,90,8,>1K
1219,lakers,2223,22994083,85.0099722023,90,6,>1K
1220,except,2223,22996306,85.0181907153,90,6,>1K
1221,search,2221,22998527,85.0264018341,90,6,>1K
1222,sleeping,2216,23000743,85.0345944678,90,8,>1K
1223,healthy,2216,23002959,85.0427871014,90,7,>1K
1224,bag,2215,23005174,85.0509760381,90,3,>1K
1225,fix,2212,23007386,85.0591538836,90,3,>1K
1226,nba,2209,23009595,85.067320638,90,3,>1K
1227,sold,2204,23011799,85.0754689072,90,4,>1K
1228,v,2203,23014002,85.0836134794,90,1,>1K
1229,stories,2202,23016204,85.0917543545,90,7,>1K
1230,given,2189,23018393,85.0998471682,90,5,>1K
1231,ima,2188,23020581,85.1079362848,90,3,>1K
1232,currently,2187,23022768,85.1160217044,90,9,>1K
1233,score,2185,23024953,85.1240997299,90,5,>1K
1234,scared,2181,23027134,85.1321629673,90,6,>1K
1235,points,2180,23029314,85.1402225076,90,6,>1K
1236,houston,2174,23031488,85.1482598658,90,7,>1K
1237,fly,2173,23033661,85.1562935268,90,3,>1K
1238,winter,2173,23035834,85.1643271879,90,6,>1K
1239,bike,2171,23038005,85.1723534549,90,4,>1K
1240,literally,2168,23040173,85.1803686308,90,9,>1K
1241,nights,2167,23042340,85.1883801097,90,6,>1K
1242,begin,2165,23044505,85.1963841944,90,5,>1K
1243,wisdom,2163,23046668,85.2043808852,90,6,>1K
1244,alive,2163,23048831,85.2123775759,90,5,>1K
1245,ipad,2163,23050994,85.2203742666,90,4,>1K
1246,travel,2160,23053154,85.2283598662,90,6,>1K
1247,return,2160,23055314,85.2363454658,90,6,>1K
1248,breaking,2159,23057473,85.2443273683,90,8,>1K
1249,nfl,2156,23059629,85.2522981798,90,3,>1K
1250,festival,2156,23061785,85.2602689912,90,8,>1K
1251,reply,2156,23063941,85.2682398027,90,5,>1K
1252,blast,2154,23066095,85.2762032201,90,5,>1K
1253,killed,2154,23068249,85.2841666374,90,6,>1K
1254,reach,2150,23070399,85.2921152667,90,5,>1K
1255,league,2144,23072543,85.3000417137,90,6,>1K
1256,freaking,2144,23074687,85.3079681607,90,8,>1K
1257,shower,2142,23076829,85.3158872136,90,6,>1K
1258,decided,2141,23078970,85.3238025695,90,7,>1K
1259,direction,2139,23081109,85.3317105313,90,9,>1K
1260,wall,2134,23083243,85.339600008,90,4,>1K
1261,station,2124,23085367,85.3474525142,90,7,>1K
1262,schedule,2122,23087489,85.3552976264,90,8,>1K
1263,brought,2122,23089611,85.3631427386,90,7,>1K
1264,min,2119,23091730,85.3709767597,90,3,>1K
1265,luv,2117,23093847,85.3788033867,90,3,>1K
1266,fam,2117,23095964,85.3866300138,90,3,>1K
1267,deserve,2116,23098080,85.3944529437,90,7,>1K
1268,mood,2103,23100183,85.4022278122,90,4,>1K
1269,based,2101,23102284,85.4099952866,90,5,>1K
1270,trouble,2099,23104383,85.417755367,90,7,>1K
1271,sending,2095,23106478,85.4255006592,90,7,>1K
1272,finding,2094,23108572,85.4332422544,90,7,>1K
1273,pop,2092,23110664,85.4409764555,90,3,>1K
1274,promise,2089,23112753,85.4486995654,90,7,>1K
1275,signed,2087,23114840,85.4564152813,90,6,>1K
1276,loss,2087,23116927,85.4641309973,90,4,>1K
1277,process,2084,23119011,85.4718356221,90,7,>1K
1278,simple,2084,23121095,85.4795402468,90,6,>1K
1279,places,2081,23123176,85.4872337805,90,6,>1K
1280,happiness,2081,23125257,85.4949273142,90,9,>1K
1281,smell,2079,23127336,85.5026134538,90,5,>1K
1282,clear,2079,23129415,85.5102995934,90,5,>1K
1283,tune,2078,23131493,85.517982036,90,4,>1K
1284,closed,2074,23133567,85.5256496905,90,6,>1K
1285,feet,2071,23135638,85.5333062538,90,4,>1K
1286,bless,2071,23137709,85.5409628171,90,5,>1K
1287,nope,2067,23139776,85.5486045923,90,4,>1K
1288,members,2066,23141842,85.5562426704,90,7,>1K
1289,quality,2066,23143908,85.5638807485,90,7,>1K
1290,teach,2064,23145972,85.5715114326,90,5,>1K
1291,treat,2063,23148035,85.5791384196,90,5,>1K
1292,press,2063,23150098,85.5867654066,90,5,>1K
1293,creative,2062,23152160,85.5943886966,90,8,>1K
1294,staff,2060,23154220,85.6020045925,90,5,>1K
1295,bday,2060,23156280,85.6096204884,90,4,>1K
1296,killing,2060,23158340,85.6172363844,90,7,>1K
1297,dallas,2059,23160399,85.6248485832,90,6,>1K
1298,yr,2057,23162456,85.632453388,90,2,>1K
1299,vacation,2057,23164513,85.6400581928,90,8,>1K
1300,broken,2056,23166569,85.6476593006,90,6,>1K
1301,present,2056,23168625,85.6552604084,90,7,>1K
1302,reality,2055,23170680,85.6628578191,90,7,>1K
1303,bunch,2050,23172730,85.6704367446,90,5,>1K
1304,war,2048,23174778,85.6780082761,90,3,>1K
1305,per,2045,23176823,85.6855687165,90,3,>1K
1306,fit,2045,23178868,85.6931291568,90,3,>1K
1307,mix,2043,23180911,85.7006822031,90,3,>1K
1308,cc,2041,23182952,85.7082278553,90,2,>1K
1309,tweeted,2041,23184993,85.7157735075,90,7,>1K
1310,kiss,2039,23187032,85.7233117657,90,4,>1K
1311,somewhere,2037,23189069,85.7308426297,90,9,>1K
1312,def,2037,23191106,85.7383734938,90,3,>1K
1313,wishing,2037,23193143,85.7459043579,90,7,>1K
1314,dogs,2030,23195173,85.7534093427,90,4,>1K
1315,profile,2029,23197202,85.7609106305,90,7,>1K
1316,feed,2027,23199229,85.7684045242,90,4,>1K
1317,ate,2019,23201248,85.7758688416,90,3,>1K
1318,finals,2019,23203267,85.783333159,90,6,>1K
1319,uh,2017,23205284,85.7907900823,90,2,>1K
1320,fish,2017,23207301,85.7982470056,90,4,>1K
1321,2014,2014,23209315,85.8056928378,90,4,>1K
1322,2013,2013,23211328,85.813134973,90,4,>1K
1323,2012,2012,23213340,85.8205734112,90,4,>1K
1324,2011,2011,23215351,85.8280081523,90,4,>1K
1325,2010,2010,23217361,85.8354391963,90,4,>1K
1326,2009,2009,23219370,85.8428665434,90,4,>1K
1327,2008,2008,23221378,85.8502901934,90,4,>1K
1328,updates,2007,23223385,85.8577101463,90,7,>1K
1329,2007,2007,23225392,85.8651300993,90,4,>1K
1330,2006,2006,23227398,85.8725463552,90,4,>1K
1331,2005,2005,23229403,85.8799589141,90,4,>1K
1332,2004,2004,23231407,85.8873677759,90,4,>1K
1333,2003,2003,23233410,85.8947729408,90,4,>1K
1334,dancing,2002,23235412,85.9021744085,90,7,>1K
1335,2002,2002,23237414,85.9095758763,90,4,>1K
1336,award,2001,23239415,85.916973647,90,5,>1K
1337,2001,2001,23241416,85.9243714178,90,4,>1K
1338,2000,2000,23243416,85.9317654915,90,4,>1K
1339,english,1999,23245415,85.9391558681,90,7,>1K
1340,1999,1999,23247414,85.9465462448,90,4,>1K
1341,1998,1998,23249412,85.9539329244,90,4,>1K
1342,bye,1998,23251410,85.9613196041,90,3,>1K
1343,denver,1997,23253407,85.9687025867,90,6,>1K
1344,1996,1996,23255403,85.9760818722,90,4,>1K
1345,1995,1995,23257398,85.9834574607,90,4,>1K
1346,1994,1994,23259392,85.9908293522,90,4,>1K
1347,earlier,1994,23261386,85.9982012437,90,7,>1K
1348,surprised,1992,23263378,86.0055657411,90,9,>1K
1349,bc,1989,23265367,86.0129191474,90,2,>1K
1350,spread,1989,23267356,86.0202725537,90,6,>1K
1351,moms,1989,23269345,86.02762596,90,4,>1K
1352,credit,1987,23271332,86.0349719722,90,6,>1K
1353,wild,1987,23273319,86.0423179844,90,4,>1K
1354,wont,1987,23275306,86.0496639967,90,4,>1K
1355,shooting,1986,23277292,86.0570063118,90,8,>1K
1356,police,1978,23279270,86.0643190507,90,6,>1K
1357,within,1977,23281247,86.0716280926,90,6,>1K
1358,spending,1976,23283223,86.0789334374,90,8,>1K
1359,honestly,1973,23285196,86.0862276911,90,8,>1K
1360,restaurant,1970,23287166,86.0935108537,90,10,>1K
1361,handle,1964,23289130,86.1007718341,90,6,>1K
1362,beyond,1963,23291093,86.1080291174,90,6,>1K
1363,shall,1960,23293053,86.1152753096,90,5,>1K
1364,screen,1960,23295013,86.1225215019,90,6,>1K
1365,crying,1958,23296971,86.1297603,90,6,>1K
1366,miles,1957,23298928,86.1369954011,90,5,>1K
1367,jersey,1954,23300882,86.1442194112,90,6,>1K
1368,fail,1954,23302836,86.1514434212,90,4,>1K
1369,shots,1951,23304787,86.1586563401,90,5,>1K
1370,successful,1950,23306737,86.1658655619,90,10,>1K
1371,channel,1949,23308686,86.1730710867,90,7,>1K
1372,thanksgiving,1948,23310634,86.1802729145,90,12,>1K
1373,latest,1946,23312580,86.1874673482,90,6,>1K
1374,view,1945,23314525,86.1946580849,90,4,>1K
1375,pull,1945,23316470,86.2018488216,90,4,>1K
1376,hurts,1943,23318413,86.2090321642,90,5,>1K
1377,dat,1942,23320355,86.2162118097,90,3,>1K
1378,services,1941,23322296,86.2233877583,90,8,>1K
1379,f,1940,23324236,86.2305600098,90,1,>1K
1380,alot,1936,23326172,86.2377174731,90,4,>1K
1381,tom,1934,23328106,86.2448675424,90,3,>1K
1382,address,1932,23330038,86.2520102176,90,7,>1K
1383,suggestions,1930,23331968,86.2591454987,90,11,>1K
1384,ryan,1930,23333898,86.2662807798,90,4,>1K
1385,museum,1919,23335817,86.2733753935,90,6,>1K
1386,match,1918,23337735,86.2804663102,90,5,>1K
1387,cats,1917,23339652,86.2875535299,90,4,>1K
1388,challenge,1916,23341568,86.2946370525,90,9,>1K
1389,cheers,1916,23343484,86.3017205751,90,6,>1K
1390,thunder,1916,23345400,86.3088040977,90,7,>1K
1391,co,1915,23347315,86.3158839232,90,2,>1K
1392,county,1911,23349226,86.3229489607,90,6,>1K
1393,boss,1906,23351132,86.3299955129,90,4,>1K
1394,magic,1903,23353035,86.337030974,90,5,>1K
1395,value,1902,23354937,86.3440627381,90,5,>1K
1396,booth,1899,23356836,86.3510834111,90,5,>1K
1397,presentation,1899,23358735,86.3581040841,90,12,>1K
1398,customer,1898,23360633,86.36512106,90,8,>1K
1399,matt,1897,23362530,86.3721343389,90,4,>1K
1400,buying,1896,23364426,86.3791439208,90,6,>1K
1401,connect,1881,23366307,86.3860980471,90,7,>1K
1402,uk,1880,23368187,86.3930484764,90,2,>1K
1403,plz,1877,23370064,86.3999878146,90,3,>1K
1404,beauty,1875,23371939,86.4069197587,90,6,>1K
1405,easier,1875,23373814,86.4138517028,90,6,>1K
1406,afraid,1873,23375687,86.4207762528,90,6,>1K
1407,trade,1870,23377557,86.4276897117,90,5,>1K
1408,knowing,1869,23379426,86.4345994736,90,7,>1K
1409,results,1868,23381294,86.4415055384,90,7,>1K
1410,ran,1868,23383162,86.4484116032,90,3,>1K
1411,judge,1868,23385030,86.4553176681,90,5,>1K
1412,clothes,1867,23386897,86.4622200359,90,7,>1K
1413,access,1867,23388764,86.4691224037,90,6,>1K
1414,teaching,1866,23390630,86.4760210744,90,8,>1K
1415,bieber,1865,23392495,86.4829160482,90,6,>1K
1416,staying,1863,23394358,86.4898036278,90,7,>1K
1417,playoffs,1863,23396221,86.4966912075,90,8,>1K
1418,washington,1861,23398082,86.5035713931,90,10,>1K
1419,cards,1861,23399943,86.5104515786,90,5,>1K
1420,gas,1860,23401803,86.5173280672,90,3,>1K
1421,themselves,1860,23403663,86.5242045557,90,10,>1K
1422,fashion,1858,23405521,86.5310736502,90,7,>1K
1423,crowd,1857,23407378,86.5379390476,90,5,>1K
1424,honor,1856,23409234,86.544800748,90,5,>1K
1425,artists,1856,23411090,86.5516624484,90,7,>1K
1426,picked,1854,23412944,86.5585167547,90,6,>1K
1427,block,1853,23414797,86.565367364,90,5,>1K
1428,marriage,1851,23416648,86.5722105792,90,8,>1K
1429,copy,1850,23418498,86.5790500974,90,4,>1K
1430,jazz,1849,23420347,86.5858859185,90,4,>1K
1431,blood,1847,23422194,86.5927143456,90,5,>1K
1432,twice,1843,23424037,86.5995279845,90,5,>1K
1433,rich,1842,23425879,86.6063379264,90,4,>1K
1434,ma,1839,23427718,86.6131367772,90,2,>1K
1435,beginning,1839,23429557,86.6199356279,90,9,>1K
1436,named,1839,23431396,86.6267344787,90,5,>1K
1437,bay,1835,23433231,86.6335185413,90,3,>1K
1438,fell,1833,23435064,86.6402952099,90,4,>1K
1439,continue,1833,23436897,86.6470718784,90,8,>1K
1440,smoke,1829,23438726,86.6538337588,90,5,>1K
1441,dirty,1829,23440555,86.6605956392,90,5,>1K
1442,product,1828,23442383,86.6673538226,90,7,>1K
1443,pool,1828,23444211,86.6741120059,90,4,>1K
1444,panel,1828,23446039,86.6808701893,90,5,>1K
1445,gettin,1819,23447858,86.6875950993,90,6,>1K
1446,romney,1819,23449677,86.6943200094,90,6,>1K
1447,cd,1817,23451494,86.7010375253,90,2,>1K
1448,horrible,1811,23453305,86.7077328591,90,8,>1K
1449,stars,1809,23455114,86.7144207987,90,5,>1K
1450,airport,1807,23456921,86.7211013443,90,7,>1K
1451,model,1807,23458728,86.7277818899,90,5,>1K
1452,technology,1801,23460529,86.7344402533,90,10,>1K
1453,court,1799,23462328,86.7410912226,90,5,>1K
1454,awake,1798,23464126,86.7477384948,90,5,>1K
1455,marathon,1797,23465923,86.7543820701,90,8,>1K
1456,gold,1795,23467718,86.7610182512,90,4,>1K
1457,ive,1789,23469507,86.7676322501,90,3,>1K
1458,stick,1789,23471296,86.7742462491,90,5,>1K
1459,grand,1789,23473085,86.780860248,90,5,>1K
1460,campaign,1784,23474869,86.7874557617,90,8,>1K
1461,inspiration,1781,23476650,86.7940401844,90,11,>1K
1462,bringing,1778,23478428,86.8006135159,90,8,>1K
1463,current,1778,23480206,86.8071868474,90,7,>1K
1464,asap,1778,23481984,86.8137601789,90,4,>1K
1465,faith,1778,23483762,86.8203335104,90,5,>1K
1466,pack,1777,23485539,86.8269031449,90,4,>1K
1467,thankful,1776,23487315,86.8334690824,90,8,>1K
1468,portland,1776,23489091,86.8400350198,90,8,>1K
1469,including,1775,23490866,86.8465972602,90,9,>1K
1470,helps,1773,23492639,86.8531521066,90,5,>1K
1471,losing,1771,23494410,86.8596995588,90,6,>1K
1472,everywhere,1771,23496181,86.8662470111,90,10,>1K
1473,laughing,1769,23497950,86.8727870693,90,8,>1K
1474,acting,1769,23499719,86.8793271275,90,6,>1K
1475,weight,1764,23501483,86.8858487005,90,6,>1K
1476,scary,1762,23503245,86.8923628794,90,5,>1K
1477,mess,1762,23505007,86.8988770583,90,4,>1K
1478,woo,1761,23506768,86.9053875402,90,3,>1K
1479,member,1758,23508526,86.911886931,90,6,>1K
1480,talked,1756,23510282,86.9183789277,90,6,>1K
1481,hahah,1754,23512036,86.9248635304,90,5,>1K
1482,original,1752,23513788,86.9313407389,90,8,>1K
1483,tax,1752,23515540,86.9378179475,90,3,>1K
1484,guest,1746,23517286,86.9442729738,90,5,>1K
1485,george,1746,23519032,86.9507280002,90,6,>1K
1486,period,1746,23520778,86.9571830265,90,6,>1K
1487,fabulous,1746,23522524,86.9636380528,90,8,>1K
1488,scene,1745,23524269,86.9700893822,90,5,>1K
1489,wrote,1744,23526013,86.9765370144,90,5,>1K
1490,chill,1742,23527755,86.9829772526,90,5,>1K
1491,id,1741,23529496,86.9894137938,90,2,>1K
1492,teachers,1738,23531234,86.9958392438,90,8,>1K
1493,known,1738,23532972,87.0022646939,90,5,>1K
1494,changes,1737,23534709,87.0086864469,90,7,>1K
1495,main,1735,23536444,87.0151008058,90,4,>1K
1496,pray,1735,23538179,87.0215151647,90,4,>1K
1497,trending,1734,23539913,87.0279258266,90,8,>1K
1498,mall,1734,23541647,87.0343364885,90,4,>1K
1499,jack,1734,23543381,87.0407471504,90,4,>1K
1500,ad,1733,23545114,87.0471541153,90,2,>1K
1501,products,1732,23546846,87.0535573831,90,8,>1K
1502,added,1732,23548578,87.059960651,90,5,>1K
1503,row,1730,23550308,87.0663565247,90,3,>1K
1504,hill,1730,23552038,87.0727523985,90,4,>1K
1505,golf,1726,23553764,87.0791334841,90,4,>1K
1506,french,1726,23555490,87.0855145697,90,6,>1K
1507,university,1725,23557215,87.0918919582,90,10,>1K
1508,babe,1725,23558940,87.0982693468,90,4,>1K
1509,consider,1724,23560664,87.1046430383,90,8,>1K
1510,science,1722,23562386,87.1110093358,90,7,>1K
1511,total,1722,23564108,87.1173756333,90,5,>1K
1512,yum,1719,23565827,87.1237308396,90,3,>1K
1513,cost,1718,23567545,87.1300823489,90,4,>1K
1514,schools,1715,23569260,87.1364227671,90,7,>1K
1515,sometime,1714,23570974,87.1427594883,90,8,>1K
1516,quit,1714,23572688,87.1490962094,90,4,>1K
1517,comment,1713,23574401,87.1554292336,90,7,>1K
1518,tix,1713,23576114,87.1617622577,90,3,>1K
1519,peeps,1701,23577815,87.1680509174,90,5,>1K
1520,beats,1700,23579515,87.17433588,90,5,>1K
1521,merry,1699,23581214,87.1806171456,90,5,>1K
1522,character,1699,23582913,87.1868984112,90,9,>1K
1523,wat,1699,23584612,87.1931796768,90,3,>1K
1524,surprise,1697,23586309,87.1994535484,90,8,>1K
1525,industry,1696,23588005,87.2057237229,90,8,>1K
1526,cleaning,1695,23589700,87.2119902003,90,8,>1K
1527,moved,1695,23591395,87.2182566778,90,5,>1K
1528,third,1695,23593090,87.2245231553,90,5,>1K
1529,joy,1693,23594783,87.2307822387,90,3,>1K
1530,jump,1693,23596476,87.237041322,90,4,>1K
1531,response,1690,23598166,87.2432893143,90,8,>1K
1532,holding,1689,23599855,87.2495336096,90,7,>1K
1533,stopped,1688,23601543,87.2557742078,90,7,>1K
1534,q,1688,23603231,87.262014806,90,1,>1K
1535,bigger,1688,23604919,87.2682554042,90,6,>1K
1536,lazy,1687,23606606,87.2744923053,90,4,>1K
1537,al,1686,23608292,87.2807255095,90,2,>1K
1538,perhaps,1686,23609978,87.2869587136,90,7,>1K
1539,fox,1685,23611663,87.2931882207,90,3,>1K
1540,decision,1685,23613348,87.2994177278,90,8,>1K
1541,pro,1683,23615031,87.3056398408,90,3,>1K
1542,goals,1683,23616714,87.3118619538,90,5,>1K
1543,hmm,1683,23618397,87.3180840668,90,3,>1K
1544,mac,1680,23620077,87.3242950888,90,3,>1K
1545,famous,1674,23621751,87.3304839284,90,6,>1K
1546,prom,1674,23623425,87.3366727681,90,4,>1K
1547,common,1670,23625095,87.3428468197,90,6,>1K
1548,hunger,1669,23626764,87.3490171742,90,6,>1K
1549,ends,1667,23628431,87.3551801346,90,4,>1K
1550,form,1666,23630097,87.361339398,90,4,>1K
1551,drama,1665,23631762,87.3674949644,90,5,>1K
1552,follower,1665,23633427,87.3736505307,90,8,>1K
1553,atlanta,1664,23635091,87.3798024,90,7,>1K
1554,coast,1661,23636752,87.3859431782,90,5,>1K
1555,shoutout,1660,23638412,87.3920802594,90,8,>1K
1556,sunny,1659,23640071,87.3982136436,90,5,>1K
1557,decide,1659,23641730,87.4043470277,90,6,>1K
1558,epic,1659,23643389,87.4104804118,90,4,>1K
1559,annual,1656,23645045,87.4166027048,90,6,>1K
1560,lights,1652,23646697,87.4227102097,90,6,>1K
1561,mail,1651,23648348,87.4288140176,90,4,>1K
1562,hitting,1650,23649998,87.4349141284,90,7,>1K
1563,bottle,1650,23651648,87.4410142392,90,6,>1K
1564,yellow,1647,23653295,87.4471032589,90,6,>1K
1565,ed,1644,23654939,87.4531811875,90,2,>1K
1566,blow,1643,23656582,87.459255419,90,4,>1K
1567,married,1637,23658219,87.4653074683,90,7,>1K
1568,normal,1636,23659855,87.4713558206,90,6,>1K
1569,anytime,1632,23661487,87.4773893847,90,7,>1K
1570,org,1632,23663119,87.4834229489,90,3,>1K
1571,rose,1632,23664751,87.489456513,90,4,>1K
1572,blame,1629,23666380,87.4954789861,90,5,>1K
1573,truck,1629,23668009,87.5015014591,90,5,>1K
1574,bacon,1621,23669630,87.5074943558,90,5,>1K
1575,hockey,1621,23671251,87.5134872526,90,6,>1K
1576,fav,1620,23672871,87.5194764523,90,3,>1K
1577,episodes,1615,23674486,87.5254471668,90,8,>1K
1578,turns,1615,23676101,87.5314178813,90,5,>1K
1579,xoxo,1614,23677715,87.5373848988,90,4,>1K
1580,tree,1613,23679328,87.5433482192,90,4,>1K
1581,math,1613,23680941,87.5493115396,90,4,>1K
1582,biz,1613,23682554,87.5552748601,90,3,>1K
1583,rule,1611,23684165,87.5612307865,90,4,>1K
1584,plays,1610,23685775,87.5671830158,90,5,>1K
1585,mama,1609,23687384,87.5731315481,90,4,>1K
1586,rules,1608,23688992,87.5790763833,90,5,>1K
1587,whenever,1607,23690599,87.5850175216,90,8,>1K
1588,checked,1607,23692206,87.5909586598,90,7,>1K
1589,launch,1606,23693812,87.596896101,90,6,>1K
1590,imma,1605,23695417,87.6028298451,90,4,>1K
1591,instagram,1603,23697020,87.6087561952,90,9,>1K
1592,philly,1603,23698623,87.6146825452,90,6,>1K
1593,avengers,1600,23700223,87.6205978042,90,8,>1K
1594,usa,1599,23701822,87.6265093661,90,3,>1K
1595,neighbors,1597,23703419,87.632413534,90,9,>1K
1596,role,1597,23705016,87.6383177018,90,4,>1K
1597,likely,1595,23706611,87.6442144756,90,6,>1K
1598,camp,1595,23708206,87.6501112494,90,4,>1K
1599,projects,1595,23709801,87.6560080232,90,8,>1K
1600,husband,1593,23711394,87.6618974029,90,7,>1K
1601,cookies,1590,23712984,87.6677756915,90,7,>1K
1602,wishes,1589,23714573,87.673650283,90,6,>1K
1603,holidays,1589,23716162,87.6795248746,90,8,>1K
1604,defense,1589,23717751,87.6853994661,90,7,>1K
1605,grab,1589,23719340,87.6912740577,90,4,>1K
1606,cash,1587,23720927,87.6971412552,90,4,>1K
1607,none,1586,23722513,87.7030047556,90,4,>1K
1608,growing,1585,23724098,87.708864559,90,7,>1K
1609,grade,1585,23725683,87.7147243624,90,5,>1K
1610,location,1584,23727267,87.7205804688,90,8,>1K
1611,client,1583,23728850,87.7264328781,90,6,>1K
1612,fighting,1582,23730432,87.7322815904,90,8,>1K
1613,obviously,1580,23732012,87.7381229087,90,9,>1K
1614,ohh,1579,23733591,87.7439605298,90,3,>1K
1615,soccer,1579,23735170,87.749798151,90,6,>1K
1616,feature,1578,23736748,87.7556320752,90,7,>1K
1617,window,1578,23738326,87.7614659993,90,6,>1K
1618,parking,1577,23739903,87.7672962264,90,7,>1K
1619,simply,1577,23741480,87.7731264536,90,6,>1K
1620,awards,1573,23743053,87.7789418925,90,6,>1K
1621,receive,1573,23744626,87.7847573315,90,7,>1K
1622,falling,1571,23746197,87.7905653764,90,7,>1K
1623,pink,1571,23747768,87.7963734213,90,4,>1K
1624,knowledge,1571,23749339,87.8021814662,90,9,>1K
1625,camera,1571,23750910,87.8079895111,90,6,>1K
1626,dying,1567,23752477,87.8137827678,90,5,>1K
1627,smith,1564,23754041,87.8195649334,90,5,>1K
1628,moon,1563,23755604,87.825343402,90,4,>1K
1629,rep,1563,23757167,87.8311218706,90,3,>1K
1630,corner,1562,23758729,87.8368966422,90,6,>1K
1631,nah,1561,23760290,87.8426677167,90,3,>1K
1632,heads,1559,23761849,87.8484313972,90,5,>1K
1633,xo,1558,23763407,87.8541913806,90,2,>1K
1634,ground,1552,23764959,87.8599291818,90,6,>1K
1635,pissed,1552,23766511,87.865666983,90,6,>1K
1636,begins,1549,23768060,87.8713936931,90,6,>1K
1637,excuse,1546,23769606,87.877109312,90,6,>1K
1638,gotten,1546,23771152,87.882824931,90,6,>1K
1639,opinion,1545,23772697,87.8885368529,90,7,>1K
1640,orange,1545,23774242,87.8942487749,90,6,>1K
1641,higher,1543,23775785,87.8999533027,90,6,>1K
1642,steak,1542,23777327,87.9056541336,90,5,>1K
1643,customers,1541,23778868,87.9113512673,90,9,>1K
1644,celebrating,1541,23780409,87.9170484011,90,11,>1K
1645,cancer,1539,23781948,87.9227381408,90,6,>1K
1646,letting,1537,23783485,87.9284204865,90,7,>1K
1647,jus,1535,23785020,87.934095438,90,3,>1K
1648,private,1535,23786555,87.9397703896,90,7,>1K
1649,former,1534,23788089,87.9454416441,90,6,>1K
1650,father,1532,23789621,87.9511055046,90,6,>1K
1651,garden,1532,23791153,87.9567693651,90,6,>1K
1652,discussion,1530,23792683,87.9624258314,90,10,>1K
1653,hits,1528,23794211,87.9680749037,90,4,>1K
1654,selling,1528,23795739,87.973723976,90,7,>1K
1655,fingers,1528,23797267,87.9793730484,90,7,>1K
1656,changing,1527,23798794,87.9850184236,90,8,>1K
1657,recommend,1527,23800321,87.9906637989,90,9,>1K
1658,walked,1525,23801846,87.9963017801,90,6,>1K
1659,campus,1522,23803368,88.0019286702,90,6,>1K
1660,awww,1521,23804889,88.0075518632,90,4,>1K
1661,standing,1521,23806410,88.0131750563,90,8,>1K
1662,baltimore,1520,23807930,88.0187945523,90,9,>1K
1663,productive,1519,23809449,88.0244103513,90,10,>1K
1664,himself,1519,23810968,88.0300261503,90,7,>1K
1665,general,1519,23812487,88.0356419492,90,7,>1K
1666,dang,1518,23814005,88.0412540512,90,4,>1K
1667,noticed,1517,23815522,88.0468624561,90,7,>1K
1668,homie,1517,23817039,88.052470861,90,5,>1K
1669,names,1514,23818553,88.0580681748,90,5,>1K
1670,size,1511,23820064,88.0636543974,90,4,>1K
1671,lake,1510,23821574,88.0692369231,90,4,>1K
1672,bank,1509,23823083,88.0748157517,90,4,>1K
1673,noon,1509,23824592,88.0803945803,90,4,>1K
1674,quiet,1509,23826101,88.0859734089,90,5,>1K
1675,kobe,1508,23827609,88.0915485405,90,4,>1K
1676,talented,1505,23829114,88.0971125809,90,8,>1K
1677,natural,1504,23830618,88.1026729244,90,7,>1K
1678,involved,1504,23832122,88.1082332678,90,8,>1K
1679,clearly,1501,23833623,88.1137825201,90,7,>1K
1680,1500,1500,23835123,88.1193280754,90,4,>1K
1681,california,1498,23836621,88.1248662366,90,10,>1K
1682,battle,1490,23838111,88.1303748215,90,6,>1K
1683,hahahaha,1489,23839600,88.1358797094,90,8,>1K
1684,certain,1489,23841089,88.1413845972,90,7,>1K
1685,large,1489,23842578,88.1468894851,90,5,>1K
1686,fill,1486,23844064,88.1523832819,90,4,>1K
1687,yrs,1486,23845550,88.1578770786,90,3,>1K
1688,ring,1484,23847034,88.1633634813,90,4,>1K
1689,received,1479,23848513,88.1688313988,90,8,>1K
1690,closer,1476,23849989,88.1742882252,90,6,>1K
1691,amen,1476,23851465,88.1797450516,90,4,>1K
1692,regular,1475,23852940,88.185198181,90,7,>1K
1693,midnight,1475,23854415,88.1906513103,90,8,>1K
1694,cross,1472,23855887,88.1960933486,90,5,>1K
1695,hosting,1471,23857358,88.2015316898,90,7,>1K
1696,correct,1470,23858828,88.2069663339,90,7,>1K
1697,storm,1468,23860296,88.212393584,90,5,>1K
1698,waste,1466,23861762,88.2178134401,90,5,>1K
1699,confused,1466,23863228,88.2232332961,90,8,>1K
1700,feelings,1465,23864693,88.2286494551,90,8,>1K
1701,fellow,1464,23866157,88.234061917,90,6,>1K
1702,ridiculous,1460,23867617,88.2394595908,90,10,>1K
1703,follows,1460,23869077,88.2448572646,90,7,>1K
1704,tim,1460,23870537,88.2502549384,90,3,>1K
1705,taylor,1460,23871997,88.2556526122,90,6,>1K
1706,madison,1459,23873456,88.261046589,90,7,>1K
1707,bands,1458,23874914,88.2664368687,90,5,>1K
1708,ten,1457,23876371,88.2718234514,90,3,>1K
1709,nick,1456,23877827,88.2772063371,90,4,>1K
1710,spanish,1456,23879283,88.2825892227,90,7,>1K
1711,memories,1456,23880739,88.2879721084,90,8,>1K
1712,audience,1456,23882195,88.293354994,90,8,>1K
1713,explain,1452,23883647,88.2987230915,90,7,>1K
1714,skills,1452,23885099,88.304091189,90,6,>1K
1715,older,1452,23886551,88.3094592865,90,5,>1K
1716,alex,1450,23888001,88.31481999,90,4,>1K
1717,jackson,1450,23889451,88.3201806934,90,7,>1K
1718,halloween,1449,23890900,88.3255376998,90,9,>1K
1719,topic,1449,23892349,88.3308947062,90,5,>1K
1720,inspired,1449,23893798,88.3362517126,90,8,>1K
1721,position,1448,23895246,88.341605022,90,8,>1K
1722,several,1447,23896693,88.3469546343,90,7,>1K
1723,jones,1445,23898138,88.3522968525,90,5,>1K
1724,states,1443,23899581,88.3576316767,90,6,>1K
1725,arts,1438,23901019,88.3629480157,90,4,>1K
1726,invite,1438,23902457,88.3682643547,90,6,>1K
1727,spirit,1438,23903895,88.3735806937,90,6,>1K
1728,scott,1437,23905332,88.3788933356,90,5,>1K
1729,speech,1437,23906769,88.3842059776,90,6,>1K
1730,degrees,1437,23908206,88.3895186196,90,7,>1K
1731,yoga,1436,23909642,88.3948275645,90,4,>1K
1732,upcoming,1434,23911076,88.4001291153,90,8,>1K
1733,kitchen,1434,23912510,88.4054306662,90,7,>1K
1734,anniversary,1434,23913944,88.410732217,90,11,>1K
1735,six,1433,23915377,88.4160300708,90,3,>1K
1736,tag,1432,23916809,88.4213242276,90,3,>1K
1737,runs,1432,23918241,88.4266183844,90,4,>1K
1738,comments,1430,23919671,88.431905147,90,8,>1K
1739,ohio,1429,23921100,88.4371882127,90,4,>1K
1740,mostly,1429,23922529,88.4424712784,90,6,>1K
1741,harry,1427,23923956,88.44774695,90,5,>1K
1742,flying,1427,23925383,88.4530226215,90,6,>1K
1743,nd,1427,23926810,88.4582982931,90,2,>1K
1744,ms,1427,23928237,88.4635739647,90,2,>1K
1745,lame,1426,23929663,88.4688459393,90,4,>1K
1746,youth,1426,23931089,88.4741179138,90,5,>1K
1747,graduation,1425,23932514,88.4793861913,90,10,>1K
1748,situation,1425,23933939,88.4846544688,90,9,>1K
1749,plane,1423,23935362,88.4899153523,90,5,>1K
1750,clients,1423,23936785,88.4951762357,90,7,>1K
1751,language,1423,23938208,88.5004371192,90,8,>1K
1752,hip,1422,23939630,88.5056943056,90,3,>1K
1753,status,1422,23941052,88.510951492,90,6,>1K
1754,outta,1422,23942474,88.5162086784,90,5,>1K
1755,upon,1416,23943890,88.5214436825,90,4,>1K
1756,swag,1415,23945305,88.5266749897,90,4,>1K
1757,legs,1414,23946719,88.5319025998,90,4,>1K
1758,waking,1411,23948130,88.5371191188,90,6,>1K
1759,lack,1410,23949540,88.5423319407,90,4,>1K
1760,central,1409,23950949,88.5475410657,90,7,>1K
1761,machine,1408,23952357,88.5527464936,90,7,>1K
1762,admit,1407,23953764,88.5579482244,90,5,>1K
1763,josh,1407,23955171,88.5631499553,90,4,>1K
1764,bob,1407,23956578,88.5683516861,90,3,>1K
1765,click,1406,23957984,88.5735497199,90,5,>1K
1766,hasn,1405,23959389,88.5787440567,90,4,>1K
1767,h,1405,23960794,88.5839383935,90,1,>1K
1768,land,1404,23962198,88.5891290332,90,4,>1K
1769,recording,1404,23963602,88.5943196729,90,9,>1K
1770,doin,1403,23965005,88.5995066156,90,4,>1K
1771,awful,1401,23966406,88.6046861643,90,5,>1K
1772,tells,1401,23967807,88.6098657129,90,5,>1K
1773,cooking,1400,23969207,88.6150415645,90,7,>1K
1774,attending,1398,23970605,88.620210022,90,9,>1K
1775,comedy,1396,23972001,88.6253710855,90,6,>1K
1776,diet,1396,23973397,88.6305321489,90,4,>1K
1777,island,1395,23974792,88.6356895153,90,6,>1K
1778,candy,1394,23976186,88.6408431847,90,5,>1K
1779,hollywood,1393,23977579,88.645993157,90,9,>1K
1780,senior,1393,23978972,88.6511431293,90,6,>1K
1781,catching,1392,23980364,88.6562894046,90,8,>1K
1782,hat,1392,23981756,88.6614356799,90,3,>1K
1783,shame,1391,23983147,88.6665782582,90,5,>1K
1784,upset,1389,23984536,88.6717134424,90,5,>1K
1785,jam,1389,23985925,88.6768486266,90,3,>1K
1786,bottom,1388,23987313,88.6819801137,90,6,>1K
1787,anywhere,1388,23988701,88.6871116009,90,8,>1K
1788,cast,1388,23990089,88.692243088,90,4,>1K
1789,skin,1388,23991477,88.6973745752,90,4,>1K
1790,cheap,1386,23992863,88.7024986682,90,5,>1K
1791,semester,1385,23994248,88.7076190643,90,8,>1K
1792,avoid,1385,23995633,88.7127394603,90,5,>1K
1793,jim,1385,23997018,88.7178598564,90,3,>1K
1794,although,1385,23998403,88.7229802524,90,8,>1K
1795,tryna,1383,23999786,88.7280932544,90,5,>1K
1796,wisconsin,1382,24001168,88.7332025593,90,9,>1K
1797,magazine,1379,24002547,88.7383007731,90,8,>1K
1798,ca,1377,24003924,88.7433915928,90,2,>1K
1799,international,1376,24005300,88.7484787155,90,13,>1K
1800,difficult,1372,24006672,88.7535510501,90,9,>1K
1801,wings,1370,24008042,88.7586159906,90,5,>1K
1802,posting,1370,24009412,88.7636809311,90,7,>1K
1803,sky,1370,24010782,88.7687458716,90,3,>1K
1804,balls,1369,24012151,88.773807115,90,5,>1K
1805,desk,1368,24013519,88.7788646614,90,4,>1K
1806,professional,1367,24014886,88.7839185108,90,12,>1K
1807,square,1366,24016252,88.7889686631,90,6,>1K
1808,written,1366,24017618,88.7940188155,90,7,>1K
1809,created,1363,24018981,88.7990578767,90,7,>1K
1810,menu,1362,24020343,88.8040932409,90,4,>1K
1811,direct,1362,24021705,88.8091286051,90,6,>1K
1812,download,1361,24023066,88.8141602722,90,8,>1K
1813,santa,1360,24024426,88.8191882424,90,5,>1K
1814,curious,1358,24025784,88.8242088184,90,7,>1K
1815,lies,1358,24027142,88.8292293944,90,4,>1K
1816,term,1357,24028499,88.8342462735,90,4,>1K
1817,feedback,1356,24029855,88.8392594554,90,8,>1K
1818,pair,1356,24031211,88.8442726374,90,4,>1K
1819,hospital,1354,24032565,88.8492784253,90,8,>1K
1820,force,1354,24033919,88.8542842132,90,5,>1K
1821,plenty,1353,24035272,88.859286304,90,6,>1K
1822,appreciated,1353,24036625,88.8642883949,90,11,>1K
1823,nite,1352,24037977,88.8692867887,90,4,>1K
1824,rocks,1352,24039329,88.8742851825,90,5,>1K
1825,interest,1351,24040680,88.8792798793,90,8,>1K
1826,hop,1351,24042031,88.8842745761,90,3,>1K
1827,burger,1350,24043381,88.8892655759,90,6,>1K
1828,strange,1348,24044729,88.8942491815,90,7,>1K
1829,guitar,1347,24046076,88.8992290902,90,6,>1K
1830,theater,1346,24047422,88.9042053018,90,7,>1K
1831,raise,1346,24048768,88.9091815134,90,5,>1K
1832,lounge,1345,24050113,88.9141540279,90,6,>1K
1833,turning,1345,24051458,88.9191265425,90,7,>1K
1834,bird,1345,24052803,88.9240990571,90,4,>1K
1835,cars,1345,24054148,88.9290715716,90,4,>1K
1836,whoa,1345,24055493,88.9340440862,90,4,>1K
1837,talks,1345,24056838,88.9390166008,90,5,>1K
1838,reminds,1344,24058182,88.9439854183,90,7,>1K
1839,seconds,1344,24059526,88.9489542358,90,7,>1K
1840,sandwich,1343,24060869,88.9539193563,90,8,>1K
1841,silly,1343,24062212,88.9588844768,90,5,>1K
1842,supporting,1342,24063554,88.9638459003,90,10,>1K
1843,kno,1342,24064896,88.9688073237,90,3,>1K
1844,dope,1342,24066238,88.9737687472,90,4,>1K
1845,cousin,1342,24067580,88.9787301706,90,6,>1K
1846,soup,1339,24068919,88.983680503,90,4,>1K
1847,solid,1337,24070256,88.9886234412,90,5,>1K
1848,host,1337,24071593,88.9935663795,90,4,>1K
1849,bright,1336,24072929,88.9985056207,90,6,>1K
1850,workshop,1336,24074265,89.003444862,90,8,>1K
1851,creating,1335,24075600,89.0083804062,90,8,>1K
1852,specials,1335,24076935,89.0133159504,90,8,>1K
1853,according,1335,24078270,89.0182514946,90,9,>1K
1854,doesnt,1335,24079605,89.0231870388,90,6,>1K
1855,female,1335,24080940,89.0281225829,90,6,>1K
1856,heck,1333,24082273,89.0330507331,90,4,>1K
1857,impossible,1333,24083606,89.0379788832,90,10,>1K
1858,texting,1331,24084937,89.0428996392,90,7,>1K
1859,salad,1331,24086268,89.0478203953,90,5,>1K
1860,mission,1331,24087599,89.0527411513,90,7,>1K
1861,tebow,1329,24088928,89.0576545133,90,5,>1K
1862,shake,1328,24090256,89.0625641782,90,5,>1K
1863,honey,1327,24091583,89.0674701462,90,5,>1K
1864,wind,1326,24092909,89.072372417,90,4,>1K
1865,seat,1323,24094232,89.0772635968,90,4,>1K
1866,taco,1322,24095554,89.0821510795,90,4,>1K
1867,windows,1322,24096876,89.0870385622,90,7,>1K
1868,lived,1322,24098198,89.0919260449,90,5,>1K
1869,rush,1321,24099519,89.0968098306,90,4,>1K
1870,production,1321,24100840,89.1016936163,90,10,>1K
1871,purchase,1320,24102160,89.1065737049,90,8,>1K
1872,tool,1319,24103479,89.1114500965,90,4,>1K
1873,miller,1319,24104798,89.1163264881,90,6,>1K
1874,helped,1318,24106116,89.1211991827,90,6,>1K
1875,chick,1318,24107434,89.1260718773,90,5,>1K
1876,figured,1317,24108751,89.1309408748,90,7,>1K
1877,unfortunately,1316,24110067,89.1358061753,90,13,>1K
1878,rights,1314,24111381,89.1406640817,90,6,>1K
1879,sis,1313,24112694,89.1455182911,90,3,>1K
1880,kevin,1313,24114007,89.1503725005,90,5,>1K
1881,lebron,1310,24115317,89.1552156188,90,6,>1K
1882,leadership,1310,24116627,89.160058737,90,10,>1K
1883,fool,1309,24117936,89.1648981583,90,4,>1K
1884,milk,1309,24119245,89.1697375795,90,4,>1K
1885,spam,1309,24120554,89.1745770008,90,4,>1K
1886,print,1306,24121860,89.1794053309,90,5,>1K
1887,push,1306,24123166,89.184233661,90,4,>1K
1888,nervous,1303,24124469,89.1890509,90,7,>1K
1889,enter,1303,24125772,89.193868139,90,5,>1K
1890,nation,1302,24127074,89.198681681,90,6,>1K
1891,tx,1299,24128373,89.2034841319,90,2,>1K
1892,oil,1296,24129669,89.2082754917,90,3,>1K
1893,weren,1294,24130963,89.2130594573,90,5,>1K
1894,cook,1293,24132256,89.217839726,90,4,>1K
1895,attack,1293,24133549,89.2226199946,90,6,>1K
1896,bulls,1293,24134842,89.2274002633,90,5,>1K
1897,ended,1292,24136134,89.2321768349,90,5,>1K
1898,brings,1292,24137426,89.2369534065,90,6,>1K
1899,filled,1290,24138716,89.241722584,90,6,>1K
1900,pages,1290,24140006,89.2464917616,90,5,>1K
1901,bbq,1290,24141296,89.2512609391,90,3,>1K
1902,adam,1289,24142585,89.2560264196,90,4,>1K
1903,tonite,1289,24143874,89.2607919001,90,6,>1K
1904,angry,1288,24145162,89.2655536836,90,5,>1K
1905,yummy,1288,24146450,89.270315467,90,5,>1K
1906,recently,1288,24147738,89.2750772505,90,8,>1K
1907,august,1287,24149025,89.2798353369,90,6,>1K
1908,honest,1287,24150312,89.2845934234,90,6,>1K
1909,giants,1286,24151598,89.2893478128,90,6,>1K
1910,heaven,1286,24152884,89.2941022021,90,6,>1K
1911,numbers,1286,24154170,89.2988565915,90,7,>1K
1912,exercise,1286,24155456,89.3036109809,90,8,>1K
1913,ben,1285,24156741,89.3083616733,90,3,>1K
1914,security,1285,24158026,89.3131123656,90,8,>1K
1915,abt,1284,24159310,89.3178593609,90,3,>1K
1916,reasons,1284,24160594,89.3226063563,90,7,>1K
1917,however,1282,24161876,89.3273459575,90,7,>1K
1918,lesson,1281,24163157,89.3320818617,90,6,>1K
1919,fest,1280,24164437,89.3368140689,90,4,>1K
1920,prayers,1280,24165717,89.3415462761,90,7,>1K
1921,culture,1279,24166996,89.3462747862,90,7,>1K
1922,studying,1279,24168275,89.3510032963,90,8,>1K
1923,sleepy,1277,24169552,89.3557244124,90,6,>1K
1924,tears,1276,24170828,89.3604418314,90,5,>1K
1925,ending,1275,24172103,89.3651555534,90,6,>1K
1926,source,1275,24173378,89.3698692754,90,6,>1K
1927,brunch,1273,24174651,89.3745756033,90,6,>1K
1928,itunes,1273,24175924,89.3792819312,90,6,>1K
1929,stress,1273,24177197,89.3839882591,90,6,>1K
1930,budget,1272,24178469,89.38869089,90,6,>1K
1931,average,1271,24179740,89.3933898238,90,7,>1K
1932,paying,1271,24181011,89.3980887576,90,6,>1K
1933,sf,1269,24182280,89.4027802974,90,2,>1K
1934,harder,1269,24183549,89.4074718372,90,6,>1K
1935,posts,1269,24184818,89.4121633769,90,5,>1K
1936,notes,1268,24186086,89.4168512197,90,5,>1K
1937,yu,1267,24187353,89.4215353654,90,2,>1K
1938,director,1267,24188620,89.426219511,90,8,>1K
1939,amount,1266,24189886,89.4308999597,90,6,>1K
1940,companies,1266,24191152,89.4355804084,90,9,>1K
1941,los,1265,24192417,89.44025716,90,3,>1K
1942,inbox,1262,24193679,89.4449228205,90,5,>1K
1943,possibly,1262,24194941,89.449588481,90,8,>1K
1944,mi,1261,24196202,89.4542504444,90,2,>1K
1945,valentine,1260,24197462,89.4589087109,90,9,>1K
1946,management,1260,24198722,89.4635669773,90,10,>1K
1947,government,1259,24199981,89.4682215467,90,10,>1K
1948,dnt,1259,24201240,89.4728761161,90,3,>1K
1949,pitch,1256,24202496,89.4775195944,90,5,>1K
1950,mayo,1256,24203752,89.4821630727,90,4,>1K
1951,effort,1254,24205006,89.4867991569,90,6,>1K
1952,sugar,1254,24206260,89.4914352411,90,5,>1K
1953,failure,1254,24207514,89.4960713253,90,7,>1K
1954,prob,1254,24208768,89.5007074095,90,4,>1K
1955,willing,1254,24210022,89.5053434937,90,7,>1K
1956,dig,1254,24211276,89.5099795779,90,3,>1K
1957,certainly,1253,24212529,89.5146119651,90,9,>1K
1958,joining,1253,24213782,89.5192443523,90,7,>1K
1959,wet,1252,24215034,89.5238730424,90,3,>1K
1960,lookin,1251,24216285,89.5284980355,90,6,>1K
1961,bread,1251,24217536,89.5331230286,90,5,>1K
1962,sunshine,1251,24218787,89.5377480217,90,8,>1K
1963,universe,1251,24220038,89.5423730148,90,8,>1K
1964,trend,1250,24221288,89.5469943109,90,5,>1K
1965,ipod,1250,24222538,89.551615607,90,4,>1K
1966,ahh,1250,24223788,89.556236903,90,3,>1K
1967,brothers,1249,24225037,89.560854502,90,8,>1K
1968,include,1248,24226285,89.565468404,90,7,>1K
1969,itself,1248,24227533,89.570082306,90,6,>1K
1970,remind,1248,24228781,89.574696208,90,6,>1K
1971,starbucks,1247,24230028,89.579306413,90,9,>1K
1972,society,1247,24231275,89.5839166179,90,7,>1K
1973,doors,1246,24232521,89.5885231258,90,5,>1K
1974,sum,1246,24233767,89.5931296338,90,3,>1K
1975,decisions,1246,24235013,89.5977361417,90,9,>1K
1976,allowed,1243,24236256,89.6023315585,90,7,>1K
1977,grateful,1243,24237499,89.6069269753,90,8,>1K
1978,sort,1243,24238742,89.6115223921,90,4,>1K
1979,manager,1242,24239984,89.6161141119,90,7,>1K
1980,speed,1242,24241226,89.6207058316,90,5,>1K
1981,pie,1241,24242467,89.6252938544,90,3,>1K
1982,kept,1238,24243705,89.629870786,90,4,>1K
1983,jr,1238,24244943,89.6344477176,90,2,>1K
1984,deals,1237,24246180,89.6390209522,90,5,>1K
1985,ty,1236,24247416,89.6435904897,90,2,>1K
1986,becoming,1235,24248651,89.6481563302,90,8,>1K
1987,development,1233,24249884,89.6527147767,90,11,>1K
1988,tools,1233,24251117,89.6572732231,90,5,>1K
1989,fantasy,1233,24252350,89.6618316695,90,7,>1K
1990,quarter,1232,24253582,89.6663864189,90,7,>1K
1991,stoked,1232,24254814,89.6709411684,90,6,>1K
1992,hurry,1232,24256046,89.6754959178,90,5,>1K
1993,bucks,1232,24257278,89.6800506672,90,5,>1K
1994,indiana,1232,24258510,89.6846054166,90,7,>1K
1995,theme,1231,24259741,89.6891564689,90,5,>1K
1996,potential,1230,24260971,89.6937038242,90,9,>1K
1997,martin,1227,24262198,89.6982400885,90,6,>1K
1998,espn,1227,24263425,89.7027763527,90,4,>1K
1999,author,1226,24264651,89.7073089199,90,6,>1K
2000,burn,1225,24265876,89.71183779,90,4,>1K
2001,jk,1225,24267101,89.7163666601,90,2,>1K
2002,cafe,1224,24268325,89.7208918332,90,4,>1K
2003,quickly,1223,24269548,89.7254133093,90,7,>1K
2004,depends,1220,24270768,89.7299236943,90,7,>1K
2005,cares,1218,24271986,89.7344266852,90,5,>1K
2006,powerful,1218,24273204,89.738929676,90,8,>1K
2007,wise,1218,24274422,89.7434326669,90,4,>1K
2008,mistake,1218,24275640,89.7479356578,90,7,>1K
2009,cleveland,1216,24276856,89.7524312546,90,9,>1K
2010,freedom,1214,24278070,89.7569194574,90,7,>1K
2011,above,1213,24279283,89.7614039631,90,5,>1K
2012,visiting,1213,24280496,89.7658884688,90,8,>1K
2013,cell,1210,24281706,89.7703618833,90,4,>1K
2014,mary,1210,24282916,89.7748352979,90,4,>1K
2015,tony,1209,24284125,89.7793050155,90,4,>1K
2016,considering,1209,24285334,89.783774733,90,11,>1K
2017,nasty,1208,24286542,89.7882407536,90,5,>1K
2018,accept,1206,24287748,89.79269938,90,6,>1K
2019,robert,1202,24288950,89.7971432183,90,6,>1K
2020,collection,1201,24290151,89.8015833595,90,10,>1K
2021,meal,1200,24291351,89.8060198038,90,4,>1K
2022,faster,1199,24292550,89.810452551,90,6,>1K
2023,championship,1199,24293749,89.8148852981,90,12,>1K
2024,setting,1199,24294948,89.8193180453,90,7,>1K
2025,pls,1198,24296146,89.8237470955,90,3,>1K
2026,mins,1197,24297343,89.8281724486,90,4,>1K
2027,political,1196,24298539,89.8325941047,90,9,>1K
2028,dudes,1196,24299735,89.8370157607,90,5,>1K
2029,riding,1195,24300930,89.8414337198,90,6,>1K
2030,discuss,1194,24302124,89.8458479818,90,7,>1K
2031,attend,1194,24303318,89.8502622438,90,6,>1K
2032,nature,1191,24304509,89.8546654147,90,6,>1K
2033,playoff,1191,24305700,89.8590685855,90,7,>1K
2034,prefer,1191,24306891,89.8634717564,90,6,>1K
2035,moves,1190,24308081,89.8678712303,90,5,>1K
2036,related,1190,24309271,89.8722707041,90,7,>1K
2037,lines,1190,24310461,89.876670178,90,5,>1K
2038,dry,1189,24311650,89.8810659548,90,3,>1K
2039,havent,1189,24312839,89.8854617316,90,6,>1K
2040,rate,1189,24314028,89.8898575084,90,4,>1K
2041,seek,1189,24315217,89.8942532853,90,4,>1K
2042,leader,1189,24316406,89.8986490621,90,6,>1K
2043,exist,1189,24317595,89.9030448389,90,5,>1K
2044,neighborhood,1188,24318783,89.9074369187,90,12,>1K
2045,zone,1188,24319971,89.9118289984,90,4,>1K
2046,mile,1187,24321158,89.9162173812,90,4,>1K
2047,weak,1184,24322342,89.9205946728,90,4,>1K
2048,hes,1184,24323526,89.9249719644,90,3,>1K
2049,union,1183,24324709,89.929345559,90,5,>1K
2050,queen,1182,24325891,89.9337154566,90,5,>1K
2051,river,1182,24327073,89.9380853542,90,5,>1K
2052,brilliant,1182,24328255,89.9424552517,90,9,>1K
2053,bear,1181,24329436,89.9468214522,90,4,>1K
2054,ave,1180,24330616,89.9511839557,90,3,>1K
2055,letter,1179,24331795,89.9555427622,90,6,>1K
2056,haters,1179,24332974,89.9599015686,90,6,>1K
2057,praying,1179,24334153,89.9642603751,90,7,>1K
2058,adorable,1177,24335330,89.9686117874,90,8,>1K
2059,showed,1176,24336506,89.9729595028,90,6,>1K
2060,required,1175,24337681,89.9773035211,90,8,>1K
2061,tattoo,1174,24338855,89.9816438423,90,6,>1K
2062,dave,1173,24340028,89.9859804666,90,4,>1K
2063,thomas,1172,24341200,89.9903133937,_100,6,>1K
2064,provide,1171,24342371,89.9946426239,_100,7,>1K
2065,suppose,1171,24343542,89.9989718541,_100,7,>1K
2066,dropped,1171,24344713,90.0033010842,_100,7,>1K
2067,net,1170,24345883,90.0076266173,_100,3,>1K
2068,daddy,1167,24347050,90.0119410593,_100,5,>1K
2069,chinese,1167,24348217,90.0162555013,_100,7,>1K
2070,favor,1166,24349383,90.0205662463,_100,5,>1K
2071,benefit,1165,24350548,90.0248732942,_100,7,>1K
2072,bell,1163,24351711,90.0291729481,_100,4,>1K
2073,picking,1163,24352874,90.0334726019,_100,7,>1K
2074,insane,1163,24354037,90.0377722558,_100,6,>1K
2075,draw,1163,24355200,90.0420719097,_100,4,>1K
2076,pumped,1162,24356362,90.0463678665,_100,6,>1K
2077,genius,1162,24357524,90.0506638233,_100,6,>1K
2078,teeth,1161,24358685,90.0549560831,_100,5,>1K
2079,nearly,1160,24359845,90.0592446458,_100,6,>1K
2080,carry,1159,24361004,90.0635295115,_100,5,>1K
2081,detroit,1158,24362162,90.0678106802,_100,7,>1K
2082,heavy,1157,24363319,90.0720881519,_100,5,>1K
2083,option,1156,24364475,90.0763619265,_100,6,>1K
2084,disappointed,1155,24365630,90.080632004,_100,12,>1K
2085,theatre,1154,24366784,90.0848983845,_100,7,>1K
2086,signing,1153,24367937,90.089161068,_100,7,>1K
2087,taught,1152,24369089,90.0934200545,_100,6,>1K
2088,laptop,1152,24370241,90.0976790409,_100,6,>1K
2089,ray,1151,24371392,90.1019343303,_100,3,>1K
2090,smells,1150,24372542,90.1061859227,_100,6,>1K
2091,tht,1149,24373691,90.1104338181,_100,3,>1K
2092,inspiring,1149,24374840,90.1146817134,_100,9,>1K
2093,purpose,1149,24375989,90.1189296088,_100,7,>1K
2094,progress,1149,24377138,90.1231775041,_100,8,>1K
2095,ex,1148,24378286,90.1274217024,_100,2,>1K
2096,eve,1147,24379433,90.1316622037,_100,3,>1K
2097,records,1145,24380578,90.1358953109,_100,7,>1K
2098,dan,1144,24381722,90.140124721,_100,3,>1K
2099,disney,1144,24382866,90.1443541312,_100,6,>1K
2100,babies,1143,24384009,90.1485798443,_100,6,>1K
2101,johnson,1143,24385152,90.1528055574,_100,7,>1K
2102,perform,1142,24386294,90.1570275735,_100,7,>1K
2103,strength,1142,24387436,90.1612495896,_100,8,>1K
2104,risk,1142,24388578,90.1654716057,_100,4,>1K
2105,serve,1142,24389720,90.1696936218,_100,5,>1K
2106,wed,1139,24390859,90.1739045467,_100,3,>1K
2107,beast,1139,24391998,90.1781154717,_100,5,>1K
2108,rise,1139,24393137,90.1823263967,_100,4,>1K
2109,juice,1138,24394275,90.1865336246,_100,5,>1K
2110,usual,1138,24395413,90.1907408525,_100,5,>1K
2111,packed,1137,24396550,90.1949443834,_100,6,>1K
2112,lay,1137,24397687,90.1991479143,_100,3,>1K
2113,evil,1137,24398824,90.2033514452,_100,4,>1K
2114,driver,1136,24399960,90.2075512791,_100,6,>1K
2115,allow,1135,24401095,90.2117474159,_100,5,>1K
2116,background,1134,24402229,90.2159398557,_100,10,>1K
2117,messages,1134,24403363,90.2201322955,_100,8,>1K
2118,united,1133,24404496,90.2243210383,_100,6,>1K
2119,arrived,1132,24405628,90.228506084,_100,7,>1K
2120,expected,1131,24406759,90.2326874327,_100,8,>1K
2121,doctor,1131,24407890,90.2368687813,_100,6,>1K
2122,finishing,1131,24409021,90.24105013,_100,9,>1K
2123,recent,1130,24410151,90.2452277816,_100,6,>1K
2124,leg,1129,24411280,90.2494017363,_100,3,>1K
2125,journey,1129,24412409,90.2535756909,_100,7,>1K
2126,nose,1128,24413537,90.2577459484,_100,4,>1K
2127,relax,1127,24414664,90.261912509,_100,5,>1K
2128,released,1124,24415788,90.2660679784,_100,8,>1K
2129,actual,1122,24416910,90.2702160537,_100,6,>1K
2130,rough,1121,24418031,90.274360432,_100,5,>1K
2131,louis,1121,24419152,90.2785048103,_100,5,>1K
2132,crush,1120,24420272,90.2826454916,_100,5,>1K
2133,ability,1120,24421392,90.2867861729,_100,7,>1K
2134,request,1120,24422512,90.2909268542,_100,7,>1K
2135,killer,1119,24423631,90.2950638384,_100,6,>1K
2136,apart,1119,24424750,90.2992008226,_100,5,>1K
2137,nashville,1117,24425867,90.3033304128,_100,9,>1K
2138,global,1117,24426984,90.307460003,_100,6,>1K
2139,apartment,1117,24428101,90.3115895931,_100,9,>1K
2140,easily,1117,24429218,90.3157191833,_100,6,>1K
2141,somehow,1116,24430334,90.3198450764,_100,7,>1K
2142,creepy,1116,24431450,90.3239709695,_100,6,>1K
2143,gun,1115,24432565,90.3280931656,_100,3,>1K
2144,mexican,1114,24433679,90.3322116647,_100,7,>1K
2145,highly,1112,24434791,90.3363227697,_100,6,>1K
2146,reminder,1111,24435902,90.3404301776,_100,8,>1K
2147,planned,1110,24437012,90.3445338885,_100,7,>1K
2148,swing,1110,24438122,90.3486375994,_100,5,>1K
2149,gosh,1110,24439232,90.3527413103,_100,4,>1K
2150,adding,1109,24440341,90.3568413242,_100,6,>1K
2151,stock,1108,24441449,90.360937641,_100,5,>1K
2152,dollar,1108,24442557,90.3650339578,_100,6,>1K
2153,popular,1107,24443664,90.3691265776,_100,7,>1K
2154,impact,1107,24444771,90.3732191974,_100,6,>1K
2155,ordered,1106,24445877,90.3773081202,_100,7,>1K
2156,section,1105,24446982,90.3813933459,_100,7,>1K
2157,jordan,1104,24448086,90.3854748746,_100,6,>1K
2158,kentucky,1104,24449190,90.3895564033,_100,8,>1K
2159,users,1104,24450294,90.393637932,_100,5,>1K
2160,partner,1103,24451397,90.3977157636,_100,7,>1K
2161,shirts,1102,24452499,90.4017898982,_100,6,>1K
2162,fitness,1101,24453600,90.4058603358,_100,7,>1K
2163,netflix,1100,24454700,90.4099270763,_100,7,>1K
2164,jeff,1099,24455799,90.4139901198,_100,4,>1K
2165,links,1099,24456898,90.4180531633,_100,5,>1K
2166,characters,1098,24457996,90.4221125098,_100,10,>1K
2167,debate,1097,24459093,90.4261681592,_100,6,>1K
2168,tournament,1097,24460190,90.4302238086,_100,10,>1K
2169,saved,1097,24461287,90.4342794581,_100,5,>1K
2170,cinco,1097,24462384,90.4383351075,_100,5,>1K
2171,moments,1096,24463480,90.4423870599,_100,7,>1K
2172,stomach,1095,24464575,90.4464353152,_100,7,>1K
2173,eggs,1094,24465669,90.4504798735,_100,4,>1K
2174,leaders,1094,24466763,90.4545244318,_100,7,>1K
2175,ft,1094,24467857,90.4585689902,_100,2,>1K
2176,jason,1093,24468950,90.4626098514,_100,5,>1K
2177,yard,1093,24470043,90.4666507127,_100,4,>1K
2178,rangers,1092,24471135,90.470687877,_100,7,>1K
2179,audition,1092,24472227,90.4747250412,_100,8,>1K
2180,memory,1092,24473319,90.4787622054,_100,6,>1K
2181,foot,1091,24474410,90.4827956726,_100,4,>1K
2182,justice,1091,24475501,90.4868291399,_100,7,>1K
2183,dollars,1090,24476591,90.49085891,_100,7,>1K
2184,brewers,1090,24477681,90.4948886802,_100,7,>1K
2185,stadium,1088,24478769,90.4989110563,_100,7,>1K
2186,otherwise,1087,24479856,90.5029297353,_100,9,>1K
2187,idol,1087,24480943,90.5069484144,_100,4,>1K
2188,basically,1086,24482029,90.5109633964,_100,9,>1K
2189,awhile,1085,24483114,90.5149746814,_100,6,>1K
2190,ron,1085,24484199,90.5189859664,_100,3,>1K
2191,among,1084,24485283,90.5229935543,_100,5,>1K
2192,mvp,1084,24486367,90.5270011423,_100,3,>1K
2193,youre,1083,24487450,90.5310050332,_100,5,>1K
2194,similar,1083,24488533,90.5350089241,_100,7,>1K
2195,theres,1083,24489616,90.539012815,_100,6,>1K
2196,target,1082,24490698,90.5430130089,_100,6,>1K
2197,wash,1082,24491780,90.5470132027,_100,4,>1K
2198,marry,1082,24492862,90.5510133966,_100,5,>1K
2199,prices,1082,24493944,90.5550135905,_100,6,>1K
2200,birds,1082,24495026,90.5590137844,_100,5,>1K
2201,wide,1081,24496107,90.5630102812,_100,4,>1K
2202,wanting,1081,24497188,90.567006778,_100,7,>1K
2203,mayor,1081,24498269,90.5710032749,_100,5,>1K
2204,bathroom,1080,24499349,90.5749960747,_100,8,>1K
2205,master,1079,24500428,90.5789851774,_100,6,>1K
2206,brian,1078,24501506,90.5829705832,_100,5,>1K
2207,tumblr,1078,24502584,90.5869559889,_100,6,>1K
2208,minds,1077,24503661,90.5909376976,_100,5,>1K
2209,networking,1077,24504738,90.5949194063,_100,10,>1K
2210,leads,1077,24505815,90.5989011149,_100,5,>1K
2211,charge,1077,24506892,90.6028828236,_100,6,>1K
2212,careful,1075,24507967,90.6068571383,_100,7,>1K
2213,tie,1075,24509042,90.6108314529,_100,3,>1K
2214,repeat,1075,24510117,90.6148057675,_100,6,>1K
2215,gig,1074,24511191,90.6187763851,_100,3,>1K
2216,testing,1073,24512264,90.6227433056,_100,7,>1K
2217,skype,1073,24513337,90.6267102261,_100,5,>1K
2218,lee,1073,24514410,90.6306771467,_100,3,>1K
2219,raining,1070,24515480,90.6346329761,_100,7,>1K
2220,pulled,1070,24516550,90.6385888055,_100,6,>1K
2221,relationships,1069,24517619,90.6425409379,_100,13,>1K
2222,limit,1069,24518688,90.6464930703,_100,5,>1K
2223,knock,1067,24519755,90.6504378086,_100,5,>1K
2224,multiple,1067,24520822,90.654382547,_100,8,>1K
2225,rolling,1067,24521889,90.6583272853,_100,7,>1K
2226,london,1066,24522955,90.6622683266,_100,6,>1K
2227,neither,1065,24524020,90.6662056708,_100,7,>1K
2228,egg,1065,24525085,90.6701430151,_100,3,>1K
2229,cheer,1064,24526149,90.6740766623,_100,5,>1K
2230,emails,1064,24527213,90.6780103095,_100,6,>1K
2231,rap,1064,24528277,90.6819439567,_100,3,>1K
2232,hook,1063,24529340,90.6858739069,_100,4,>1K
2233,hr,1063,24530403,90.689803857,_100,2,>1K
2234,teen,1063,24531466,90.6937338072,_100,4,>1K
2235,rainy,1063,24532529,90.6976637574,_100,5,>1K
2236,options,1062,24533591,90.7015900105,_100,7,>1K
2237,gop,1062,24534653,90.7055162637,_100,3,>1K
2238,hero,1061,24535714,90.7094388198,_100,4,>1K
2239,fault,1059,24536773,90.7133539818,_100,5,>1K
2240,worried,1057,24537830,90.7172617497,_100,7,>1K
2241,throwing,1057,24538887,90.7211695177,_100,8,>1K
2242,apply,1057,24539944,90.7250772856,_100,5,>1K
2243,hacked,1055,24540999,90.7289776595,_100,6,>1K
2244,pr,1055,24542054,90.7328780334,_100,2,>1K
2245,lock,1054,24543108,90.7367747102,_100,4,>1K
2246,fixed,1054,24544162,90.7406713871,_100,5,>1K
2247,blah,1052,24545214,90.7445606698,_100,4,>1K
2248,items,1051,24546265,90.7484462556,_100,5,>1K
2249,atl,1050,24547315,90.7523281443,_100,3,>1K
2250,strategy,1050,24548365,90.756210033,_100,8,>1K
2251,rick,1049,24549414,90.7600882246,_100,4,>1K
2252,planet,1049,24550463,90.7639664163,_100,6,>1K
2253,af,1049,24551512,90.7678446079,_100,2,>1K
2254,patrick,1048,24552560,90.7717191025,_100,7,>1K
2255,towards,1048,24553608,90.7755935972,_100,7,>1K
2256,chapter,1046,24554654,90.7794606977,_100,7,>1K
2257,effect,1046,24555700,90.7833277983,_100,6,>1K
2258,horse,1046,24556746,90.7871948988,_100,5,>1K
2259,golden,1046,24557792,90.7910619993,_100,6,>1K
2260,tons,1046,24558838,90.7949290999,_100,4,>1K
2261,sea,1044,24559882,90.7987888064,_100,3,>1K
2262,sauce,1043,24560925,90.8026448158,_100,5,>1K
2263,hug,1042,24561967,90.8064971282,_100,3,>1K
2264,mexico,1041,24563008,90.8103457436,_100,6,>1K
2265,tweeps,1041,24564049,90.8141943589,_100,6,>1K
2266,closing,1039,24565088,90.8180355802,_100,7,>1K
2267,voting,1038,24566126,90.8218731045,_100,6,>1K
2268,empty,1037,24567163,90.8257069317,_100,5,>1K
2269,insurance,1037,24568200,90.8295407589,_100,9,>1K
2270,voted,1036,24569236,90.8333708891,_100,5,>1K
2271,pet,1036,24570272,90.8372010192,_100,3,>1K
2272,singer,1036,24571308,90.8410311494,_100,6,>1K
2273,sessions,1034,24572342,90.8448538855,_100,8,>1K
2274,legal,1034,24573376,90.8486766216,_100,5,>1K
2275,breath,1033,24574409,90.8524956607,_100,6,>1K
2276,laying,1033,24575442,90.8563146998,_100,6,>1K
2277,android,1032,24576474,90.8601300418,_100,7,>1K
2278,base,1031,24577505,90.8639416868,_100,4,>1K
2279,sox,1030,24578535,90.8677496347,_100,3,>1K
2280,someday,1030,24579565,90.8715575827,_100,7,>1K
2281,ourselves,1029,24580594,90.8753618336,_100,9,>1K
2282,grown,1029,24581623,90.8791660845,_100,5,>1K
2283,whose,1029,24582652,90.8829703355,_100,5,>1K
2284,crack,1029,24583681,90.8867745864,_100,5,>1K
2285,hehe,1029,24584710,90.8905788373,_100,4,>1K
2286,meaning,1029,24585739,90.8943830882,_100,7,>1K
2287,feb,1028,24586767,90.8981836421,_100,3,>1K
2288,gov,1028,24587795,90.901984196,_100,3,>1K
2289,jay,1028,24588823,90.9057847499,_100,3,>1K
2290,whitney,1027,24589850,90.9095816067,_100,7,>1K
2291,sayin,1026,24590876,90.9133747665,_100,5,>1K
2292,degree,1026,24591902,90.9171679263,_100,6,>1K
2293,calm,1025,24592927,90.9209573891,_100,4,>1K
2294,held,1025,24593952,90.9247468519,_100,4,>1K
2295,victory,1025,24594977,90.9285363146,_100,7,>1K
2296,timeline,1025,24596002,90.9323257774,_100,8,>1K
2297,smoking,1023,24597025,90.9361078461,_100,7,>1K
2298,worries,1023,24598048,90.9398899148,_100,7,>1K
2299,hoe,1023,24599071,90.9436719835,_100,3,>1K
2300,fruit,1022,24600093,90.9474503552,_100,5,>1K
2301,hrs,1022,24601115,90.9512287268,_100,3,>1K
2302,las,1021,24602136,90.9550034015,_100,3,>1K
2303,hashtag,1021,24603157,90.9587780761,_100,7,>1K
2304,amazon,1020,24604177,90.9625490537,_100,6,>1K
2305,extremely,1020,24605197,90.9663200313,_100,9,>1K
2306,meat,1019,24606216,90.9700873118,_100,4,>1K
2307,matters,1019,24607235,90.9738545924,_100,7,>1K
2308,sigh,1019,24608254,90.9776218729,_100,4,>1K
2309,everytime,1018,24609272,90.9813854564,_100,9,>1K
2310,couch,1018,24610290,90.9851490399,_100,5,>1K
2311,davis,1017,24611307,90.9889089264,_100,5,>1K
2312,coverage,1017,24612324,90.9926688129,_100,8,>1K
2313,opportunities,1017,24613341,90.9964286994,_100,13,>1K
2314,reports,1016,24614357,91.0001848888,_100,7,>1K
2315,announced,1016,24615373,91.0039410783,_100,9,>1K
2316,weed,1016,24616389,91.0076972677,_100,4,>1K
2317,prize,1015,24617404,91.0114497601,_100,5,>1K
2318,vision,1015,24618419,91.0152022525,_100,6,>1K
2319,turkey,1015,24619434,91.0189547449,_100,6,>1K
2320,editing,1014,24620448,91.0227035403,_100,7,>1K
2321,christian,1014,24621462,91.0264523356,_100,9,>1K
2322,animal,1013,24622475,91.030197434,_100,6,>1K
2323,williams,1012,24623487,91.0339388353,_100,8,>1K
2324,user,1012,24624499,91.0376802366,_100,4,>1K
2325,counting,1011,24625510,91.0414179408,_100,8,>1K
2326,movement,1011,24626521,91.0451556451,_100,8,>1K
2327,software,1011,24627532,91.0488933493,_100,8,>1K
2328,struck,1011,24628543,91.0526310536,_100,6,>1K
2329,hoes,1010,24629553,91.0563650608,_100,4,>1K
2330,mistakes,1010,24630563,91.060099068,_100,8,>1K
2331,seats,1009,24631572,91.0638293782,_100,5,>1K
2332,pittsburgh,1009,24632581,91.0675596884,_100,10,>1K
2333,commercials,1009,24633590,91.0712899986,_100,11,>1K
2334,bears,1009,24634599,91.0750203087,_100,5,>1K
2335,tracks,1008,24635607,91.0787469219,_100,6,>1K
2336,sites,1007,24636614,91.082469838,_100,5,>1K
2337,announce,1006,24637620,91.0861890571,_100,8,>1K
2338,rocking,1005,24638625,91.0899045791,_100,7,>1K
2339,volunteer,1005,24639630,91.0936201011,_100,9,>1K
2340,january,1005,24640635,91.0973356232,_100,7,>1K
2341,dating,1005,24641640,91.1010511452,_100,6,>1K
2342,orlando,1004,24642644,91.1047629702,_100,7,>1K
2343,october,1003,24643647,91.1084710982,_100,7,>1K
2344,celebration,1002,24644649,91.1121755291,_100,11,>1K
2345,adult,1002,24645651,91.11587996,_100,5,>1K
2346,beef,1002,24646653,91.1195843909,_100,4,>1K
2347,tacos,1000,24647653,91.1232814278,_100,5,>100
2348,1000,1000,24648653,91.1269784646,_100,4,>100
2349,bomb,998,24649651,91.1306681074,_100,4,>100
2350,tight,998,24650649,91.1343577502,_100,5,>100
2351,grind,997,24651646,91.1380436959,_100,5,>100
2352,sushi,997,24652643,91.1417296417,_100,5,>100
2353,oops,996,24653639,91.1454118904,_100,4,>100
2354,ignore,996,24654635,91.1490941391,_100,6,>100
2355,tha,995,24655630,91.1527726908,_100,3,>100
2356,shine,994,24656624,91.1564475454,_100,5,>100
2357,goodbye,993,24657617,91.160118703,_100,7,>100
2358,mentioned,993,24658610,91.1637898606,_100,9,>100
2359,signs,992,24659602,91.1674573211,_100,5,>100
2360,example,992,24660594,91.1711247817,_100,7,>100
2361,spell,991,24661585,91.1747885452,_100,5,>100
2362,grandma,990,24662575,91.1784486117,_100,7,>100
2363,image,990,24663565,91.1821086782,_100,5,>100
2364,uses,990,24664555,91.1857687447,_100,4,>100
2365,knicks,989,24665544,91.1894251141,_100,6,>100
2366,el,988,24666532,91.1930777865,_100,2,>100
2367,policy,988,24667520,91.1967304589,_100,6,>100
2368,crash,988,24668508,91.2003831313,_100,5,>100
2369,americans,984,24669492,91.2040210156,_100,9,>100
2370,rice,984,24670476,91.2076588998,_100,4,>100
2371,leading,983,24671459,91.2112930871,_100,7,>100
2372,hearts,983,24672442,91.2149272743,_100,6,>100
2373,jokes,983,24673425,91.2185614615,_100,5,>100
2374,sarah,982,24674407,91.2221919517,_100,5,>100
2375,honored,982,24675389,91.2258224419,_100,7,>100
2376,giant,981,24676370,91.229449235,_100,5,>100
2377,politics,981,24677351,91.2330760282,_100,8,>100
2378,mentions,980,24678331,91.2366991243,_100,8,>100
2379,sadly,980,24679311,91.2403222204,_100,5,>100
2380,perry,979,24680290,91.2439416195,_100,5,>100
2381,nuts,979,24681269,91.2475610186,_100,4,>100
2382,punch,978,24682247,91.2511767206,_100,5,>100
2383,valley,978,24683225,91.2547924227,_100,6,>100
2384,libraries,978,24684203,91.2584081247,_100,9,>100
2385,peter,977,24685180,91.2620201297,_100,5,>100
2386,opened,977,24686157,91.2656321347,_100,6,>100
2387,impressed,976,24687133,91.2692404427,_100,9,>100
2388,besides,975,24688108,91.2728450536,_100,7,>100
2389,lower,974,24689082,91.2764459675,_100,5,>100
2390,phones,974,24690056,91.2800468814,_100,6,>100
2391,z,973,24691029,91.2836440982,_100,1,>100
2392,grad,972,24692001,91.2872376181,_100,4,>100
2393,paint,972,24692973,91.2908311379,_100,5,>100
2394,legit,972,24693945,91.2944246577,_100,5,>100
2395,idiot,972,24694917,91.2980181775,_100,5,>100
2396,contract,971,24695888,91.3016080003,_100,8,>100
2397,improve,970,24696858,91.305194126,_100,7,>100
2398,regret,970,24697828,91.3087802518,_100,6,>100
2399,cookie,967,24698795,91.3123552864,_100,6,>100
2400,district,967,24699762,91.3159303211,_100,8,>100
2401,answers,967,24700729,91.3195053557,_100,7,>100
2402,shes,966,24701695,91.3230766933,_100,4,>100
2403,gear,965,24702660,91.3266443339,_100,4,>100
2404,okc,965,24703625,91.3302119744,_100,3,>100
2405,council,965,24704590,91.333779615,_100,7,>100
2406,naked,963,24705553,91.3373398615,_100,5,>100
2407,deserves,963,24706516,91.3409001079,_100,8,>100
2408,purple,963,24707479,91.3444603544,_100,6,>100
2409,kim,963,24708442,91.3480206009,_100,3,>100
2410,exam,959,24709401,91.3515660593,_100,4,>100
2411,featuring,958,24710359,91.3551078206,_100,9,>100
2412,expensive,958,24711317,91.3586495819,_100,9,>100
2413,express,956,24712273,91.3621839491,_100,7,>100
2414,hood,954,24713227,91.3657109223,_100,4,>100
2415,talkin,954,24714181,91.3692378954,_100,6,>100
2416,limited,954,24715135,91.3727648686,_100,7,>100
2417,spurs,954,24716089,91.3762918417,_100,5,>100
2418,guide,953,24717042,91.3798151178,_100,5,>100
2419,makeup,951,24717993,91.3833309999,_100,6,>100
2420,mini,950,24718943,91.3868431849,_100,4,>100
2421,complain,950,24719893,91.3903553699,_100,8,>100
2422,indy,949,24720842,91.3938638579,_100,4,>100
2423,yess,949,24721791,91.3973723458,_100,4,>100
2424,negative,948,24722739,91.4008771368,_100,8,>100
2425,programs,948,24723687,91.4043819277,_100,8,>100
2426,picks,948,24724635,91.4078867187,_100,5,>100
2427,sam,948,24725583,91.4113915096,_100,3,>100
2428,pieces,947,24726530,91.4148926035,_100,6,>100
2429,built,947,24727477,91.4183936974,_100,5,>100
2430,kicked,947,24728424,91.4218947913,_100,6,>100
2431,respond,946,24729370,91.4253921881,_100,7,>100
2432,drug,945,24730315,91.428885888,_100,4,>100
2433,musical,945,24731260,91.4323795878,_100,7,>100
2434,homeless,943,24732203,91.4358658935,_100,8,>100
2435,covered,940,24733143,91.4393411082,_100,7,>100
2436,mixtape,940,24734083,91.4428163228,_100,7,>100
2437,chillin,939,24735022,91.4462878404,_100,7,>100
2438,whoever,938,24735960,91.449755661,_100,7,>100
2439,packers,938,24736898,91.4532234816,_100,7,>100
2440,anyways,936,24737834,91.456683908,_100,7,>100
2441,families,936,24738770,91.4601443345,_100,8,>100
2442,continues,935,24739705,91.463601064,_100,9,>100
2443,shorts,935,24740640,91.4670577934,_100,6,>100
2444,caps,935,24741575,91.4705145229,_100,4,>100
2445,arms,935,24742510,91.4739712524,_100,4,>100
2446,meetings,934,24743444,91.4774242848,_100,8,>100
2447,circle,933,24744377,91.4808736202,_100,6,>100
2448,newest,932,24745309,91.4843192585,_100,6,>100
2449,friendly,931,24746240,91.4877611998,_100,8,>100
2450,despite,931,24747171,91.4912031411,_100,7,>100
2451,promo,931,24748102,91.4946450824,_100,5,>100
2452,fri,930,24749032,91.4980833267,_100,3,>100
2453,930,930,24749962,91.501521571,_100,3,>100
2454,winners,929,24750891,91.5049561182,_100,7,>100
2455,bound,929,24751820,91.5083906654,_100,5,>100
2456,writers,929,24752749,91.5118252127,_100,7,>100
2457,updated,928,24753677,91.5152560629,_100,7,>100
2458,pure,928,24754605,91.5186869131,_100,4,>100
2459,neck,928,24755533,91.5221177633,_100,4,>100
2460,statement,928,24756461,91.5255486135,_100,9,>100
2461,labor,928,24757389,91.5289794637,_100,5,>100
2462,november,927,24758316,91.5324066168,_100,8,>100
2463,frank,926,24759242,91.5358300729,_100,5,>100
2464,reference,925,24760167,91.539249832,_100,9,>100
2465,kisses,925,24761092,91.5426695911,_100,6,>100
2466,hole,924,24762016,91.5460856532,_100,4,>100
2467,yell,923,24762939,91.5494980182,_100,4,>100
2468,becomes,922,24763861,91.5529066862,_100,7,>100
2469,mommy,921,24764782,91.5563116571,_100,5,>100
2470,ads,921,24765703,91.559716628,_100,3,>100
2471,faces,920,24766623,91.5631179019,_100,5,>100
2472,chair,919,24767542,91.5665154788,_100,5,>100
2473,eric,918,24768460,91.5699093586,_100,4,>100
2474,ears,917,24769377,91.5732995414,_100,4,>100
2475,solo,917,24770294,91.5766897242,_100,4,>100
2476,rts,916,24771210,91.58007621,_100,3,>100
2477,nc,916,24772126,91.5834626957,_100,2,>100
2478,flip,916,24773042,91.5868491815,_100,4,>100
2479,eh,914,24773956,91.5902282732,_100,2,>100
2480,threw,914,24774870,91.5936073649,_100,5,>100
2481,calendar,914,24775784,91.5969864565,_100,8,>100
2482,dates,914,24776698,91.6003655482,_100,5,>100
2483,connection,914,24777612,91.6037446399,_100,10,>100
2484,steal,913,24778525,91.6071200345,_100,5,>100
2485,election,913,24779438,91.6104954292,_100,8,>100
2486,charles,912,24780350,91.6138671268,_100,7,>100
2487,kicking,912,24781262,91.6172388244,_100,7,>100
2488,alert,911,24782173,91.620606825,_100,5,>100
2489,arm,911,24783084,91.6239748255,_100,3,>100
2490,911,911,24783995,91.6273428261,_100,3,>100
2491,blessings,911,24784906,91.6307108267,_100,9,>100
2492,greater,910,24785816,91.6340751302,_100,7,>100
2493,onto,909,24786725,91.6374357367,_100,4,>100
2494,junior,909,24787634,91.6407963432,_100,6,>100
2495,gross,908,24788542,91.6441532527,_100,5,>100
2496,beers,908,24789450,91.6475101621,_100,5,>100
2497,adventure,907,24790357,91.6508633746,_100,9,>100
2498,fried,907,24791264,91.654216587,_100,5,>100
2499,monster,906,24792170,91.6575661024,_100,7,>100
2500,chips,905,24793075,91.6609119207,_100,5,>100
2501,china,905,24793980,91.6642577391,_100,5,>100
2502,max,904,24794884,91.6675998604,_100,3,>100
2503,parties,904,24795788,91.6709419817,_100,7,>100
2504,storms,903,24796691,91.674280406,_100,6,>100
2505,tiny,901,24797592,91.6776114362,_100,4,>100
2506,entertainment,901,24798493,91.6809424664,_100,13,>100
2507,register,901,24799394,91.6842734966,_100,8,>100
2508,keys,901,24800295,91.6876045268,_100,4,>100
2509,hide,901,24801196,91.690935557,_100,4,>100
2510,billion,900,24802096,91.6942628902,_100,7,>100
2511,necessary,900,24802996,91.6975902233,_100,9,>100
2512,900,900,24803896,91.7009175565,_100,3,>100
2513,texts,900,24804796,91.7042448897,_100,5,>100
2514,tomato,899,24805695,91.7075685258,_100,6,>100
2515,gunna,898,24806593,91.7108884649,_100,5,>100
2516,opens,898,24807491,91.714208404,_100,5,>100
2517,sd,898,24808389,91.7175283431,_100,2,>100
2518,mountain,898,24809287,91.7208482821,_100,8,>100
2519,cloud,897,24810184,91.7241645242,_100,5,>100
2520,memphis,897,24811081,91.7274807663,_100,7,>100
2521,leaves,897,24811978,91.7307970083,_100,6,>100
2522,kelly,896,24812874,91.7341095533,_100,5,>100
2523,barely,896,24813770,91.7374220984,_100,6,>100
2524,preparing,896,24814666,91.7407346434,_100,9,>100
2525,odd,895,24815561,91.7440434913,_100,3,>100
2526,auto,895,24816456,91.7473523393,_100,4,>100
2527,ton,895,24817351,91.7506611873,_100,3,>100
2528,francisco,894,24818245,91.7539663383,_100,9,>100
2529,saving,894,24819139,91.7572714892,_100,6,>100
2530,doc,894,24820033,91.7605766401,_100,3,>100
2531,bud,893,24820926,91.7638780941,_100,3,>100
2532,forgive,892,24821818,91.7671758509,_100,7,>100
2533,blues,891,24822709,91.7704699108,_100,5,>100
2534,chase,891,24823600,91.7737639706,_100,5,>100
2535,sink,891,24824491,91.7770580304,_100,4,>100
2536,offers,891,24825382,91.7803520903,_100,6,>100
2537,booked,891,24826273,91.7836461501,_100,6,>100
2538,tan,891,24827164,91.7869402099,_100,3,>100
2539,stayed,890,24828054,91.7902305727,_100,6,>100
2540,unique,890,24828944,91.7935209355,_100,6,>100
2541,puts,890,24829834,91.7968112983,_100,4,>100
2542,headache,890,24830724,91.8001016611,_100,8,>100
2543,stone,889,24831613,91.8033883269,_100,5,>100
2544,dvd,889,24832502,91.8066749926,_100,3,>100
2545,fl,889,24833391,91.8099616584,_100,2,>100
2546,parts,888,24834279,91.8132446271,_100,5,>100
2547,discount,887,24835166,91.8165238988,_100,8,>100
2548,slowly,887,24836053,91.8198031705,_100,6,>100
2549,tasting,887,24836940,91.8230824422,_100,7,>100
2550,omfg,887,24837827,91.8263617139,_100,4,>100
2551,advantage,886,24838713,91.8296372885,_100,9,>100
2552,surgery,886,24839599,91.8329128632,_100,7,>100
2553,asks,886,24840485,91.8361884378,_100,4,>100
2554,helpful,885,24841370,91.8394603154,_100,7,>100
2555,chuck,885,24842255,91.842732193,_100,5,>100
2556,isnt,884,24843139,91.8460003736,_100,4,>100
2557,choices,884,24844023,91.8492685542,_100,7,>100
2558,speaker,884,24844907,91.8525367348,_100,7,>100
2559,relaxing,884,24845791,91.8558049154,_100,8,>100
2560,parade,882,24846673,91.8590657019,_100,6,>100
2561,suit,882,24847555,91.8623264884,_100,4,>100
2562,offense,881,24848436,91.8655835778,_100,7,>100
2563,walker,881,24849317,91.8688406673,_100,6,>100
2564,favorites,879,24850196,91.8720903627,_100,9,>100
2565,sore,879,24851075,91.8753400581,_100,4,>100
2566,laundry,878,24851953,91.8785860564,_100,7,>100
2567,taxes,878,24852831,91.8818320548,_100,5,>100
2568,flowers,877,24853708,91.8850743561,_100,7,>100
2569,fyi,877,24854585,91.8883166574,_100,3,>100
2570,wi,877,24855462,91.8915589587,_100,2,>100
2571,foundation,877,24856339,91.8948012601,_100,10,>100
2572,tall,876,24857215,91.8980398643,_100,4,>100
2573,jimmy,876,24858091,91.9012784686,_100,5,>100
2574,flow,876,24858967,91.9045170729,_100,4,>100
2575,joined,875,24859842,91.9077519801,_100,6,>100
2576,medical,875,24860717,91.9109868874,_100,7,>100
2577,packing,875,24861592,91.9142217946,_100,7,>100
2578,writer,873,24862465,91.9174493078,_100,6,>100
2579,fave,873,24863338,91.920676821,_100,4,>100
2580,ps,873,24864211,91.9239043341,_100,2,>100
2581,falls,870,24865081,91.9271207562,_100,5,>100
2582,addicted,870,24865951,91.9303371783,_100,8,>100
2583,discovered,869,24866820,91.9335499033,_100,10,>100
2584,obsessed,869,24867689,91.9367626283,_100,8,>100
2585,metro,869,24868558,91.9399753533,_100,5,>100
2586,aka,868,24869426,91.9431843813,_100,3,>100
2587,useful,868,24870294,91.9463934093,_100,6,>100
2588,qb,868,24871162,91.9496024373,_100,2,>100
2589,ceo,867,24872029,91.9528077682,_100,3,>100
2590,fries,867,24872896,91.9560130992,_100,5,>100
2591,manning,866,24873762,91.9592147331,_100,7,>100
2592,prayer,865,24874627,91.96241267,_100,6,>100
2593,considered,864,24875491,91.9656069098,_100,10,>100
2594,rid,863,24876354,91.9687974526,_100,3,>100
2595,italian,863,24877217,91.9719879954,_100,7,>100
2596,increase,863,24878080,91.9751785382,_100,8,>100
2597,bridge,861,24878941,91.978361687,_100,6,>100
2598,growth,861,24879802,91.9815448357,_100,6,>100
2599,jeans,861,24880663,91.9847279844,_100,5,>100
2600,pandora,860,24881523,91.9879074361,_100,7,>100
2601,angeles,860,24882383,91.9910868878,_100,7,>100
2602,slept,860,24883243,91.9942663395,_100,5,>100
2603,personally,859,24884102,91.9974420941,_100,10,>100
2604,finale,858,24884960,92.0006141518,_100,6,>100
2605,chef,857,24885817,92.0037825123,_100,4,>100
2606,offering,857,24886674,92.0069508729,_100,8,>100
2607,resume,857,24887531,92.0101192335,_100,6,>100
2608,bills,857,24888388,92.0132875941,_100,5,>100
2609,rude,856,24889244,92.0164522576,_100,4,>100
2610,prepared,855,24890099,92.0196132241,_100,8,>100
2611,streets,855,24890954,92.0227741906,_100,7,>100
2612,irish,855,24891809,92.0259351572,_100,5,>100
2613,agent,855,24892664,92.0290961237,_100,5,>100
2614,courage,854,24893518,92.0322533931,_100,7,>100
2615,protect,854,24894372,92.0354106626,_100,7,>100
2616,crossed,854,24895226,92.0385679321,_100,7,>100
2617,wars,853,24896079,92.0417215045,_100,4,>100
2618,wayne,853,24896932,92.0448750769,_100,5,>100
2619,impressive,853,24897785,92.0480286494,_100,10,>100
2620,novel,853,24898638,92.0511822218,_100,5,>100
2621,films,851,24899489,92.0543284002,_100,5,>100
2622,birth,850,24900339,92.0574708815,_100,5,>100
2623,painting,850,24901189,92.0606133628,_100,8,>100
2624,grill,850,24902039,92.0637558441,_100,5,>100
2625,delivery,849,24902888,92.0668946284,_100,8,>100
2626,mirror,849,24903737,92.0700334127,_100,6,>100
2627,plate,848,24904585,92.0731685,_100,5,>100
2628,hates,848,24905433,92.0763035872,_100,5,>100
2629,bars,847,24906280,92.0794349774,_100,4,>100
2630,poker,847,24907127,92.0825663676,_100,5,>100
2631,derby,847,24907974,92.0856977578,_100,5,>100
2632,custom,846,24908820,92.088825451,_100,6,>100
2633,lying,846,24909666,92.0919531442,_100,5,>100
2634,economy,844,24910510,92.0950734433,_100,7,>100
2635,server,844,24911354,92.0981937424,_100,6,>100
2636,breathe,844,24912198,92.1013140415,_100,7,>100
2637,jan,843,24913041,92.1044306436,_100,3,>100
2638,donate,843,24913884,92.1075472456,_100,6,>100
2639,woot,843,24914727,92.1106638477,_100,4,>100
2640,trash,842,24915569,92.1137767527,_100,5,>100
2641,mo,842,24916411,92.1168896578,_100,2,>100
2642,anthony,842,24917253,92.1200025628,_100,7,>100
2643,february,841,24918094,92.1231117708,_100,8,>100
2644,solution,841,24918935,92.1262209788,_100,8,>100
2645,umm,839,24919774,92.1293227927,_100,3,>100
2646,boat,839,24920613,92.1324246066,_100,4,>100
2647,va,839,24921452,92.1355264205,_100,2,>100
2648,southern,839,24922291,92.1386282344,_100,8,>100
2649,shift,839,24923130,92.1417300484,_100,5,>100
2650,gain,838,24923968,92.1448281652,_100,4,>100
2651,motivation,838,24924806,92.1479262821,_100,10,>100
2652,became,838,24925644,92.151024399,_100,6,>100
2653,switch,837,24926481,92.1541188188,_100,6,>100
2654,tap,837,24927318,92.1572132387,_100,3,>100
2655,prince,837,24928155,92.1603076585,_100,6,>100
2656,patio,837,24928992,92.1634020784,_100,5,>100
2657,modern,837,24929829,92.1664964982,_100,6,>100
2658,mrs,837,24930666,92.1695909181,_100,3,>100
2659,concept,837,24931503,92.1726853379,_100,7,>100
2660,cried,836,24932339,92.1757760607,_100,5,>100
2661,lessons,835,24933174,92.1788630865,_100,7,>100
2662,steps,835,24934009,92.1819501123,_100,5,>100
2663,mode,835,24934844,92.185037138,_100,4,>100
2664,cali,835,24935679,92.1881241638,_100,4,>100
2665,stream,834,24936513,92.1912074925,_100,6,>100
2666,financial,834,24937347,92.1942908213,_100,9,>100
2667,memorial,833,24938180,92.197370453,_100,8,>100
2668,actor,833,24939013,92.2004500847,_100,5,>100
2669,graduate,833,24939846,92.2035297164,_100,8,>100
2670,blind,832,24940678,92.206605651,_100,5,>100
2671,safety,832,24941510,92.2096815857,_100,6,>100
2672,sec,831,24942341,92.2127538233,_100,3,>100
2673,pressure,831,24943172,92.2158260609,_100,8,>100
2674,flash,831,24944003,92.2188982985,_100,5,>100
2675,balance,831,24944834,92.2219705362,_100,7,>100
2676,listened,830,24945664,92.2250390768,_100,8,>100
2677,grant,829,24946493,92.2281039203,_100,5,>100
2678,canada,829,24947322,92.2311687639,_100,6,>100
2679,alcohol,829,24948151,92.2342336074,_100,7,>100
2680,foods,829,24948980,92.237298451,_100,5,>100
2681,trick,829,24949809,92.2403632945,_100,5,>100
2682,tiger,828,24950637,92.243424441,_100,5,>100
2683,tape,827,24951464,92.2464818905,_100,4,>100
2684,lab,827,24952291,92.24953934,_100,3,>100
2685,michigan,827,24953118,92.2525967894,_100,8,>100
2686,hah,826,24953944,92.2556505419,_100,3,>100
2687,skip,826,24954770,92.2587042943,_100,4,>100
2688,rehearsal,826,24955596,92.2617580468,_100,9,>100
2689,screw,825,24956421,92.2648081022,_100,5,>100
2690,theory,824,24957245,92.2678544605,_100,6,>100
2691,pregnant,824,24958069,92.2709008189,_100,8,>100
2692,accident,824,24958893,92.2739471773,_100,8,>100
2693,finger,822,24959715,92.2769861415,_100,6,>100
2694,path,821,24960536,92.2800214088,_100,4,>100
2695,allen,821,24961357,92.2830566761,_100,5,>100
2696,vip,821,24962178,92.2860919433,_100,3,>100
2697,trivia,821,24962999,92.2891272106,_100,6,>100
2698,serving,821,24963820,92.2921624778,_100,7,>100
2699,sisters,821,24964641,92.2951977451,_100,7,>100
2700,pub,821,24965462,92.2982330123,_100,3,>100
2701,resources,821,24966283,92.3012682796,_100,9,>100
2702,congress,821,24967104,92.3043035468,_100,8,>100
2703,exhibit,820,24967924,92.3073351171,_100,7,>100
2704,benefits,820,24968744,92.3103666873,_100,8,>100
2705,shape,820,24969564,92.3133982575,_100,5,>100
2706,breaks,820,24970384,92.3164298277,_100,6,>100
2707,lonely,820,24971204,92.3194613979,_100,6,>100
2708,unfollow,820,24972024,92.3224929681,_100,8,>100
2709,carolina,819,24972843,92.3255208413,_100,8,>100
2710,colorado,819,24973662,92.3285487145,_100,8,>100
2711,angel,819,24974481,92.3315765877,_100,5,>100
2712,pacers,818,24975299,92.3346007638,_100,6,>100
2713,lyrics,818,24976117,92.33762494,_100,6,>100
2714,colors,818,24976935,92.3406491161,_100,6,>100
2715,actors,817,24977752,92.3436695952,_100,6,>100
2716,typing,817,24978569,92.3466900743,_100,6,>100
2717,celebrity,817,24979386,92.3497105534,_100,9,>100
2718,nails,817,24980203,92.3527310325,_100,5,>100
2719,kings,817,24981020,92.3557515117,_100,5,>100
2720,prove,816,24981836,92.3587682937,_100,5,>100
2721,drawing,815,24982651,92.3617813788,_100,7,>100
2722,wheel,815,24983466,92.3647944638,_100,5,>100
2723,humor,815,24984281,92.3678075488,_100,5,>100
2724,tragedy,814,24985095,92.3708169368,_100,7,>100
2725,dis,814,24985909,92.3738263248,_100,3,>100
2726,drugs,814,24986723,92.3768357128,_100,5,>100
2727,woods,813,24987536,92.3798414038,_100,5,>100
2728,uncle,812,24988348,92.3828433977,_100,5,>100
2729,rob,812,24989160,92.3858453916,_100,3,>100
2730,promote,812,24989972,92.3888473855,_100,7,>100
2731,rockin,811,24990783,92.3918456824,_100,6,>100
2732,andrew,811,24991594,92.3948439793,_100,6,>100
2733,awe,811,24992405,92.3978422762,_100,3,>100
2734,estate,811,24993216,92.4008405731,_100,6,>100
2735,failed,811,24994027,92.40383887,_100,6,>100
2736,december,811,24994838,92.4068371669,_100,8,>100
2737,ups,811,24995649,92.4098354637,_100,3,>100
2738,dare,810,24996459,92.4128300636,_100,4,>100
2739,puppy,810,24997269,92.4158246634,_100,5,>100
2740,clock,810,24998079,92.4188192633,_100,5,>100
2741,freakin,809,24998888,92.4218101661,_100,7,>100
2742,craving,809,24999697,92.4248010689,_100,7,>100
2743,guilty,809,25000506,92.4277919717,_100,6,>100
2744,christ,808,25001314,92.4307791775,_100,6,>100
2745,ap,807,25002121,92.4337626862,_100,2,>100
2746,non,806,25002927,92.4367424979,_100,3,>100
2747,mixed,806,25003733,92.4397223096,_100,5,>100
2748,workshops,805,25004538,92.4426984243,_100,9,>100
2749,gm,804,25005342,92.4456708419,_100,2,>100
2750,clark,804,25006146,92.4486432596,_100,5,>100
2751,sport,804,25006950,92.4516156772,_100,5,>100
2752,skinny,804,25007754,92.4545880948,_100,6,>100
2753,bo,803,25008557,92.4575568154,_100,2,>100
2754,hiring,803,25009360,92.460525536,_100,6,>100
2755,accounts,802,25010162,92.4634905596,_100,8,>100
2756,pulling,802,25010964,92.4664555831,_100,7,>100
2757,liking,802,25011766,92.4694206067,_100,6,>100
2758,hs,802,25012568,92.4723856302,_100,2,>100
2759,stores,802,25013370,92.4753506538,_100,6,>100
2760,wen,801,25014171,92.4783119803,_100,3,>100
2761,facts,801,25014972,92.4812733068,_100,5,>100
2762,mitt,800,25015772,92.4842309363,_100,4,>100
2763,800,800,25016572,92.4871885658,_100,3,>100
2764,logo,800,25017372,92.4901461953,_100,4,>100
2765,chances,800,25018172,92.4931038247,_100,7,>100
2766,prepare,800,25018972,92.4960614542,_100,7,>100
2767,grace,799,25019771,92.4990153867,_100,5,>100
2768,cutting,799,25020570,92.5019693191,_100,7,>100
2769,buffalo,799,25021369,92.5049232515,_100,7,>100
2770,hugs,799,25022168,92.507877184,_100,4,>100
2771,pinterest,798,25022966,92.5108274194,_100,9,>100
2772,soft,798,25023764,92.5137776548,_100,4,>100
2773,fully,797,25024561,92.5167241932,_100,5,>100
2774,focused,797,25025358,92.5196707315,_100,7,>100
2775,screaming,796,25026154,92.5226135729,_100,9,>100
2776,madness,796,25026950,92.5255564142,_100,7,>100
2777,expecting,796,25027746,92.5284992555,_100,9,>100
2778,aye,796,25028542,92.5314420969,_100,3,>100
2779,september,794,25029336,92.5343775441,_100,9,>100
2780,subway,793,25030129,92.5373092944,_100,6,>100
2781,generation,793,25030922,92.5402410446,_100,10,>100
2782,virginia,791,25031713,92.5431654007,_100,8,>100
2783,reviews,791,25032504,92.5460897569,_100,7,>100
2784,kindle,790,25033294,92.549010416,_100,6,>100
2785,bags,788,25034082,92.551923681,_100,4,>100
2786,icon,788,25034870,92.5548369461,_100,4,>100
2787,ship,788,25035658,92.5577502111,_100,4,>100
2788,summit,786,25036444,92.5606560821,_100,6,>100
2789,porn,786,25037230,92.563561953,_100,4,>100
2790,podcast,785,25038015,92.566464127,_100,7,>100
2791,engagement,784,25038799,92.5693626039,_100,10,>100
2792,hire,784,25039583,92.5722610807,_100,4,>100
2793,mental,783,25040366,92.5751558606,_100,6,>100
2794,charity,783,25041149,92.5780506405,_100,7,>100
2795,blake,783,25041932,92.5809454203,_100,5,>100
2796,lincoln,782,25042714,92.5838365031,_100,7,>100
2797,stopping,782,25043496,92.5867275859,_100,8,>100
2798,neighbor,781,25044277,92.5896149717,_100,8,>100
2799,further,781,25045058,92.5925023575,_100,7,>100
2800,filming,780,25045838,92.5953860463,_100,7,>100
2801,duh,780,25046618,92.598269735,_100,3,>100
2802,specific,780,25047398,92.6011534237,_100,8,>100
2803,bs,779,25048177,92.6040334154,_100,2,>100
2804,ghost,779,25048956,92.6069134072,_100,5,>100
2805,pride,779,25049735,92.6097933989,_100,5,>100
2806,dressed,779,25050514,92.6126733906,_100,7,>100
2807,asian,778,25051292,92.6155496852,_100,5,>100
2808,farm,776,25052068,92.6184185858,_100,4,>100
2809,suggest,776,25052844,92.6212874864,_100,7,>100
2810,committee,774,25053618,92.624148993,_100,9,>100
2811,patience,774,25054392,92.6270104995,_100,8,>100
2812,gon,774,25055166,92.629872006,_100,3,>100
2813,momma,774,25055940,92.6327335125,_100,5,>100
2814,result,773,25056713,92.635591322,_100,6,>100
2815,bang,773,25057486,92.6384491315,_100,4,>100
2816,ooh,772,25058258,92.6413032439,_100,3,>100
2817,lifetime,772,25059030,92.6441573564,_100,8,>100
2818,decent,771,25059801,92.6470077718,_100,6,>100
2819,hardest,769,25060570,92.6498507931,_100,7,>100
2820,alarm,769,25061339,92.6526938145,_100,5,>100
2821,civil,767,25062106,92.6555294417,_100,5,>100
2822,thurs,767,25062873,92.658365069,_100,5,>100
2823,trailer,767,25063640,92.6612006963,_100,7,>100
2824,male,767,25064407,92.6640363235,_100,4,>100
2825,corporate,766,25065173,92.6668682538,_100,9,>100
2826,invited,766,25065939,92.669700184,_100,7,>100
2827,active,766,25066705,92.6725321142,_100,6,>100
2828,edge,766,25067471,92.6753640444,_100,4,>100
2829,innovation,766,25068237,92.6781959747,_100,10,>100
2830,wasnt,765,25069002,92.6810242079,_100,5,>100
2831,bull,765,25069767,92.6838524411,_100,4,>100
2832,package,764,25070531,92.6866769772,_100,7,>100
2833,kansas,763,25071294,92.6894978163,_100,6,>100
2834,emotional,763,25072057,92.6923186554,_100,9,>100
2835,txt,762,25072819,92.6951357975,_100,3,>100
2836,props,762,25073581,92.6979529396,_100,5,>100
2837,fired,762,25074343,92.7007700817,_100,5,>100
2838,gallery,761,25075104,92.7035835267,_100,7,>100
2839,advance,761,25075865,92.7063969718,_100,7,>100
2840,peanut,760,25076625,92.7092067198,_100,6,>100
2841,overall,760,25077385,92.7120164678,_100,7,>100
2842,jail,760,25078145,92.7148262158,_100,4,>100
2843,whip,759,25078904,92.7176322668,_100,4,>100
2844,intense,759,25079663,92.7204383177,_100,7,>100
2845,cable,759,25080422,92.7232443687,_100,5,>100
2846,cities,758,25081180,92.7260467226,_100,6,>100
2847,succeed,758,25081938,92.7288490766,_100,7,>100
2848,smiling,756,25082694,92.7316440364,_100,7,>100
2849,owner,755,25083449,92.7344352992,_100,5,>100
2850,advertising,755,25084204,92.7372265621,_100,11,>100
2851,quotes,755,25084959,92.7400178249,_100,6,>100
2852,william,754,25085713,92.7428053907,_100,7,>100
2853,awareness,754,25086467,92.7455929565,_100,9,>100
2854,rising,754,25087221,92.7483805223,_100,6,>100
2855,unfollowed,753,25087974,92.751164391,_100,10,>100
2856,tyler,753,25088727,92.7539482597,_100,5,>100
2857,myspace,753,25089480,92.7567321285,_100,7,>100
2858,raised,753,25090233,92.7595159972,_100,6,>100
2859,lane,752,25090985,92.762296169,_100,4,>100
2860,comic,752,25091737,92.7650763407,_100,5,>100
2861,ear,752,25092489,92.7678565124,_100,3,>100
2862,obvious,752,25093241,92.7706366841,_100,7,>100
2863,papers,752,25093993,92.7734168558,_100,6,>100
2864,bite,751,25094744,92.7761933305,_100,4,>100
2865,clue,751,25095495,92.7789698052,_100,4,>100
2866,urban,751,25096246,92.7817462798,_100,5,>100
2867,flat,750,25096996,92.7845190575,_100,4,>100
2868,effective,749,25097745,92.7872881381,_100,9,>100
2869,stronger,749,25098494,92.7900572187,_100,8,>100
2870,banana,748,25099242,92.7928226022,_100,6,>100
2871,conversations,747,25099989,92.7955842888,_100,13,>100
2872,features,747,25100736,92.7983459753,_100,8,>100
2873,bio,747,25101483,92.8011076618,_100,3,>100
2874,females,747,25102230,92.8038693483,_100,7,>100
2875,silver,747,25102977,92.8066310349,_100,6,>100
2876,studies,746,25103723,92.8093890244,_100,7,>100
2877,grey,746,25104469,92.8121470139,_100,4,>100
2878,businesses,746,25105215,92.8149050033,_100,10,>100
2879,convo,746,25105961,92.8176629928,_100,5,>100
2880,afford,745,25106706,92.8204172853,_100,6,>100
2881,gifts,745,25107451,92.8231715777,_100,5,>100
2882,antonio,745,25108196,92.8259258702,_100,7,>100
2883,phil,744,25108940,92.8286764656,_100,4,>100
2884,tied,744,25109684,92.831427061,_100,4,>100
2885,physical,744,25110428,92.8341776564,_100,8,>100
2886,immediately,744,25111172,92.8369282519,_100,11,>100
2887,seeking,744,25111916,92.8396788473,_100,7,>100
2888,yelled,743,25112659,92.8424257457,_100,6,>100
2889,drew,743,25113402,92.845172644,_100,4,>100
2890,punk,743,25114145,92.8479195424,_100,4,>100
2891,premiere,743,25114888,92.8506664408,_100,8,>100
2892,independent,743,25115631,92.8534133392,_100,11,>100
2893,employees,742,25116373,92.8561565405,_100,9,>100
2894,trees,742,25117115,92.8588997419,_100,5,>100
2895,aha,742,25117857,92.8616429432,_100,3,>100
2896,announcement,742,25118599,92.8643861446,_100,12,>100
2897,fancy,741,25119340,92.8671256489,_100,5,>100
2898,drake,741,25120081,92.8698651532,_100,5,>100
2899,tasty,740,25120821,92.8726009604,_100,5,>100
2900,bother,739,25121560,92.8753330707,_100,6,>100
2901,bf,739,25122299,92.8780651809,_100,2,>100
2902,rite,738,25123037,92.8807935941,_100,4,>100
2903,pretend,737,25123774,92.8835183103,_100,7,>100
2904,valentines,736,25124510,92.8862393294,_100,10,>100
2905,bottles,736,25125246,92.8889603485,_100,7,>100
2906,loose,736,25125982,92.8916813676,_100,5,>100
2907,audio,736,25126718,92.8944023867,_100,5,>100
2908,wrap,736,25127454,92.8971234059,_100,4,>100
2909,clippers,736,25128190,92.899844425,_100,8,>100
2910,organization,736,25128926,92.9025654441,_100,12,>100
2911,orleans,735,25129661,92.9052827662,_100,7,>100
2912,finna,735,25130396,92.9080000883,_100,5,>100
2913,deserved,734,25131130,92.9107137133,_100,8,>100
2914,silent,733,25131863,92.9134236413,_100,6,>100
2915,chip,732,25132595,92.9161298723,_100,4,>100
2916,delete,732,25133327,92.9188361033,_100,6,>100
2917,cap,731,25134058,92.9215386372,_100,3,>100
2918,spots,730,25134788,92.9242374741,_100,5,>100
2919,730,730,25135518,92.926936311,_100,3,>100
2920,groups,730,25136248,92.9296351479,_100,6,>100
2921,ocean,730,25136978,92.9323339848,_100,5,>100
2922,cure,730,25137708,92.9350328217,_100,4,>100
2923,spreading,730,25138438,92.9377316586,_100,9,>100
2924,served,729,25139167,92.9404267985,_100,6,>100
2925,burning,729,25139896,92.9431219384,_100,7,>100
2926,accepted,729,25140625,92.9458170782,_100,8,>100
2927,hunt,728,25141353,92.9485085211,_100,4,>100
2928,thanx,728,25142081,92.9511999639,_100,5,>100
2929,xmas,728,25142809,92.9538914067,_100,4,>100
2930,convention,727,25143536,92.9565791525,_100,10,>100
2931,material,725,25144261,92.9592595042,_100,8,>100
2932,personality,725,25144986,92.9619398559,_100,11,>100
2933,threat,725,25145711,92.9646202077,_100,6,>100
2934,dangerous,725,25146436,92.9673005594,_100,9,>100
2935,vodka,725,25147161,92.9699809111,_100,5,>100
2936,raw,724,25147885,92.9726575658,_100,3,>100
2937,license,724,25148609,92.9753342204,_100,7,>100
2938,forum,724,25149333,92.9780108751,_100,5,>100
2939,seven,723,25150056,92.9806838328,_100,5,>100
2940,edition,723,25150779,92.9833567904,_100,7,>100
2941,preview,723,25151502,92.9860297481,_100,7,>100
2942,featured,722,25152224,92.9886990087,_100,8,>100
2943,connected,722,25152946,92.9913682693,_100,9,>100
2944,wordpress,722,25153668,92.9940375299,_100,9,>100
2945,iron,722,25154390,92.9967067905,_100,4,>100
2946,traveling,722,25155112,92.9993760511,_100,9,>100
2947,animals,721,25155833,93.0020416147,_100,7,>100
2948,injury,721,25156554,93.0047071782,_100,6,>100
2949,oregon,720,25157274,93.0073690448,_100,6,>100
2950,homes,720,25157994,93.0100309113,_100,5,>100
2951,screening,719,25158713,93.0126890808,_100,9,>100
2952,boyz,719,25159432,93.0153472503,_100,4,>100
2953,warning,718,25160150,93.0180017227,_100,7,>100
2954,yankees,717,25160867,93.0206524982,_100,7,>100
2955,actions,717,25161584,93.0233032736,_100,7,>100
2956,scream,716,25162300,93.025950352,_100,6,>100
2957,cody,716,25163016,93.0285974304,_100,4,>100
2958,ncaa,716,25163732,93.0312445087,_100,4,>100
2959,duck,715,25164447,93.0338878901,_100,4,>100
2960,demand,715,25165162,93.0365312714,_100,6,>100
2961,costs,715,25165877,93.0391746528,_100,5,>100
2962,subject,715,25166592,93.0418180341,_100,7,>100
2963,wifi,714,25167306,93.0444577184,_100,4,>100
2964,yikes,714,25168020,93.0470974028,_100,5,>100
2965,poetry,713,25168733,93.04973339,_100,6,>100
2966,articles,712,25169445,93.0523656803,_100,8,>100
2967,entertaining,712,25170157,93.0549979705,_100,12,>100
2968,claim,712,25170869,93.0576302607,_100,5,>100
2969,argument,712,25171581,93.060262551,_100,8,>100
2970,socks,710,25172291,93.0628874472,_100,5,>100
2971,understanding,710,25173001,93.0655123433,_100,13,>100
2972,british,709,25173710,93.0681335424,_100,7,>100
2973,devil,706,25174416,93.0707436505,_100,5,>100
2974,guard,706,25175122,93.0733537585,_100,5,>100
2975,softball,706,25175828,93.0759638665,_100,8,>100
2976,interviews,705,25176533,93.0785702775,_100,10,>100
2977,craft,705,25177238,93.0811766885,_100,5,>100
2978,darn,705,25177943,93.0837830994,_100,4,>100
2979,henry,705,25178648,93.0863895104,_100,5,>100
2980,confidence,704,25179352,93.0889922244,_100,10,>100
2981,shared,704,25180056,93.0915949383,_100,6,>100
2982,silence,704,25180760,93.0941976522,_100,7,>100
2983,suggestion,704,25181464,93.0968003662,_100,10,>100
2984,inspire,704,25182168,93.0994030801,_100,7,>100
2985,recovery,704,25182872,93.1020057941,_100,8,>100
2986,tank,703,25183575,93.104604811,_100,4,>100
2987,peyton,703,25184278,93.1072038279,_100,6,>100
2988,brooklyn,702,25184980,93.1097991478,_100,8,>100
2989,clothing,702,25185682,93.1123944676,_100,8,>100
2990,joint,702,25186384,93.1149897875,_100,5,>100
2991,lips,702,25187086,93.1175851074,_100,4,>100
2992,millions,702,25187788,93.1201804272,_100,8,>100
2993,pot,702,25188490,93.1227757471,_100,3,>100
2994,tunes,701,25189191,93.1253673699,_100,5,>100
2995,ruin,701,25189892,93.1279589928,_100,4,>100
2996,duty,701,25190593,93.1305506156,_100,4,>100
2997,knee,701,25191294,93.1331422384,_100,4,>100
2998,tear,701,25191995,93.1357338613,_100,4,>100
2999,exhausted,700,25192695,93.1383217871,_100,9,>100
3000,700,700,25193395,93.1409097129,_100,3,>100
3001,celtics,700,25194095,93.1434976386,_100,7,>100
3002,expert,700,25194795,93.1460855644,_100,6,>100
3003,century,700,25195495,93.1486734902,_100,7,>100
3004,terms,699,25196194,93.151257719,_100,5,>100
3005,praise,698,25196892,93.1538382507,_100,6,>100
3006,recipe,698,25197590,93.1564187824,_100,6,>100
3007,friendship,698,25198288,93.1589993142,_100,10,>100
3008,loser,698,25198986,93.1615798459,_100,5,>100
3009,younger,697,25199683,93.1641566806,_100,7,>100
3010,murder,697,25200380,93.1667335153,_100,6,>100
3011,stole,696,25201076,93.1693066529,_100,5,>100
3012,grew,696,25201772,93.1718797906,_100,4,>100
3013,zero,696,25202468,93.1744529282,_100,4,>100
3014,cops,696,25203164,93.1770260658,_100,4,>100
3015,wilson,696,25203860,93.1795992035,_100,6,>100
3016,replace,695,25204555,93.1821686441,_100,7,>100
3017,deadline,695,25205250,93.1847380847,_100,8,>100
3018,underwear,695,25205945,93.1873075253,_100,9,>100
3019,charlie,695,25206640,93.1898769659,_100,7,>100
3020,nbc,695,25207335,93.1924464066,_100,3,>100
3021,casting,694,25208029,93.1950121501,_100,7,>100
3022,standard,694,25208723,93.1975778937,_100,8,>100
3023,chi,693,25209416,93.2001399402,_100,3,>100
3024,zombie,692,25210108,93.2026982897,_100,6,>100
3025,piss,691,25210799,93.2052529422,_100,4,>100
3026,eventually,691,25211490,93.2078075947,_100,10,>100
3027,aaron,691,25212181,93.2103622471,_100,5,>100
3028,watchin,691,25212872,93.2129168996,_100,7,>100
3029,exact,690,25213562,93.215467855,_100,5,>100
3030,toast,690,25214252,93.2180188104,_100,5,>100
3031,systems,690,25214942,93.2205697659,_100,7,>100
3032,doe,690,25215632,93.2231207213,_100,3,>100
3033,freak,689,25216321,93.2256679797,_100,5,>100
3034,rally,688,25217009,93.228211541,_100,5,>100
3035,creation,687,25217696,93.2307514054,_100,8,>100
3036,oct,687,25218383,93.2332912697,_100,3,>100
3037,reached,687,25219070,93.235831134,_100,7,>100
3038,desire,687,25219757,93.2383709983,_100,6,>100
3039,angels,687,25220444,93.2409108626,_100,6,>100
3040,salt,687,25221131,93.2434507269,_100,4,>100
3041,military,686,25221817,93.2459868942,_100,8,>100
3042,throat,686,25222503,93.2485230615,_100,6,>100
3043,nov,685,25223188,93.2510555317,_100,3,>100
3044,comfortable,685,25223873,93.253588002,_100,11,>100
3045,platform,685,25224558,93.2561204722,_100,8,>100
3046,piano,685,25225243,93.2586529425,_100,5,>100
3047,bible,684,25225927,93.2611817157,_100,5,>100
3048,shore,684,25226611,93.2637104889,_100,5,>100
3049,attempt,684,25227295,93.2662392621,_100,7,>100
3050,hubby,684,25227979,93.2687680353,_100,5,>100
3051,jessica,683,25228662,93.2712931115,_100,7,>100
3052,searching,683,25229345,93.2738181876,_100,9,>100
3053,plant,682,25230027,93.2763395668,_100,5,>100
3054,designer,682,25230709,93.2788609459,_100,8,>100
3055,throughout,682,25231391,93.281382325,_100,10,>100
3056,discussing,682,25232073,93.2839037042,_100,10,>100
3057,sweetheart,681,25232754,93.2864213863,_100,10,>100
3058,describe,681,25233435,93.2889390684,_100,8,>100
3059,recommendations,681,25234116,93.2914567505,_100,15,>100
3060,paris,681,25234797,93.2939744326,_100,5,>100
3061,disagree,681,25235478,93.2964921146,_100,8,>100
3062,coaches,681,25236159,93.2990097967,_100,7,>100
3063,travels,680,25236839,93.3015237818,_100,7,>100
3064,bobby,679,25237518,93.3040340698,_100,5,>100
3065,apologize,679,25238197,93.3065443578,_100,9,>100
3066,wheels,679,25238876,93.3090546459,_100,6,>100
3067,cuts,679,25239555,93.3115649339,_100,4,>100
3068,proof,679,25240234,93.3140752219,_100,5,>100
3069,agency,679,25240913,93.3165855099,_100,6,>100
3070,legend,678,25241591,93.3190921009,_100,6,>100
3071,dropping,677,25242268,93.3215949949,_100,8,>100
3072,remembered,677,25242945,93.3240978888,_100,10,>100
3073,phoenix,677,25243622,93.3266007828,_100,7,>100
3074,sets,676,25244298,93.3290999797,_100,4,>100
3075,ouch,676,25244974,93.3315991766,_100,4,>100
3076,coke,676,25245650,93.3340983735,_100,4,>100
3077,cancelled,676,25246326,93.3365975704,_100,9,>100
3078,regardless,676,25247002,93.3390967673,_100,10,>100
3079,views,676,25247678,93.3415959642,_100,5,>100
3080,cupcakes,675,25248353,93.3440914641,_100,8,>100
3081,andy,675,25249028,93.346586964,_100,4,>100
3082,england,674,25249702,93.3490787668,_100,7,>100
3083,fourth,674,25250376,93.3515705696,_100,6,>100
3084,suddenly,674,25251050,93.3540623725,_100,8,>100
3085,twin,673,25251723,93.3565504783,_100,4,>100
3086,votes,673,25252396,93.3590385841,_100,5,>100
3087,lineup,673,25253069,93.3615266899,_100,6,>100
3088,wood,672,25253741,93.3640110987,_100,4,>100
3089,yahoo,672,25254413,93.3664955074,_100,5,>100
3090,reporting,671,25255084,93.3689762191,_100,9,>100
3091,comin,671,25255755,93.3714569309,_100,5,>100
3092,sees,670,25256425,93.3739339456,_100,4,>100
3093,percent,670,25257095,93.3764109603,_100,7,>100
3094,perfectly,669,25257764,93.3788842779,_100,9,>100
3095,amy,669,25258433,93.3813575956,_100,3,>100
3096,deliver,669,25259102,93.3838309132,_100,7,>100
3097,howard,669,25259771,93.3863042309,_100,6,>100
3098,weekly,668,25260439,93.3887738515,_100,6,>100
3099,tourney,668,25261107,93.3912434721,_100,7,>100
3100,grocery,667,25261774,93.3937093957,_100,7,>100
3101,models,667,25262441,93.3961753193,_100,6,>100
3102,cab,667,25263108,93.3986412428,_100,3,>100
3103,victims,667,25263775,93.4011071664,_100,7,>100
3104,zoo,666,25264441,93.403569393,_100,3,>100
3105,rates,666,25265107,93.4060316195,_100,5,>100
3106,woohoo,665,25265772,93.408490149,_100,6,>100
3107,toward,665,25266437,93.4109486785,_100,6,>100
3108,messed,665,25267102,93.413407208,_100,6,>100
3109,stands,665,25267767,93.4158657375,_100,6,>100
3110,prep,664,25268431,93.41832057,_100,4,>100
3111,ol,664,25269095,93.4207754025,_100,2,>100
3112,toilet,664,25269759,93.4232302349,_100,6,>100
3113,submit,663,25270422,93.4256813704,_100,6,>100
3114,columbus,663,25271085,93.4281325058,_100,8,>100
3115,fab,663,25271748,93.4305836412,_100,3,>100
3116,tl,662,25272410,93.4330310796,_100,2,>100
3117,arizona,662,25273072,93.435478518,_100,7,>100
3118,noise,662,25273734,93.4379259564,_100,5,>100
3119,walks,661,25274395,93.4403696978,_100,5,>100
3120,creativity,661,25275056,93.4428134391,_100,10,>100
3121,compliment,660,25275716,93.4452534834,_100,10,>100
3122,mlb,660,25276376,93.4476935278,_100,3,>100
3123,potato,660,25277036,93.4501335721,_100,6,>100
3124,activity,659,25277695,93.4525699194,_100,8,>100
3125,mic,659,25278354,93.4550062667,_100,3,>100
3126,cherry,659,25279013,93.4574426139,_100,6,>100
3127,giveaway,659,25279672,93.4598789612,_100,8,>100
3128,route,659,25280331,93.4623153085,_100,5,>100
3129,scheduled,658,25280989,93.4647479588,_100,9,>100
3130,file,657,25281646,93.467176912,_100,4,>100
3131,weekends,657,25282303,93.4696058652,_100,8,>100
3132,crime,657,25282960,93.4720348184,_100,5,>100
3133,wasted,657,25283617,93.4744637716,_100,6,>100
3134,fame,656,25284273,93.4768890278,_100,4,>100
3135,grilled,656,25284929,93.479314284,_100,7,>100
3136,pocket,655,25285584,93.4817358431,_100,6,>100
3137,achieve,655,25286239,93.4841574022,_100,7,>100
3138,owe,655,25286894,93.4865789614,_100,3,>100
3139,glee,655,25287549,93.4890005205,_100,4,>100
3140,blowing,655,25288204,93.4914220796,_100,7,>100
3141,application,655,25288859,93.4938436388,_100,11,>100
3142,lisa,654,25289513,93.4962615009,_100,4,>100
3143,virtual,654,25290167,93.498679363,_100,7,>100
3144,pa,653,25290820,93.501093528,_100,2,>100
3145,remain,653,25291473,93.5035076931,_100,6,>100
3146,ga,653,25292126,93.5059218582,_100,2,>100
3147,wave,653,25292779,93.5083360232,_100,4,>100
3148,images,653,25293432,93.5107501883,_100,6,>100
3149,spider,653,25294085,93.5131643534,_100,6,>100
3150,nike,652,25294737,93.5155748214,_100,4,>100
3151,chilling,652,25295389,93.5179852894,_100,8,>100
3152,roof,652,25296041,93.5203957574,_100,4,>100
3153,forgotten,652,25296693,93.5228062255,_100,9,>100
3154,voicemail,651,25297344,93.5252129965,_100,9,>100
3155,est,651,25297995,93.5276197674,_100,3,>100
3156,frozen,651,25298646,93.5300265384,_100,6,>100
3157,jets,651,25299297,93.5324333094,_100,4,>100
3158,aware,650,25299947,93.5348363834,_100,5,>100
3159,sentence,650,25300597,93.5372394573,_100,8,>100
3160,complaining,650,25301247,93.5396425313,_100,11,>100
3161,nor,649,25301896,93.5420419082,_100,3,>100
3162,load,648,25302544,93.5444375881,_100,4,>100
3163,triple,648,25303192,93.546833268,_100,6,>100
3164,perspective,648,25303840,93.5492289478,_100,11,>100
3165,corn,647,25304487,93.5516209307,_100,4,>100
3166,nothin,647,25305134,93.5540129135,_100,6,>100
3167,recognize,646,25305780,93.5564011993,_100,9,>100
3168,hills,646,25306426,93.5587894851,_100,5,>100
3169,tennis,646,25307072,93.5611777709,_100,6,>100
3170,worthwhile,646,25307718,93.5635660568,_100,10,>100
3171,battery,646,25308364,93.5659543426,_100,7,>100
3172,faculty,646,25309010,93.5683426284,_100,7,>100
3173,appear,645,25309655,93.5707272171,_100,6,>100
3174,stops,645,25310300,93.5731118059,_100,5,>100
3175,manage,645,25310945,93.5754963947,_100,6,>100
3176,dem,645,25311590,93.5778809834,_100,3,>100
3177,librarians,644,25312234,93.5802618752,_100,10,>100
3178,cow,644,25312878,93.5826427669,_100,3,>100
3179,strip,644,25313522,93.5850236586,_100,5,>100
3180,bush,644,25314166,93.5874045504,_100,4,>100
3181,wade,644,25314810,93.5897854421,_100,4,>100
3182,pee,643,25315453,93.5921626368,_100,3,>100
3183,department,643,25316096,93.5945398315,_100,10,>100
3184,snake,643,25316739,93.5969170262,_100,5,>100
3185,economic,643,25317382,93.5992942209,_100,8,>100
3186,cubs,643,25318025,93.6016714156,_100,4,>100
3187,pushing,643,25318668,93.6040486103,_100,7,>100
3188,core,642,25319310,93.6064221079,_100,4,>100
3189,patient,641,25319951,93.6087919085,_100,7,>100
3190,concerned,641,25320592,93.6111617092,_100,9,>100
3191,included,641,25321233,93.6135315098,_100,8,>100
3192,calories,641,25321874,93.6159013104,_100,8,>100
3193,expo,640,25322514,93.618267414,_100,4,>100
3194,communication,640,25323154,93.6206335176,_100,13,>100
3195,johnny,640,25323794,93.6229996212,_100,6,>100
3196,swim,639,25324433,93.6253620277,_100,4,>100
3197,constantly,639,25325072,93.6277244343,_100,10,>100
3198,funding,639,25325711,93.6300868408,_100,7,>100
3199,hunter,639,25326350,93.6324492474,_100,6,>100
3200,musicians,639,25326989,93.6348116539,_100,9,>100
3201,locked,638,25327627,93.6371703634,_100,6,>100
3202,jon,638,25328265,93.6395290729,_100,3,>100
3203,phrase,638,25328903,93.6418877824,_100,6,>100
3204,coaching,638,25329541,93.6442464919,_100,8,>100
3205,pork,637,25330178,93.6466015044,_100,4,>100
3206,terribly,637,25330815,93.6489565169,_100,8,>100
3207,bummer,637,25331452,93.6513115294,_100,6,>100
3208,inning,637,25332089,93.6536665418,_100,6,>100
3209,buzz,637,25332726,93.6560215543,_100,4,>100
3210,holla,637,25333363,93.6583765668,_100,5,>100
3211,presents,636,25333999,93.6607278822,_100,8,>100
3212,partners,635,25334634,93.6630755006,_100,8,>100
3213,smooth,635,25335269,93.665423119,_100,6,>100
3214,produce,635,25335904,93.6677707374,_100,7,>100
3215,unknown,635,25336539,93.6701183558,_100,7,>100
3216,bath,635,25337174,93.6724659742,_100,4,>100
3217,belly,634,25337808,93.6748098956,_100,5,>100
3218,presence,633,25338441,93.6771501199,_100,8,>100
3219,msg,632,25339073,93.6794866472,_100,3,>100
3220,ii,631,25339704,93.6818194775,_100,2,>100
3221,longest,631,25340335,93.6841523077,_100,7,>100
3222,hating,631,25340966,93.686485138,_100,6,>100
3223,youve,631,25341597,93.6888179682,_100,5,>100
3224,thrilled,630,25342227,93.6911471014,_100,8,>100
3225,homemade,630,25342857,93.6934762347,_100,8,>100
3226,ll,630,25343487,93.6958053679,_100,2,>100
3227,dam,630,25344117,93.6981345011,_100,3,>100
3228,broadway,629,25344746,93.7004599373,_100,8,>100
3229,fools,629,25345375,93.7027853734,_100,5,>100
3230,metal,629,25346004,93.7051108096,_100,5,>100
3231,gang,629,25346633,93.7074362458,_100,4,>100
3232,reunion,629,25347262,93.709761682,_100,7,>100
3233,twins,628,25347890,93.7120834211,_100,5,>100
3234,survive,628,25348518,93.7144051603,_100,7,>100
3235,cruise,628,25349146,93.7167268994,_100,6,>100
3236,candidate,628,25349774,93.7190486385,_100,9,>100
3237,journal,627,25350401,93.7213666807,_100,7,>100
3238,ultimate,627,25351028,93.7236847228,_100,8,>100
3239,wrestling,627,25351655,93.7260027649,_100,9,>100
3240,sweat,626,25352281,93.7283171099,_100,5,>100
3241,shortly,625,25352906,93.730627758,_100,7,>100
3242,survey,625,25353531,93.732938406,_100,6,>100
3243,reception,625,25354156,93.735249054,_100,9,>100
3244,horror,625,25354781,93.7375597021,_100,6,>100
3245,costume,625,25355406,93.7398703501,_100,7,>100
3246,dec,625,25356031,93.7421809981,_100,3,>100
3247,rocked,625,25356656,93.7444916462,_100,6,>100
3248,directly,624,25357280,93.7467985972,_100,8,>100
3249,az,624,25357904,93.7491055481,_100,2,>100
3250,bruh,623,25358527,93.7514088021,_100,4,>100
3251,levels,623,25359150,93.7537120561,_100,6,>100
3252,stranger,623,25359773,93.75601531,_100,8,>100
3253,shoe,623,25360396,93.758318564,_100,4,>100
3254,sweetie,623,25361019,93.7606218179,_100,7,>100
3255,rescue,621,25361640,93.7629176778,_100,6,>100
3256,blonde,621,25362261,93.7652135377,_100,6,>100
3257,factor,621,25362882,93.7675093976,_100,6,>100
3258,drove,620,25363502,93.7698015604,_100,5,>100
3259,nuggets,620,25364122,93.7720937233,_100,7,>100
3260,et,620,25364742,93.7743858861,_100,2,>100
3261,appreciation,620,25365362,93.776678049,_100,12,>100
3262,drivers,620,25365982,93.7789702118,_100,7,>100
3263,bug,619,25366601,93.7812586776,_100,3,>100
3264,capital,619,25367220,93.7835471434,_100,7,>100
3265,619,619,25367839,93.7858356093,_100,3,>100
3266,medicine,619,25368458,93.7881240751,_100,8,>100
3267,kicks,618,25369076,93.7904088438,_100,5,>100
3268,captain,618,25369694,93.7926936126,_100,7,>100
3269,construction,618,25370312,93.7949783814,_100,12,>100
3270,greg,618,25370930,93.7972631502,_100,4,>100
3271,fascinating,618,25371548,93.7995479189,_100,11,>100
3272,dreaming,618,25372166,93.8018326877,_100,8,>100
3273,bench,618,25372784,93.8041174565,_100,5,>100
3274,blessing,618,25373402,93.8064022253,_100,8,>100
3275,delay,617,25374019,93.808683297,_100,5,>100
3276,designs,617,25374636,93.8109643687,_100,7,>100
3277,scored,616,25375252,93.8132417434,_100,6,>100
3278,attractive,616,25375868,93.8155191181,_100,10,>100
3279,salsa,616,25376484,93.8177964928,_100,5,>100
3280,walmart,616,25377100,93.8200738675,_100,7,>100
3281,letters,616,25377716,93.8223512422,_100,7,>100
3282,venue,615,25378331,93.8246249199,_100,5,>100
3283,speakers,615,25378946,93.8268985976,_100,8,>100
3284,familiar,615,25379561,93.8291722752,_100,8,>100
3285,jerry,615,25380176,93.8314459529,_100,5,>100
3286,princess,615,25380791,93.8337196306,_100,8,>100
3287,comfort,614,25381405,93.8359896112,_100,7,>100
3288,fiction,614,25382019,93.8382595918,_100,7,>100
3289,appears,614,25382633,93.8405295724,_100,7,>100
3290,academy,614,25383247,93.8427995531,_100,7,>100
3291,zoom,613,25383860,93.8450658366,_100,4,>100
3292,approach,613,25384473,93.8473321202,_100,8,>100
3293,map,612,25385085,93.8495947068,_100,3,>100
3294,lemon,612,25385697,93.8518572933,_100,5,>100
3295,librarian,612,25386309,93.8541198799,_100,9,>100
3296,staring,612,25386921,93.8563824664,_100,7,>100
3297,donuts,612,25387533,93.858645053,_100,6,>100
3298,workers,612,25388145,93.8609076396,_100,7,>100
3299,boots,612,25388757,93.8631702261,_100,5,>100
3300,opposite,612,25389369,93.8654328127,_100,8,>100
3301,distance,610,25389979,93.8676880051,_100,8,>100
3302,mondays,610,25390589,93.8699431976,_100,7,>100
3303,fed,610,25391199,93.8721983901,_100,3,>100
3304,outstanding,609,25391808,93.8744498855,_100,11,>100
3305,poster,609,25392417,93.876701381,_100,6,>100
3306,vocals,609,25393026,93.8789528764,_100,6,>100
3307,ages,609,25393635,93.8812043719,_100,4,>100
3308,gary,609,25394244,93.8834558673,_100,4,>100
3309,beating,608,25394852,93.8857036657,_100,7,>100
3310,false,608,25395460,93.8879514641,_100,5,>100
3311,federal,607,25396067,93.8901955655,_100,7,>100
3312,primary,607,25396674,93.8924396669,_100,7,>100
3313,brew,607,25397281,93.8946837682,_100,4,>100
3314,hopes,607,25397888,93.8969278696,_100,5,>100
3315,printing,607,25398495,93.899171971,_100,8,>100
3316,rare,606,25399101,93.9014123753,_100,4,>100
3317,republican,606,25399707,93.9036527796,_100,10,>100
3318,deck,605,25400312,93.9058894869,_100,4,>100
3319,highest,605,25400917,93.9081261942,_100,7,>100
3320,lovers,604,25401521,93.9103592045,_100,6,>100
3321,fund,604,25402125,93.9125922147,_100,4,>100
3322,esp,604,25402729,93.914825225,_100,3,>100
3323,covers,604,25403333,93.9170582352,_100,6,>100
3324,beta,604,25403937,93.9192912455,_100,4,>100
3325,tribute,604,25404541,93.9215242558,_100,7,>100
3326,individual,603,25405144,93.923753569,_100,10,>100
3327,religion,603,25405747,93.9259828822,_100,8,>100
3328,racing,602,25406349,93.9282084984,_100,6,>100
3329,laughed,602,25406951,93.9304341146,_100,7,>100
3330,parent,602,25407553,93.9326597308,_100,6,>100
3331,error,602,25408155,93.9348853469,_100,5,>100
3332,hottest,602,25408757,93.9371109631,_100,7,>100
3333,jacket,602,25409359,93.9393365793,_100,6,>100
3334,pat,601,25409960,93.9415584985,_100,3,>100
3335,flavor,601,25410561,93.9437804176,_100,6,>100
3336,army,600,25411161,93.9459986397,_100,4,>100
3337,relevant,600,25411761,93.9482168618,_100,8,>100
3338,chicks,600,25412361,93.9504350839,_100,6,>100
3339,600,600,25412961,93.952653306,_100,3,>100
3340,vegan,600,25413561,93.9548715282,_100,5,>100
3341,fml,600,25414161,93.9570897503,_100,3,>100
3342,blogs,600,25414761,93.9593079724,_100,5,>100
3343,beard,599,25415360,93.9615224974,_100,5,>100
3344,saints,599,25415959,93.9637370225,_100,6,>100
3345,illegal,598,25416557,93.9659478506,_100,7,>100
3346,glory,597,25417154,93.9681549816,_100,5,>100
3347,stated,597,25417751,93.9703621126,_100,6,>100
3348,oscar,597,25418348,93.9725692436,_100,5,>100
3349,blocked,597,25418945,93.9747763746,_100,7,>100
3350,tests,596,25419541,93.9769798085,_100,5,>100
3351,appropriate,595,25420136,93.9791795454,_100,11,>100
3352,candidates,595,25420731,93.9813792824,_100,10,>100
3353,santorum,595,25421326,93.9835790193,_100,8,>100
3354,hawks,594,25421920,93.9857750592,_100,5,>100
3355,salon,594,25422514,93.9879710991,_100,5,>100
3356,stays,594,25423108,93.990167139,_100,5,>100
3357,appointment,593,25423701,93.9923594818,_100,11,>100
3358,demo,593,25424294,93.9945518247,_100,4,>100
3359,solutions,593,25424887,93.9967441675,_100,9,>100
3360,garage,592,25425479,93.9989328133,_100,6,>100
3361,painful,592,25426071,94.0011214592,_100,7,>100
3362,pace,591,25426662,94.0033064079,_100,4,>100
3363,counts,591,25427253,94.0054913567,_100,6,>100
3364,root,590,25427843,94.0076726085,_100,4,>100
3365,emergency,590,25428433,94.0098538602,_100,9,>100
3366,debt,589,25429022,94.0120314149,_100,4,>100
3367,countdown,589,25429611,94.0142089696,_100,9,>100
3368,wouldnt,589,25430200,94.0163865243,_100,7,>100
3369,keynote,588,25430788,94.018560382,_100,7,>100
3370,potter,588,25431376,94.0207342397,_100,6,>100
3371,resource,588,25431964,94.0229080973,_100,8,>100
3372,allows,588,25432552,94.025081955,_100,6,>100
3373,senate,588,25433140,94.0272558127,_100,6,>100
3374,settle,587,25433727,94.0294259733,_100,6,>100
3375,morgan,587,25434314,94.0315961339,_100,6,>100
3376,sight,587,25434901,94.0337662946,_100,5,>100
3377,chili,587,25435488,94.0359364552,_100,5,>100
3378,regarding,587,25436075,94.0381066158,_100,9,>100
3379,includes,587,25436662,94.0402767764,_100,8,>100
3380,seminar,586,25437248,94.04244324,_100,7,>100
3381,richard,586,25437834,94.0446097036,_100,7,>100
3382,experiences,586,25438420,94.0467761672,_100,11,>100
3383,chest,586,25439006,94.0489426308,_100,5,>100
3384,pepper,586,25439592,94.0511090944,_100,6,>100
3385,digging,586,25440178,94.053275558,_100,7,>100
3386,compared,585,25440763,94.0554383246,_100,8,>100
3387,patriots,585,25441348,94.0576010911,_100,8,>100
3388,sean,585,25441933,94.0597638577,_100,4,>100
3389,behavior,585,25442518,94.0619266242,_100,8,>100
3390,excitement,584,25443102,94.0640856938,_100,10,>100
3391,arrive,583,25443685,94.0662410662,_100,6,>100
3392,electric,583,25444268,94.0683964387,_100,8,>100
3393,sept,583,25444851,94.0705518112,_100,4,>100
3394,hurting,583,25445434,94.0727071837,_100,7,>100
3395,ward,583,25446017,94.0748625562,_100,4,>100
3396,guessing,583,25446600,94.0770179287,_100,8,>100
3397,rent,582,25447182,94.0791696041,_100,4,>100
3398,therapy,582,25447764,94.0813212796,_100,7,>100
3399,shoulder,582,25448346,94.083472955,_100,8,>100
3400,lion,582,25448928,94.0856246305,_100,4,>100
3401,beans,582,25449510,94.0877763059,_100,5,>100
3402,speaks,582,25450092,94.0899279814,_100,6,>100
3403,webinar,582,25450674,94.0920796568,_100,7,>100
3404,naw,582,25451256,94.0942313322,_100,3,>100
3405,convinced,581,25451837,94.0963793107,_100,9,>100
3406,poll,581,25452418,94.0985272891,_100,4,>100
3407,louisville,581,25452999,94.1006752675,_100,10,>100
3408,presenting,581,25453580,94.1028232459,_100,10,>100
3409,heels,581,25454161,94.1049712243,_100,5,>100
3410,arena,581,25454742,94.1071192027,_100,5,>100
3411,africa,581,25455323,94.1092671811,_100,6,>100
3412,hawaii,581,25455904,94.1114151595,_100,6,>100
3413,pc,580,25456484,94.1135594409,_100,2,>100
3414,furniture,580,25457064,94.1157037223,_100,9,>100
3415,georgia,580,25457644,94.1178480037,_100,7,>100
3416,thousand,579,25458223,94.119988588,_100,8,>100
3417,monkey,578,25458801,94.1221254753,_100,6,>100
3418,chose,578,25459379,94.1242623626,_100,5,>100
3419,bummed,578,25459957,94.1263992499,_100,6,>100
3420,burgers,578,25460535,94.1285361372,_100,7,>100
3421,range,578,25461113,94.1306730245,_100,5,>100
3422,exchange,578,25461691,94.1328099118,_100,8,>100
3423,academic,577,25462268,94.134943102,_100,8,>100
3424,dedicated,577,25462845,94.1370762923,_100,9,>100
3425,japan,577,25463422,94.1392094826,_100,5,>100
3426,treats,576,25463998,94.1413389758,_100,6,>100
3427,whiskey,576,25464574,94.143468469,_100,7,>100
3428,responsible,576,25465150,94.1455979623,_100,11,>100
3429,herself,575,25465725,94.1477237584,_100,7,>100
3430,discover,575,25466300,94.1498495546,_100,8,>100
3431,seemed,575,25466875,94.1519753508,_100,6,>100
3432,belt,575,25467450,94.154101147,_100,4,>100
3433,bruce,574,25468024,94.1562232462,_100,5,>100
3434,larry,574,25468598,94.1583453453,_100,5,>100
3435,dies,574,25469172,94.1604674445,_100,4,>100
3436,michelle,573,25469745,94.1625858466,_100,8,>100
3437,kudos,573,25470318,94.1647042487,_100,5,>100
3438,swimming,573,25470891,94.1668226508,_100,8,>100
3439,recorded,573,25471464,94.1689410529,_100,8,>100
3440,orders,573,25472037,94.171059455,_100,6,>100
3441,sponsor,573,25472610,94.1731778572,_100,7,>100
3442,nj,572,25473182,94.1752925622,_100,2,>100
3443,definition,572,25473754,94.1774072673,_100,10,>100
3444,broncos,572,25474326,94.1795219724,_100,7,>100
3445,refuse,572,25474898,94.1816366775,_100,6,>100
3446,drag,572,25475470,94.1837513826,_100,4,>100
3447,outfit,571,25476041,94.1858623906,_100,6,>100
3448,gray,571,25476612,94.1879733986,_100,4,>100
3449,ted,570,25477182,94.1900807096,_100,3,>100
3450,slightly,570,25477752,94.1921880206,_100,8,>100
3451,tongue,570,25478322,94.1942953317,_100,6,>100
3452,blew,570,25478892,94.1964026427,_100,4,>100
3453,trail,570,25479462,94.1985099537,_100,5,>100
3454,kills,569,25480031,94.2006135676,_100,5,>100
3455,gaga,569,25480600,94.2027171816,_100,4,>100
3456,foul,569,25481169,94.2048207956,_100,4,>100
3457,influence,568,25481737,94.2069207125,_100,9,>100
3458,valuable,568,25482305,94.2090206294,_100,8,>100
3459,whoops,568,25482873,94.2111205464,_100,6,>100
3460,lemme,567,25483440,94.2132167663,_100,5,>100
3461,texted,567,25484007,94.2153129861,_100,6,>100
3462,argue,567,25484574,94.217409206,_100,5,>100
3463,tornado,567,25485141,94.2195054259,_100,7,>100
3464,aunt,567,25485708,94.2216016458,_100,4,>100
3465,carpet,567,25486275,94.2236978657,_100,6,>100
3466,yelling,567,25486842,94.2257940856,_100,7,>100
3467,selection,567,25487409,94.2278903055,_100,9,>100
3468,photography,567,25487976,94.2299865254,_100,11,>100
3469,franklin,567,25488543,94.2320827453,_100,8,>100
3470,dislike,566,25489109,94.2341752682,_100,7,>100
3471,scores,566,25489675,94.236267791,_100,6,>100
3472,connecting,566,25490241,94.2383603139,_100,10,>100
3473,holds,566,25490807,94.2404528367,_100,5,>100
3474,shocked,565,25491372,94.2425416626,_100,7,>100
3475,billy,565,25491937,94.2446304884,_100,5,>100
3476,proper,565,25492502,94.2467193142,_100,6,>100
3477,cop,565,25493067,94.24880814,_100,3,>100
3478,equal,565,25493632,94.2508969658,_100,5,>100
3479,guests,565,25494197,94.2529857917,_100,6,>100
3480,tub,565,25494762,94.2550746175,_100,3,>100
3481,europe,565,25495327,94.2571634433,_100,6,>100
3482,mahomies,565,25495892,94.2592522691,_100,8,>100
3483,tues,564,25496456,94.2613373979,_100,4,>100
3484,exclusive,564,25497020,94.2634225267,_100,9,>100
3485,offered,564,25497584,94.2655076555,_100,7,>100
3486,drops,564,25498148,94.2675927843,_100,5,>100
3487,develop,564,25498712,94.269677913,_100,7,>100
3488,volunteers,563,25499275,94.2717593448,_100,10,>100
3489,accent,563,25499838,94.2738407765,_100,6,>100
3490,earned,563,25500401,94.2759222083,_100,6,>100
3491,snap,562,25500963,94.277999943,_100,4,>100
3492,village,561,25501524,94.2800739807,_100,7,>100
3493,wreck,561,25502085,94.2821480183,_100,5,>100
3494,reminded,561,25502646,94.284222056,_100,8,>100
3495,combo,561,25503207,94.2862960937,_100,5,>100
3496,reaction,560,25503767,94.2883664343,_100,8,>100
3497,participate,560,25504327,94.290436775,_100,11,>100
3498,toy,560,25504887,94.2925071156,_100,3,>100
3499,struggle,559,25505446,94.2945737592,_100,8,>100
3500,nowhere,559,25506005,94.2966404028,_100,7,>100
3501,hats,559,25506564,94.2987070464,_100,4,>100
3502,nicely,559,25507123,94.30077369,_100,6,>100
3503,professor,559,25507682,94.3028403336,_100,9,>100
3504,flyers,558,25508240,94.3049032802,_100,6,>100
3505,sooner,558,25508798,94.3069662267,_100,6,>100
3506,funniest,558,25509356,94.3090291733,_100,8,>100
3507,hated,557,25509913,94.3110884228,_100,5,>100
3508,tweeters,557,25510470,94.3131476723,_100,8,>100
3509,adults,557,25511027,94.3152069219,_100,6,>100
3510,indie,557,25511584,94.3172661714,_100,5,>100
3511,thus,557,25512141,94.3193254209,_100,4,>100
3512,rachel,557,25512698,94.3213846704,_100,6,>100
3513,childhood,557,25513255,94.32344392,_100,9,>100
3514,ne,557,25513812,94.3255031695,_100,2,>100
3515,hella,557,25514369,94.327562419,_100,5,>100
3516,gf,556,25514925,94.3296179715,_100,2,>100
3517,display,556,25515481,94.331673524,_100,7,>100
3518,brandon,556,25516037,94.3337290765,_100,7,>100
3519,efforts,556,25516593,94.335784629,_100,7,>100
3520,showcase,555,25517148,94.3378364844,_100,8,>100
3521,ruined,555,25517703,94.3398883399,_100,6,>100
3522,proverb,555,25518258,94.3419401953,_100,7,>100
3523,miracle,555,25518813,94.3439920508,_100,7,>100
3524,badly,555,25519368,94.3460439062,_100,5,>100
3525,closet,554,25519922,94.3480920646,_100,6,>100
3526,organic,554,25520476,94.3501402231,_100,7,>100
3527,owners,554,25521030,94.3521883815,_100,6,>100
3528,debut,554,25521584,94.3542365399,_100,5,>100
3529,restaurants,553,25522137,94.3562810013,_100,11,>100
3530,areas,553,25522690,94.3583254626,_100,5,>100
3531,graphic,553,25523243,94.360369924,_100,7,>100
3532,coolest,553,25523796,94.3624143854,_100,7,>100
3533,standards,553,25524349,94.3644588468,_100,9,>100
3534,lit,553,25524902,94.3665033082,_100,3,>100
3535,thnx,553,25525455,94.3685477695,_100,4,>100
3536,cam,553,25526008,94.3705922309,_100,3,>100
3537,refs,552,25526560,94.3726329953,_100,4,>100
3538,wolf,552,25527112,94.3746737596,_100,4,>100
3539,cousins,552,25527664,94.3767145239,_100,7,>100
3540,motion,551,25528215,94.3787515913,_100,6,>100
3541,western,551,25528766,94.3807886586,_100,7,>100
3542,appearance,551,25529317,94.3828257259,_100,10,>100
3543,led,551,25529868,94.3848627932,_100,3,>100
3544,repair,551,25530419,94.3868998605,_100,6,>100
3545,revolution,550,25530969,94.3889332307,_100,10,>100
3546,chief,550,25531519,94.390966601,_100,5,>100
3547,mystery,550,25532069,94.3929999713,_100,7,>100
3548,tend,550,25532619,94.3950333415,_100,4,>100
3549,tastes,550,25533169,94.3970667118,_100,6,>100
3550,instant,549,25533718,94.399096385,_100,7,>100
3551,sxsw,548,25534266,94.4011223612,_100,4,>100
3552,entered,548,25534814,94.4031483374,_100,7,>100
3553,headphones,548,25535362,94.4051743136,_100,10,>100
3554,karaoke,548,25535910,94.4072002898,_100,7,>100
3555,completed,548,25536458,94.409226266,_100,9,>100
3556,nail,548,25537006,94.4112522422,_100,4,>100
3557,tryin,547,25537553,94.4132745214,_100,5,>100
3558,terrific,547,25538100,94.4152968005,_100,8,>100
3559,pounds,547,25538647,94.4173190797,_100,6,>100
3560,pres,547,25539194,94.4193413588,_100,4,>100
3561,highlight,547,25539741,94.421363638,_100,9,>100
3562,hint,546,25540287,94.4233822201,_100,4,>100
3563,masters,546,25540833,94.4254008022,_100,7,>100
3564,savings,546,25541379,94.4274193844,_100,7,>100
3565,feelin,546,25541925,94.4294379665,_100,6,>100
3566,tampa,545,25542470,94.4314528516,_100,5,>100
3567,era,545,25543015,94.4334677366,_100,3,>100
3568,haircut,545,25543560,94.4354826217,_100,7,>100
3569,environment,545,25544105,94.4374975068,_100,11,>100
3570,hamilton,544,25544649,94.4395086949,_100,8,>100
3571,depressing,544,25545193,94.4415198829,_100,10,>100
3572,foster,544,25545737,94.443531071,_100,6,>100
3573,boxes,544,25546281,94.445542259,_100,5,>100
3574,rd,543,25546824,94.44754975,_100,2,>100
3575,previous,543,25547367,94.449557241,_100,8,>100
3576,scratch,543,25547910,94.451564732,_100,7,>100
3577,bonus,543,25548453,94.453572223,_100,5,>100
3578,bowling,543,25548996,94.455579714,_100,7,>100
3579,tigers,542,25549538,94.457583508,_100,6,>100
3580,prime,542,25550080,94.459587302,_100,5,>100
3581,stretch,542,25550622,94.461591096,_100,7,>100
3582,bestfriend,542,25551164,94.4635948899,_100,10,>100
3583,cooler,542,25551706,94.4655986839,_100,6,>100
3584,lolol,541,25552247,94.4675987809,_100,5,>100
3585,studios,541,25552788,94.4695988778,_100,7,>100
3586,newt,541,25553329,94.4715989747,_100,4,>100
3587,hype,541,25553870,94.4735990717,_100,4,>100
3588,edit,540,25554410,94.4755954716,_100,4,>100
3589,types,540,25554950,94.4775918715,_100,5,>100
3590,bat,540,25555490,94.4795882714,_100,3,>100
3591,avatar,540,25556030,94.4815846713,_100,6,>100
3592,burned,540,25556570,94.4835810712,_100,6,>100
3593,producer,540,25557110,94.4855774711,_100,8,>100
3594,hump,539,25557649,94.4875701739,_100,4,>100
3595,rooting,539,25558188,94.4895628768,_100,7,>100
3596,firm,539,25558727,94.4915555796,_100,4,>100
3597,script,539,25559266,94.4935482825,_100,6,>100
3598,upgrade,538,25559804,94.4955372883,_100,7,>100
3599,unbelievable,538,25560342,94.4975262942,_100,12,>100
3600,damage,538,25560880,94.4995153,_100,6,>100
3601,critical,538,25561418,94.5015043058,_100,8,>100
3602,annoyed,538,25561956,94.5034933116,_100,7,>100
3603,finds,537,25562493,94.5054786204,_100,5,>100
3604,seed,537,25563030,94.5074639292,_100,4,>100
3605,woah,537,25563567,94.509449238,_100,4,>100
3606,sides,537,25564104,94.5114345468,_100,5,>100
3607,arrested,537,25564641,94.5134198556,_100,8,>100
3608,thirsty,536,25565177,94.5154014673,_100,7,>100
3609,hangover,536,25565713,94.5173830791,_100,8,>100
3610,fever,536,25566249,94.5193646908,_100,5,>100
3611,ross,535,25566784,94.5213426056,_100,4,>100
3612,worship,535,25567319,94.5233205203,_100,7,>100
3613,promotion,535,25567854,94.525298435,_100,9,>100
3614,throws,535,25568389,94.5272763497,_100,6,>100
3615,lovin,534,25568923,94.5292505674,_100,5,>100
3616,doll,534,25569457,94.5312247851,_100,4,>100
3617,anger,534,25569991,94.5331990027,_100,5,>100
3618,hadn,533,25570524,94.5351695234,_100,4,>100
3619,habit,533,25571057,94.537140044,_100,5,>100
3620,broadcast,533,25571590,94.5391105647,_100,9,>100
3621,blown,533,25572123,94.5410810853,_100,5,>100
3622,loop,533,25572656,94.5430516059,_100,4,>100
3623,delivered,533,25573189,94.5450221266,_100,9,>100
3624,bloody,532,25573721,94.5469889502,_100,6,>100
3625,auction,532,25574253,94.5489557738,_100,7,>100
3626,hosted,532,25574785,94.5509225974,_100,6,>100
3627,pays,532,25575317,94.552889421,_100,4,>100
3628,designed,532,25575849,94.5548562446,_100,8,>100
3629,ours,531,25576380,94.5568193712,_100,4,>100
3630,brady,531,25576911,94.5587824977,_100,5,>100
3631,ditto,531,25577442,94.5607456243,_100,5,>100
3632,bros,530,25577972,94.5627050538,_100,4,>100
3633,embrace,530,25578502,94.5646644834,_100,7,>100
3634,emotions,530,25579032,94.5666239129,_100,8,>100
3635,steelers,530,25579562,94.5685833424,_100,8,>100
3636,outs,530,25580092,94.570542772,_100,4,>100
3637,device,529,25580621,94.5724985045,_100,6,>100
3638,farmers,529,25581150,94.574454237,_100,7,>100
3639,outdoor,528,25581678,94.5764062724,_100,7,>100
3640,recall,528,25582206,94.5783583079,_100,6,>100
3641,donation,527,25582733,94.5803066463,_100,8,>100
3642,surely,527,25583260,94.5822549847,_100,6,>100
3643,pig,526,25583786,94.5841996261,_100,3,>100
3644,niall,526,25584312,94.5861442675,_100,5,>100
3645,represent,526,25584838,94.5880889089,_100,9,>100
3646,accidentally,526,25585364,94.5900335502,_100,12,>100
3647,oakland,526,25585890,94.5919781916,_100,7,>100
3648,pumpkin,525,25586415,94.593919136,_100,7,>100
3649,ham,525,25586940,94.5958600803,_100,3,>100
3650,slap,525,25587465,94.5978010247,_100,4,>100
3651,dept,525,25587990,94.599741969,_100,4,>100
3652,spoke,525,25588515,94.6016829134,_100,5,>100
3653,lbs,525,25589040,94.6036238577,_100,3,>100
3654,kc,524,25589564,94.605561105,_100,2,>100
3655,contacts,524,25590088,94.6074983523,_100,8,>100
3656,scenes,524,25590612,94.6094355996,_100,6,>100
3657,trial,524,25591136,94.6113728469,_100,5,>100
3658,wound,524,25591660,94.6133100943,_100,5,>100
3659,hun,524,25592184,94.6152473416,_100,3,>100
3660,basic,523,25592707,94.6171808918,_100,5,>100
3661,stephen,523,25593230,94.6191144421,_100,7,>100
3662,kate,522,25593752,94.6210442953,_100,4,>100
3663,daniel,522,25594274,94.6229741486,_100,6,>100
3664,forecast,522,25594796,94.6249040018,_100,8,>100
3665,expectations,522,25595318,94.6268338551,_100,12,>100
3666,walls,521,25595839,94.6287600113,_100,5,>100
3667,evidence,521,25596360,94.6306861675,_100,8,>100
3668,welcoming,520,25596880,94.6326086266,_100,9,>100
3669,hoo,520,25597400,94.6345310858,_100,3,>100
3670,complicated,520,25597920,94.6364535449,_100,11,>100
3671,upload,520,25598440,94.6383760041,_100,6,>100
3672,interactive,520,25598960,94.6402984633,_100,11,>100
3673,remove,520,25599480,94.6422209224,_100,6,>100
3674,jewelry,520,25600000,94.6441433816,_100,7,>100
3675,charlotte,519,25600519,94.6460621437,_100,9,>100
3676,screwed,519,25601038,94.6479809058,_100,7,>100
3677,wrapped,519,25601557,94.649899668,_100,7,>100
3678,factory,518,25602075,94.6518147331,_100,7,>100
3679,youu,518,25602593,94.6537297981,_100,4,>100
3680,drank,517,25603110,94.6556411662,_100,5,>100
3681,albert,517,25603627,94.6575525342,_100,6,>100
3682,inner,517,25604144,94.6594639023,_100,5,>100
3683,jennifer,517,25604661,94.6613752704,_100,8,>100
3684,seniors,516,25605177,94.6632829414,_100,7,>100
3685,randomly,516,25605693,94.6651906124,_100,8,>100
3686,solve,516,25606209,94.6670982834,_100,5,>100
3687,attended,515,25606724,94.6690022574,_100,8,>100
3688,eastern,515,25607239,94.6709062314,_100,7,>100
3689,forced,515,25607754,94.6728102053,_100,6,>100
3690,wats,515,25608269,94.6747141793,_100,4,>100
3691,stats,515,25608784,94.6766181533,_100,5,>100
3692,native,515,25609299,94.6785221273,_100,6,>100
3693,disease,515,25609814,94.6804261012,_100,7,>100
3694,xbox,514,25610328,94.6823263782,_100,4,>100
3695,slide,514,25610842,94.6842266551,_100,5,>100
3696,strawberry,514,25611356,94.6861269321,_100,10,>100
3697,cultural,514,25611870,94.688027209,_100,8,>100
3698,invented,513,25612383,94.6899237889,_100,8,>100
3699,whore,513,25612896,94.6918203688,_100,5,>100
3700,tease,513,25613409,94.6937169487,_100,5,>100
3701,chain,513,25613922,94.6956135286,_100,5,>100
3702,activities,512,25614434,94.6975064115,_100,10,>100
3703,conf,512,25614946,94.6993992944,_100,4,>100
3704,duke,512,25615458,94.7012921772,_100,4,>100
3705,desperate,512,25615970,94.7031850601,_100,9,>100
3706,cowboys,512,25616482,94.705077943,_100,7,>100
3707,spin,512,25616994,94.7069708258,_100,4,>100
3708,bust,512,25617506,94.7088637087,_100,4,>100
3709,guns,511,25618017,94.7107528945,_100,4,>100
3710,rage,511,25618528,94.7126420804,_100,4,>100
3711,wore,511,25619039,94.7145312662,_100,4,>100
3712,mornings,511,25619550,94.716420452,_100,8,>100
3713,landed,511,25620061,94.7183096379,_100,6,>100
3714,plastic,511,25620572,94.7201988237,_100,7,>100
3715,streaming,510,25621082,94.7220843125,_100,9,>100
3716,cutest,510,25621592,94.7239698013,_100,6,>100
3717,hahahah,509,25622101,94.725851593,_100,7,>100
3718,penn,509,25622610,94.7277333848,_100,4,>100
3719,brad,509,25623119,94.7296151765,_100,4,>100
3720,located,509,25623628,94.7314969683,_100,7,>100
3721,garbage,508,25624136,94.733375063,_100,7,>100
3722,hiding,508,25624644,94.7352531577,_100,6,>100
3723,recommendation,508,25625152,94.7371312525,_100,14,>100
3724,filling,508,25625660,94.7390093472,_100,7,>100
3725,minnesota,508,25626168,94.7408874419,_100,9,>100
3726,leap,508,25626676,94.7427655366,_100,4,>100
3727,prison,508,25627184,94.7446436313,_100,6,>100
3728,mke,507,25627691,94.746518029,_100,3,>100
3729,spirits,507,25628198,94.7483924267,_100,7,>100
3730,addition,507,25628705,94.7502668244,_100,8,>100
3731,dealing,507,25629212,94.7521412221,_100,7,>100
3732,deleted,507,25629719,94.7540156198,_100,7,>100
3733,whores,506,25630225,94.7558863204,_100,6,>100
3734,laws,506,25630731,94.7577570211,_100,4,>100
3735,covering,506,25631237,94.7596277217,_100,8,>100
3736,entry,506,25631743,94.7614984223,_100,5,>100
3737,baked,506,25632249,94.763369123,_100,5,>100
3738,websites,506,25632755,94.7652398236,_100,8,>100
3739,division,505,25633260,94.7671068272,_100,8,>100
3740,sunset,505,25633765,94.7689738309,_100,6,>100
3741,alumni,505,25634270,94.7708408345,_100,6,>100
3742,cal,505,25634775,94.7727078381,_100,3,>100
3743,happier,505,25635280,94.7745748417,_100,7,>100
3744,wknd,505,25635785,94.7764418453,_100,4,>100
3745,split,504,25636289,94.7783051519,_100,5,>100
3746,jerk,504,25636793,94.7801684584,_100,4,>100
3747,eaten,504,25637297,94.782031765,_100,5,>100
3748,earthquake,504,25637801,94.7838950716,_100,10,>100
3749,seasons,504,25638305,94.7857583782,_100,7,>100
3750,fa,503,25638808,94.7876179877,_100,2,>100
3751,caring,503,25639311,94.7894775972,_100,6,>100
3752,challenges,503,25639814,94.7913372068,_100,10,>100
3753,ughh,503,25640317,94.7931968163,_100,4,>100
3754,coupon,503,25640820,94.7950564258,_100,6,>100
3755,violent,503,25641323,94.7969160354,_100,7,>100
3756,ot,503,25641826,94.7987756449,_100,2,>100
3757,cole,503,25642329,94.8006352544,_100,4,>100
3758,confirmed,502,25642831,94.8024911669,_100,9,>100
3759,tee,502,25643333,94.8043470794,_100,3,>100
3760,abc,502,25643835,94.8062029919,_100,3,>100
3761,treatment,502,25644337,94.8080589044,_100,9,>100
3762,locations,502,25644839,94.8099148169,_100,9,>100
3763,ve,502,25645341,94.8117707294,_100,2,>100
3764,witty,502,25645843,94.8136266419,_100,5,>100
3765,mcdonald,501,25646344,94.8154788574,_100,8,>100
3766,karma,501,25646845,94.8173310729,_100,5,>100
3767,hardly,501,25647346,94.8191832883,_100,6,>100
3768,lecture,501,25647847,94.8210355038,_100,7,>100
3769,ford,501,25648348,94.8228877193,_100,4,>100
3770,philadelphia,501,25648849,94.8247399347,_100,12,>100
3771,kitty,501,25649350,94.8265921502,_100,5,>100
3772,yessir,501,25649851,94.8284443656,_100,6,>100
3773,german,500,25650351,94.8302928841,_100,6,>100
3774,sounded,500,25650851,94.8321414025,_100,7,>100
3775,jose,500,25651351,94.8339899209,_100,4,>100
3776,500,500,25651851,94.8358384393,_100,3,>100
3777,publishing,499,25652350,94.8376832607,_100,10,>100
3778,lewis,499,25652849,94.8395280821,_100,5,>100
3779,requires,499,25653348,94.8413729035,_100,8,>100
3780,earn,499,25653847,94.8432177249,_100,4,>100
3781,drives,499,25654346,94.8450625463,_100,6,>100
3782,avi,499,25654845,94.8469073677,_100,3,>100
3783,champion,498,25655343,94.848748492,_100,8,>100
3784,committed,498,25655841,94.8505896164,_100,9,>100
3785,veggie,498,25656339,94.8524307407,_100,6,>100
3786,gps,498,25656837,94.8542718651,_100,3,>100
3787,property,498,25657335,94.8561129894,_100,8,>100
3788,kyle,497,25657832,94.8579504167,_100,4,>100
3789,nerd,497,25658329,94.8597878441,_100,4,>100
3790,dawn,497,25658826,94.8616252714,_100,4,>100
3791,comeback,496,25659322,94.8634590017,_100,8,>100
3792,gods,496,25659818,94.8652927319,_100,4,>100
3793,measure,496,25660314,94.8671264622,_100,7,>100
3794,sources,496,25660810,94.8689601925,_100,7,>100
3795,fort,496,25661306,94.8707939228,_100,4,>100
3796,racist,495,25661801,94.872623956,_100,6,>100
3797,jeremy,495,25662296,94.8744539892,_100,6,>100
3798,swift,495,25662791,94.8762840225,_100,5,>100
3799,prof,495,25663286,94.8781140557,_100,4,>100
3800,treating,495,25663781,94.879944089,_100,8,>100
3801,prizes,495,25664276,94.8817741222,_100,6,>100
3802,resolution,495,25664771,94.8836041555,_100,10,>100
3803,hooked,495,25665266,94.8854341887,_100,6,>100
3804,visual,495,25665761,94.8872642219,_100,6,>100
3805,snack,494,25666255,94.8890905581,_100,5,>100
3806,teens,494,25666749,94.8909168943,_100,5,>100
3807,vid,494,25667243,94.8927432305,_100,3,>100
3808,essay,494,25667737,94.8945695668,_100,5,>100
3809,bone,494,25668231,94.896395903,_100,4,>100
3810,champagne,493,25668724,94.8982185421,_100,9,>100
3811,sausage,493,25669217,94.9000411813,_100,7,>100
3812,item,493,25669710,94.9018638205,_100,4,>100
3813,bin,493,25670203,94.9036864596,_100,3,>100
3814,pops,493,25670696,94.9055090988,_100,4,>100
3815,officer,492,25671188,94.9073280409,_100,7,>100
3816,professionals,492,25671680,94.9091469831,_100,13,>100
3817,selena,492,25672172,94.9109659252,_100,6,>100
3818,responsibility,491,25672663,94.9127811703,_100,14,>100
3819,treated,491,25673154,94.9145964154,_100,7,>100
3820,crisis,491,25673645,94.9164116605,_100,6,>100
3821,ginger,491,25674136,94.9182269056,_100,6,>100
3822,income,491,25674627,94.9200421507,_100,6,>100
3823,mcdonalds,490,25675117,94.9218536987,_100,9,>100
3824,il,490,25675607,94.9236652468,_100,2,>100
3825,particular,490,25676097,94.9254767948,_100,10,>100
3826,ale,490,25676587,94.9272883429,_100,3,>100
3827,abuse,490,25677077,94.9290998909,_100,5,>100
3828,complex,489,25677566,94.930907742,_100,7,>100
3829,reader,489,25678055,94.932715593,_100,6,>100
3830,violence,489,25678544,94.934523444,_100,8,>100
3831,rumor,489,25679033,94.936331295,_100,5,>100
3832,diff,489,25679522,94.938139146,_100,4,>100
3833,borrow,488,25680010,94.9399433,_100,6,>100
3834,tequila,488,25680498,94.941747454,_100,7,>100
3835,log,488,25680986,94.943551608,_100,3,>100
3836,healthcare,488,25681474,94.945355762,_100,10,>100
3837,soda,488,25681962,94.947159916,_100,4,>100
3838,nhl,488,25682450,94.9489640699,_100,3,>100
3839,lift,487,25682937,94.9507645269,_100,4,>100
3840,hooray,487,25683424,94.9525649838,_100,6,>100
3841,bee,487,25683911,94.9543654408,_100,3,>100
3842,topics,487,25684398,94.9561658977,_100,6,>100
3843,freshman,487,25684885,94.9579663547,_100,8,>100
3844,networks,486,25685371,94.9597631146,_100,8,>100
3845,african,486,25685857,94.9615598745,_100,7,>100
3846,ahaha,486,25686343,94.9633566344,_100,5,>100
3847,rarely,486,25686829,94.9651533943,_100,6,>100
3848,champions,486,25687315,94.9669501542,_100,9,>100
3849,opinions,485,25687800,94.9687432171,_100,8,>100
3850,misses,485,25688285,94.97053628,_100,6,>100
3851,rapper,485,25688770,94.9723293428,_100,6,>100
3852,label,485,25689255,94.9741224057,_100,5,>100
3853,polish,485,25689740,94.9759154686,_100,6,>100
3854,therefore,484,25690224,94.9777048344,_100,9,>100
3855,booty,484,25690708,94.9794942003,_100,5,>100
3856,discovery,484,25691192,94.9812835661,_100,9,>100
3857,le,484,25691676,94.9830729319,_100,2,>100
3858,precious,484,25692160,94.9848622978,_100,8,>100
3859,er,484,25692644,94.9866516636,_100,2,>100
3860,strike,484,25693128,94.9884410294,_100,6,>100
3861,offensive,483,25693611,94.9902266982,_100,9,>100
3862,anderson,483,25694094,94.992012367,_100,8,>100
3863,nicki,482,25694576,94.9937943388,_100,5,>100
3864,knocked,482,25695058,94.9955763106,_100,7,>100
3865,fights,482,25695540,94.9973582823,_100,6,>100
3866,playlist,482,25696022,94.9991402541,_100,8,>100
3867,tmrw,482,25696504,95.0009222258,_100,4,>100
3868,crappy,482,25696986,95.0027041976,_100,6,>100
3869,jet,481,25697467,95.0044824723,_100,3,>100
3870,bunny,481,25697948,95.0062607471,_100,5,>100
3871,graduating,481,25698429,95.0080390218,_100,10,>100
3872,browns,480,25698909,95.0098135995,_100,6,>100
3873,enemy,480,25699389,95.0115881772,_100,5,>100
3874,clouds,480,25699869,95.0133627548,_100,6,>100
3875,hahahahaha,480,25700349,95.0151373325,_100,10,>100
3876,dentist,479,25700828,95.0169082132,_100,7,>100
3877,wicked,479,25701307,95.0186790938,_100,6,>100
3878,dragon,478,25701785,95.0204462775,_100,6,>100
3879,accomplished,478,25702263,95.0222134611,_100,12,>100
3880,occupy,478,25702741,95.0239806447,_100,6,>100
3881,context,478,25703219,95.0257478283,_100,7,>100
3882,intro,478,25703697,95.0275150119,_100,5,>100
3883,published,478,25704175,95.0292821955,_100,9,>100
3884,jumping,477,25704652,95.0310456821,_100,7,>100
3885,fridge,477,25705129,95.0328091687,_100,6,>100
3886,roses,477,25705606,95.0345726553,_100,5,>100
3887,bra,476,25706082,95.0363324448,_100,3,>100
3888,iowa,476,25706558,95.0380922343,_100,4,>100
3889,pancakes,476,25707034,95.0398520239,_100,8,>100
3890,apt,476,25707510,95.0416118134,_100,3,>100
3891,acts,475,25707985,95.0433679059,_100,4,>100
3892,pitching,475,25708460,95.0451239984,_100,8,>100
3893,startup,475,25708935,95.0468800909,_100,7,>100
3894,convince,475,25709410,95.0486361834,_100,8,>100
3895,mate,475,25709885,95.0503922759,_100,4,>100
3896,vampire,475,25710360,95.0521483684,_100,7,>100
3897,jury,474,25710834,95.0539007639,_100,4,>100
3898,bucket,474,25711308,95.0556531594,_100,6,>100
3899,banks,474,25711782,95.0574055548,_100,5,>100
3900,shuttle,474,25712256,95.0591579503,_100,7,>100
3901,eagles,474,25712730,95.0609103458,_100,6,>100
3902,begun,473,25713203,95.0626590442,_100,5,>100
3903,require,473,25713676,95.0644077426,_100,7,>100
3904,vintage,473,25714149,95.0661564411,_100,7,>100
3905,pathetic,473,25714622,95.0679051395,_100,8,>100
3906,mouse,473,25715095,95.0696538379,_100,5,>100
3907,continued,472,25715567,95.0713988393,_100,9,>100
3908,rolls,472,25716039,95.0731438407,_100,5,>100
3909,volunteering,471,25716510,95.0748851451,_100,12,>100
3910,breast,471,25716981,95.0766264494,_100,6,>100
3911,popcorn,471,25717452,95.0783677538,_100,7,>100
3912,insight,470,25717922,95.0801053611,_100,7,>100
3913,television,470,25718392,95.0818429684,_100,10,>100
3914,secrets,470,25718862,95.0835805758,_100,7,>100
3915,pens,470,25719332,95.0853181831,_100,4,>100
3916,apologies,470,25719802,95.0870557904,_100,9,>100
3917,upper,470,25720272,95.0887933977,_100,5,>100
3918,sample,469,25720741,95.090527308,_100,6,>100
3919,weirdest,469,25721210,95.0922612183,_100,8,>100
3920,squad,469,25721679,95.0939951286,_100,5,>100
3921,ink,469,25722148,95.0957290388,_100,3,>100
3922,stressed,469,25722617,95.0974629491,_100,8,>100
3923,depressed,469,25723086,95.0991968594,_100,9,>100
3924,elite,469,25723555,95.1009307697,_100,5,>100
3925,spinning,468,25724023,95.1026609829,_100,8,>100
3926,aid,468,25724491,95.1043911962,_100,3,>100
3927,belong,468,25724959,95.1061214094,_100,6,>100
3928,hail,468,25725427,95.1078516227,_100,4,>100
3929,cbs,468,25725895,95.1095818359,_100,3,>100
3930,dunno,467,25726362,95.1113083521,_100,5,>100
3931,makin,467,25726829,95.1130348683,_100,5,>100
3932,minor,467,25727296,95.1147613846,_100,5,>100
3933,auditions,467,25727763,95.1164879008,_100,9,>100
3934,hunting,467,25728230,95.118214417,_100,7,>100
3935,ann,467,25728697,95.1199409332,_100,3,>100
3936,performances,466,25729163,95.1216637524,_100,12,>100
3937,adams,466,25729629,95.1233865715,_100,5,>100
3938,compare,466,25730095,95.1251093907,_100,7,>100
3939,cnn,466,25730561,95.1268322099,_100,3,>100
3940,connections,466,25731027,95.128555029,_100,11,>100
3941,largest,466,25731493,95.1302778482,_100,7,>100
3942,laid,465,25731958,95.1319969704,_100,4,>100
3943,shades,465,25732423,95.1337160925,_100,6,>100
3944,shipping,465,25732888,95.1354352146,_100,8,>100
3945,scale,465,25733353,95.1371543368,_100,5,>100
3946,woulda,465,25733818,95.1388734589,_100,6,>100
3947,fails,465,25734283,95.140592581,_100,5,>100
3948,rooms,465,25734748,95.1423117032,_100,5,>100
3949,function,465,25735213,95.1440308253,_100,8,>100
3950,wing,464,25735677,95.1457462504,_100,4,>100
3951,pt,464,25736141,95.1474616755,_100,2,>100
3952,ralph,464,25736605,95.1491771006,_100,5,>100
3953,mid,464,25737069,95.1508925257,_100,3,>100
3954,hows,464,25737533,95.1526079508,_100,4,>100
3955,fm,464,25737997,95.1543233759,_100,2,>100
3956,playin,464,25738461,95.156038801,_100,6,>100
3957,task,463,25738924,95.1577505291,_100,4,>100
3958,divorce,463,25739387,95.1594622571,_100,7,>100
3959,lists,463,25739850,95.1611739852,_100,5,>100
3960,supporters,463,25740313,95.1628857132,_100,10,>100
3961,collaboration,463,25740776,95.1645974413,_100,13,>100
3962,iced,463,25741239,95.1663091694,_100,4,>100
3963,braun,463,25741702,95.1680208974,_100,5,>100
3964,experienced,462,25742164,95.1697289285,_100,11,>100
3965,ninja,462,25742626,95.1714369595,_100,5,>100
3966,bones,461,25743087,95.1731412935,_100,5,>100
3967,agenda,461,25743548,95.1748456275,_100,6,>100
3968,springs,461,25744009,95.1765499614,_100,7,>100
3969,ravens,461,25744470,95.1782542954,_100,6,>100
3970,casino,461,25744931,95.1799586294,_100,6,>100
3971,proposal,460,25745391,95.1816592664,_100,8,>100
3972,rec,460,25745851,95.1833599033,_100,3,>100
3973,supports,460,25746311,95.1850605403,_100,8,>100
3974,tgif,460,25746771,95.1867611772,_100,4,>100
3975,yolo,460,25747231,95.1884618142,_100,4,>100
3976,consumer,459,25747690,95.1901587541,_100,8,>100
3977,pasta,459,25748149,95.191855694,_100,5,>100
3978,atleast,459,25748608,95.1935526339,_100,7,>100
3979,cereal,459,25749067,95.1952495738,_100,6,>100
3980,allergies,459,25749526,95.1969465137,_100,9,>100
3981,typical,459,25749985,95.1986434537,_100,7,>100
3982,tables,459,25750444,95.2003403936,_100,6,>100
3983,nw,459,25750903,95.2020373335,_100,2,>100
3984,freezing,458,25751361,95.2037305764,_100,8,>100
3985,sincerely,458,25751819,95.2054238192,_100,9,>100
3986,chatting,458,25752277,95.2071170621,_100,8,>100
3987,shown,458,25752735,95.208810305,_100,5,>100
3988,ish,457,25753192,95.2104998508,_100,3,>100
3989,doctors,457,25753649,95.2121893967,_100,7,>100
3990,routine,457,25754106,95.2138789425,_100,7,>100
3991,md,457,25754563,95.2155684884,_100,2,>100
3992,accomplish,457,25755020,95.2172580342,_100,10,>100
3993,providing,457,25755477,95.21894758,_100,9,>100
3994,nine,456,25755933,95.2206334289,_100,4,>100
3995,extreme,455,25756388,95.2223155806,_100,7,>100
3996,emily,455,25756843,95.2239977324,_100,5,>100
3997,warrior,455,25757298,95.2256798842,_100,7,>100
3998,meh,455,25757753,95.2273620359,_100,3,>100
3999,reaching,455,25758208,95.2290441877,_100,8,>100
4000,carter,455,25758663,95.2307263395,_100,6,>100
4001,readers,454,25759117,95.2324047942,_100,7,>100
4002,olive,454,25759571,95.2340832489,_100,5,>100
4003,reserve,454,25760025,95.2357617036,_100,7,>100
4004,chelsea,454,25760479,95.2374401584,_100,7,>100
4005,excuses,454,25760933,95.2391186131,_100,7,>100
4006,pit,454,25761387,95.2407970678,_100,3,>100
4007,grades,454,25761841,95.2424755226,_100,6,>100
4008,thrown,454,25762295,95.2441539773,_100,6,>100
4009,whew,454,25762749,95.245832432,_100,4,>100
4010,universal,453,25763202,95.2475071897,_100,9,>100
4011,pleased,453,25763655,95.2491819474,_100,7,>100
4012,files,453,25764108,95.2508567051,_100,5,>100
4013,lottery,453,25764561,95.2525314628,_100,7,>100
4014,yogurt,453,25765014,95.2542062205,_100,6,>100
4015,sang,453,25765467,95.2558809782,_100,4,>100
4016,dev,452,25765919,95.2575520388,_100,3,>100
4017,fortune,452,25766371,95.2592230995,_100,7,>100
4018,recipes,452,25766823,95.2608941602,_100,7,>100
4019,linkedin,452,25767275,95.2625652208,_100,8,>100
4020,returns,452,25767727,95.2642362815,_100,7,>100
4021,engaged,451,25768178,95.2659036451,_100,7,>100
4022,robin,451,25768629,95.2675710087,_100,5,>100
4023,liberty,450,25769079,95.2692346753,_100,7,>100
4024,absolute,450,25769529,95.2708983419,_100,8,>100
4025,requests,450,25769979,95.2725620085,_100,8,>100
4026,archives,450,25770429,95.274225675,_100,8,>100
4027,jumped,450,25770879,95.2758893416,_100,6,>100
4028,nephew,449,25771328,95.2775493112,_100,6,>100
4029,indian,449,25771777,95.2792092807,_100,6,>100
4030,palm,449,25772226,95.2808692503,_100,4,>100
4031,treadmill,449,25772675,95.2825292198,_100,9,>100
4032,sporting,449,25773124,95.2841891894,_100,8,>100
4033,rainbow,449,25773573,95.2858491589,_100,7,>100
4034,cases,449,25774022,95.2875091284,_100,5,>100
4035,exams,449,25774471,95.289169098,_100,5,>100
4036,russell,448,25774919,95.2908253705,_100,7,>100
4037,correctly,448,25775367,95.292481643,_100,9,>100
4038,dd,448,25775815,95.2941379155,_100,2,>100
4039,danny,448,25776263,95.295794188,_100,5,>100
4040,maryland,448,25776711,95.2974504605,_100,8,>100
4041,pen,448,25777159,95.299106733,_100,3,>100
4042,disgusting,448,25777607,95.3007630056,_100,10,>100
4043,encourage,448,25778055,95.3024192781,_100,9,>100
4044,veterans,447,25778502,95.3040718535,_100,8,>100
4045,referring,447,25778949,95.305724429,_100,9,>100
4046,tries,447,25779396,95.3073770045,_100,5,>100
4047,couldnt,447,25779843,95.30902958,_100,7,>100
4048,voices,447,25780290,95.3106821554,_100,6,>100
4049,mia,447,25780737,95.3123347309,_100,3,>100
4050,booking,447,25781184,95.3139873064,_100,7,>100
4051,select,447,25781631,95.3156398818,_100,6,>100
4052,prevent,446,25782077,95.3172887603,_100,7,>100
4053,sneak,446,25782523,95.3189376387,_100,5,>100
4054,clever,446,25782969,95.3205865172,_100,6,>100
4055,blocks,445,25783414,95.3222316985,_100,6,>100
4056,greek,445,25783859,95.3238768799,_100,5,>100
4057,escape,445,25784304,95.3255220613,_100,6,>100
4058,oklahoma,445,25784749,95.3271672427,_100,8,>100
4059,pre,445,25785194,95.3288124241,_100,3,>100
4060,sons,445,25785639,95.3304576055,_100,4,>100
4061,del,444,25786083,95.3320990899,_100,3,>100
4062,mint,444,25786527,95.3337405743,_100,4,>100
4063,timing,444,25786971,95.3353820586,_100,6,>100
4064,superbowl,444,25787415,95.337023543,_100,9,>100
4065,confusing,444,25787859,95.3386650274,_100,9,>100
4066,roger,444,25788303,95.3403065117,_100,5,>100
4067,brewing,443,25788746,95.341944299,_100,7,>100
4068,blows,443,25789189,95.3435820864,_100,5,>100
4069,storage,443,25789632,95.3452198737,_100,7,>100
4070,crossing,443,25790075,95.346857661,_100,8,>100
4071,importance,443,25790518,95.3484954483,_100,10,>100
4072,sudden,443,25790961,95.3501332357,_100,6,>100
4073,lions,443,25791404,95.351771023,_100,5,>100
4074,remembering,442,25791846,95.3534051133,_100,11,>100
4075,docs,442,25792288,95.3550392036,_100,4,>100
4076,en,442,25792730,95.3566732939,_100,2,>100
4077,gate,442,25793172,95.3583073841,_100,4,>100
4078,amazed,442,25793614,95.3599414744,_100,6,>100
4079,meets,442,25794056,95.3615755647,_100,5,>100
4080,nightmare,442,25794498,95.363209655,_100,9,>100
4081,samples,441,25794939,95.3648400483,_100,7,>100
4082,blackberry,441,25795380,95.3664704415,_100,10,>100
4083,delayed,441,25795821,95.3681008348,_100,7,>100
4084,weave,441,25796262,95.369731228,_100,5,>100
4085,imagination,441,25796703,95.3713616213,_100,11,>100
4086,geez,441,25797144,95.3729920145,_100,4,>100
4087,sponsors,441,25797585,95.3746224078,_100,8,>100
4088,odds,441,25798026,95.376252801,_100,4,>100
4089,peoples,441,25798467,95.3778831943,_100,7,>100
4090,dammit,440,25798907,95.3795098905,_100,6,>100
4091,participating,440,25799347,95.3811365867,_100,13,>100
4092,editor,440,25799787,95.3827632829,_100,6,>100
4093,smiles,440,25800227,95.3843899791,_100,6,>100
4094,worlds,439,25800666,95.3860129783,_100,6,>100
4095,smaller,439,25801105,95.3876359775,_100,7,>100
4096,diamond,439,25801544,95.3892589767,_100,7,>100
4097,ftw,438,25801982,95.3908782788,_100,3,>100
4098,dust,438,25802420,95.3924975809,_100,4,>100
4099,registered,438,25802858,95.3941168831,_100,10,>100
4100,ignorant,438,25803296,95.3957361852,_100,8,>100
4101,hd,438,25803734,95.3973554874,_100,2,>100
4102,adele,437,25804171,95.3989710925,_100,5,>100
4103,managed,437,25804608,95.4005866976,_100,7,>100
4104,jake,437,25805045,95.4022023027,_100,4,>100
4105,mercy,437,25805482,95.4038179078,_100,5,>100
4106,magical,437,25805919,95.4054335129,_100,7,>100
4107,creek,437,25806356,95.407049118,_100,5,>100
4108,reward,437,25806793,95.4086647231,_100,6,>100
4109,pete,436,25807229,95.4102766312,_100,4,>100
4110,raising,436,25807665,95.4118885392,_100,7,>100
4111,hung,436,25808101,95.4135004473,_100,4,>100
4112,shrimp,436,25808537,95.4151123554,_100,6,>100
4113,skill,436,25808973,95.4167242634,_100,5,>100
4114,mega,436,25809409,95.4183361715,_100,4,>100
4115,concerts,436,25809845,95.4199480796,_100,8,>100
4116,gum,436,25810281,95.4215599876,_100,3,>100
4117,promoting,436,25810717,95.4231718957,_100,9,>100
4118,hundred,435,25811152,95.4247801067,_100,7,>100
4119,announces,435,25811587,95.4263883177,_100,9,>100
4120,lip,435,25812022,95.4279965288,_100,3,>100
4121,soundtrack,434,25812456,95.4296010428,_100,10,>100
4122,criminal,434,25812890,95.4312055568,_100,8,>100
4123,sub,434,25813324,95.4328100708,_100,3,>100
4124,somethin,434,25813758,95.4344145848,_100,8,>100
4125,albums,433,25814191,95.4360154017,_100,6,>100
4126,halftime,433,25814624,95.4376162187,_100,8,>100
4127,temple,433,25815057,95.4392170356,_100,6,>100
4128,gmail,433,25815490,95.4408178526,_100,5,>100
4129,france,433,25815923,95.4424186695,_100,6,>100
4130,confident,433,25816356,95.4440194865,_100,9,>100
4131,worthy,433,25816789,95.4456203034,_100,6,>100
4132,downloaded,433,25817222,95.4472211204,_100,10,>100
4133,brave,433,25817655,95.4488219374,_100,5,>100
4134,answered,432,25818087,95.4504190573,_100,8,>100
4135,poop,432,25818519,95.4520161772,_100,4,>100
4136,introduce,432,25818951,95.4536132971,_100,9,>100
4137,wk,432,25819383,95.455210417,_100,2,>100
4138,knees,431,25819814,95.4568038399,_100,5,>100
4139,countries,431,25820245,95.4583972628,_100,9,>100
4140,affect,431,25820676,95.4599906857,_100,6,>100
4141,colleagues,430,25821106,95.4615804115,_100,10,>100
4142,moore,430,25821536,95.4631701374,_100,5,>100
4143,dunk,430,25821966,95.4647598632,_100,4,>100
4144,batman,430,25822396,95.4663495891,_100,6,>100
4145,relief,430,25822826,95.4679393149,_100,6,>100
4146,separate,430,25823256,95.4695290408,_100,8,>100
4147,commitment,429,25823685,95.4711150696,_100,10,>100
4148,todd,429,25824114,95.4727010984,_100,4,>100
4149,idiots,429,25824543,95.4742871272,_100,6,>100
4150,heh,429,25824972,95.475873156,_100,3,>100
4151,automatically,428,25825400,95.4774554878,_100,13,>100
4152,destroy,428,25825828,95.4790378195,_100,7,>100
4153,wealth,428,25826256,95.4806201513,_100,6,>100
4154,toe,428,25826684,95.4822024831,_100,3,>100
4155,brands,428,25827112,95.4837848149,_100,6,>100
4156,cincinnati,428,25827540,95.4853671466,_100,10,>100
4157,australia,428,25827968,95.4869494784,_100,9,>100
4158,owned,428,25828396,95.4885318102,_100,5,>100
4159,laughs,428,25828824,95.4901141419,_100,6,>100
4160,alabama,428,25829252,95.4916964737,_100,7,>100
4161,toes,428,25829680,95.4932788055,_100,4,>100
4162,latin,428,25830108,95.4948611373,_100,5,>100
4163,segment,428,25830536,95.496443469,_100,7,>100
4164,gotcha,427,25830963,95.4980221038,_100,6,>100
4165,injuries,427,25831390,95.4996007385,_100,8,>100
4166,dessert,427,25831817,95.5011793732,_100,7,>100
4167,dresses,427,25832244,95.502758008,_100,7,>100
4168,suicide,427,25832671,95.5043366427,_100,7,>100
4169,rings,426,25833097,95.5059115804,_100,5,>100
4170,lawn,426,25833523,95.5074865181,_100,4,>100
4171,handsome,426,25833949,95.5090614558,_100,8,>100
4172,informed,426,25834375,95.5106363935,_100,8,>100
4173,bash,426,25834801,95.5122113312,_100,4,>100
4174,communities,426,25835227,95.5137862689,_100,11,>100
4175,loses,426,25835653,95.5153612066,_100,5,>100
4176,boxing,426,25836079,95.5169361443,_100,6,>100
4177,trips,425,25836504,95.518507385,_100,5,>100
4178,loaded,425,25836929,95.5200786256,_100,6,>100
4179,applications,425,25837354,95.5216498663,_100,12,>100
4180,pillow,425,25837779,95.5232211069,_100,6,>100
4181,canceled,425,25838204,95.5247923476,_100,8,>100
4182,forth,425,25838629,95.5263635883,_100,5,>100
4183,seau,425,25839054,95.5279348289,_100,4,>100
4184,mon,425,25839479,95.5295060696,_100,3,>100
4185,caused,424,25839903,95.5310736132,_100,6,>100
4186,iconic,424,25840327,95.5326411568,_100,6,>100
4187,pastor,424,25840751,95.5342087005,_100,6,>100
4188,colts,424,25841175,95.5357762441,_100,5,>100
4189,craig,424,25841599,95.5373437877,_100,5,>100
4190,lover,424,25842023,95.5389113313,_100,5,>100
4191,parks,424,25842447,95.540478875,_100,5,>100
4192,traditional,424,25842871,95.5420464186,_100,11,>100
4193,mane,423,25843294,95.5436102652,_100,4,>100
4194,define,423,25843717,95.5451741118,_100,6,>100
4195,bedroom,423,25844140,95.5467379584,_100,7,>100
4196,bean,423,25844563,95.5483018049,_100,4,>100
4197,frustrating,423,25844986,95.5498656515,_100,11,>100
4198,executive,423,25845409,95.5514294981,_100,9,>100
4199,doug,423,25845832,95.5529933447,_100,4,>100
4200,returning,422,25846254,95.5545534943,_100,9,>100
4201,dishes,422,25846676,95.5561136438,_100,6,>100
4202,smash,422,25847098,95.5576737934,_100,5,>100
4203,housing,422,25847520,95.5592339429,_100,7,>100
4204,dolphins,422,25847942,95.5607940925,_100,8,>100
4205,powers,422,25848364,95.562354242,_100,6,>100
4206,tone,422,25848786,95.5639143916,_100,4,>100
4207,motivated,422,25849208,95.5654745411,_100,9,>100
4208,wears,422,25849630,95.5670346907,_100,5,>100
4209,crib,422,25850052,95.5685948402,_100,4,>100
4210,forest,422,25850474,95.5701549898,_100,6,>100
4211,messing,422,25850896,95.5717151393,_100,7,>100
4212,effects,421,25851317,95.5732715918,_100,7,>100
4213,heights,421,25851738,95.5748280443,_100,7,>100
4214,majority,421,25852159,95.5763844969,_100,8,>100
4215,historical,421,25852580,95.5779409494,_100,10,>100
4216,addiction,421,25853001,95.5794974019,_100,9,>100
4217,clinic,421,25853422,95.5810538544,_100,6,>100
4218,workin,421,25853843,95.5826103069,_100,6,>100
4219,pirates,421,25854264,95.5841667594,_100,7,>100
4220,membership,421,25854685,95.5857232119,_100,10,>100
4221,ff,420,25855105,95.5872759674,_100,2,>100
4222,sup,420,25855525,95.5888287229,_100,3,>100
4223,420,420,25855945,95.5903814784,_100,3,>100
4224,mtv,420,25856365,95.5919342339,_100,3,>100
4225,rookie,420,25856785,95.5934869893,_100,6,>100
4226,listed,420,25857205,95.5950397448,_100,6,>100
4227,adventures,419,25857624,95.5965888033,_100,10,>100
4228,se,419,25858043,95.5981378617,_100,2,>100
4229,cheering,419,25858462,95.5996869201,_100,8,>100
4230,rumors,419,25858881,95.6012359786,_100,6,>100
4231,japanese,419,25859300,95.602785037,_100,8,>100
4232,luke,419,25859719,95.6043340955,_100,4,>100
4233,streak,419,25860138,95.6058831539,_100,6,>100
4234,essential,419,25860557,95.6074322123,_100,9,>100
4235,foreign,418,25860975,95.6089775737,_100,7,>100
4236,geek,418,25861393,95.6105229351,_100,4,>100
4237,royal,418,25861811,95.6120682965,_100,5,>100
4238,vanilla,418,25862229,95.6136136579,_100,7,>100
4239,blogging,418,25862647,95.6151590194,_100,8,>100
4240,crystal,418,25863065,95.6167043808,_100,7,>100
4241,suite,417,25863482,95.6182460451,_100,5,>100
4242,athletes,417,25863899,95.6197877095,_100,8,>100
4243,waited,417,25864316,95.6213293739,_100,6,>100
4244,backwards,417,25864733,95.6228710382,_100,9,>100
4245,visited,417,25865150,95.6244127026,_100,7,>100
4246,bff,417,25865567,95.625954367,_100,3,>100
4247,reported,417,25865984,95.6274960313,_100,8,>100
4248,scare,417,25866401,95.6290376957,_100,5,>100
4249,zombies,417,25866818,95.6305793601,_100,7,>100
4250,developing,417,25867235,95.6321210244,_100,10,>100
4251,trainer,417,25867652,95.6336626888,_100,7,>100
4252,reads,416,25868068,95.6352006561,_100,5,>100
4253,entirely,416,25868484,95.6367386235,_100,8,>100
4254,lemonade,416,25868900,95.6382765908,_100,8,>100
4255,pilot,416,25869316,95.6398145581,_100,5,>100
4256,potatoes,416,25869732,95.6413525254,_100,8,>100
4257,eats,416,25870148,95.6428904928,_100,4,>100
4258,loyal,416,25870564,95.6444284601,_100,5,>100
4259,mn,415,25870979,95.6459627304,_100,2,>100
4260,roommate,415,25871394,95.6474970007,_100,8,>100
4261,investment,415,25871809,95.649031271,_100,10,>100
4262,keith,415,25872224,95.6505655413,_100,5,>100
4263,sand,415,25872639,95.6520998116,_100,4,>100
4264,pats,414,25873053,95.6536303848,_100,4,>100
4265,einstein,414,25873467,95.6551609581,_100,8,>100
4266,purchased,414,25873881,95.6566915313,_100,9,>100
4267,italy,414,25874295,95.6582221046,_100,5,>100
4268,stairs,414,25874709,95.6597526778,_100,6,>100
4269,con,414,25875123,95.6612832511,_100,3,>100
4270,sour,414,25875537,95.6628138244,_100,4,>100
4271,plug,413,25875950,95.6643407006,_100,4,>100
4272,donald,413,25876363,95.6658675768,_100,6,>100
4273,remix,412,25876775,95.667390756,_100,5,>100
4274,susan,412,25877187,95.6689139352,_100,5,>100
4275,constant,412,25877599,95.6704371143,_100,8,>100
4276,computers,412,25878011,95.6719602935,_100,9,>100
4277,humans,412,25878423,95.6734834727,_100,6,>100
4278,aside,412,25878835,95.6750066519,_100,5,>100
4279,crown,411,25879246,95.676526134,_100,5,>100
4280,copies,411,25879657,95.6780456162,_100,6,>100
4281,invest,411,25880068,95.6795650983,_100,6,>100
4282,employee,411,25880479,95.6810845805,_100,8,>100
4283,shark,411,25880890,95.6826040626,_100,5,>100
4284,bb,411,25881301,95.6841235448,_100,2,>100
4285,coconut,411,25881712,95.6856430269,_100,7,>100
4286,warped,411,25882123,95.6871625091,_100,6,>100
4287,cuddle,411,25882534,95.6886819912,_100,6,>100
4288,roots,411,25882945,95.6902014734,_100,5,>100
4289,wut,411,25883356,95.6917209555,_100,3,>100
4290,limits,410,25883766,95.6932367406,_100,6,>100
4291,bake,410,25884176,95.6947525257,_100,4,>100
4292,spa,410,25884586,95.6962683108,_100,3,>100
4293,vitamin,410,25884996,95.6977840959,_100,7,>100
4294,replied,409,25885405,95.699296184,_100,7,>100
4295,cupcake,409,25885814,95.7008082721,_100,7,>100
4296,wisely,409,25886223,95.7023203601,_100,6,>100
4297,believes,409,25886632,95.7038324482,_100,8,>100
4298,correction,408,25887040,95.7053408393,_100,10,>100
4299,illinois,408,25887448,95.7068492303,_100,8,>100
4300,lighting,408,25887856,95.7083576213,_100,8,>100
4301,returned,408,25888264,95.7098660124,_100,8,>100
4302,waist,408,25888672,95.7113744034,_100,5,>100
4303,devices,408,25889080,95.7128827944,_100,7,>100
4304,greatly,408,25889488,95.7143911855,_100,7,>100
4305,stare,407,25889895,95.7158958795,_100,5,>100
4306,shaking,407,25890302,95.7174005735,_100,7,>100
4307,thang,407,25890709,95.7189052675,_100,5,>100
4308,liquor,407,25891116,95.7204099615,_100,6,>100
4309,flies,407,25891523,95.7219146555,_100,5,>100
4310,sweep,407,25891930,95.7234193495,_100,5,>100
4311,breathing,407,25892337,95.7249240435,_100,9,>100
4312,mighty,407,25892744,95.7264287375,_100,6,>100
4313,monthly,406,25893150,95.7279297344,_100,7,>100
4314,fits,406,25893556,95.7294307314,_100,4,>100
4315,mario,406,25893962,95.7309317283,_100,5,>100
4316,sake,406,25894368,95.7324327253,_100,4,>100
4317,shy,405,25894773,95.7339300252,_100,3,>100
4318,advanced,405,25895178,95.7354273251,_100,8,>100
4319,flag,405,25895583,95.7369246251,_100,4,>100
4320,india,404,25895987,95.738418228,_100,5,>100
4321,format,404,25896391,95.7399118308,_100,6,>100
4322,thin,404,25896795,95.7414054337,_100,4,>100
4323,lauren,404,25897199,95.7428990366,_100,6,>100
4324,eddie,404,25897603,95.7443926395,_100,5,>100
4325,trends,404,25898007,95.7458862424,_100,6,>100
4326,submitted,404,25898411,95.7473798453,_100,9,>100
4327,sticks,404,25898815,95.7488734482,_100,6,>100
4328,republicans,404,25899219,95.7503670511,_100,11,>100
4329,allowing,404,25899623,95.7518606539,_100,8,>100
4330,thousands,404,25900027,95.7533542568,_100,9,>100
4331,hometown,404,25900431,95.7548478597,_100,8,>100
4332,thts,403,25900834,95.7563377656,_100,4,>100
4333,mill,403,25901237,95.7578276714,_100,4,>100
4334,opera,403,25901640,95.7593175773,_100,5,>100
4335,coat,403,25902043,95.7608074831,_100,4,>100
4336,stfu,403,25902446,95.762297389,_100,4,>100
4337,monica,403,25902849,95.7637872948,_100,6,>100
4338,meals,403,25903252,95.7652772007,_100,5,>100
4339,bracket,403,25903655,95.7667671065,_100,7,>100
4340,ashamed,402,25904057,95.7682533153,_100,7,>100
4341,values,402,25904459,95.7697395242,_100,6,>100
4342,guarantee,402,25904861,95.771225733,_100,9,>100
4343,sandwiches,402,25905263,95.7727119418,_100,10,>100
4344,scoring,402,25905665,95.7741981506,_100,7,>100
4345,understood,401,25906066,95.7756806624,_100,10,>100
4346,forms,401,25906467,95.7771631742,_100,5,>100
4347,jamie,401,25906868,95.7786456859,_100,5,>100
4348,ankle,401,25907269,95.7801281977,_100,5,>100
4349,basis,401,25907670,95.7816107095,_100,5,>100
4350,prolly,401,25908071,95.7830932213,_100,6,>100
4351,touched,400,25908471,95.784572036,_100,7,>100
4352,tattoos,400,25908871,95.7860508507,_100,7,>100
4353,rad,400,25909271,95.7875296655,_100,3,>100
4354,400,400,25909671,95.7890084802,_100,3,>100
4355,suspect,400,25910071,95.790487295,_100,7,>100
4356,ceremony,399,25910470,95.7919624127,_100,8,>100
4357,stealing,399,25910869,95.7934375304,_100,8,>100
4358,underway,399,25911268,95.7949126481,_100,8,>100
4359,dvr,399,25911667,95.7963877658,_100,3,>100
4360,twilight,399,25912066,95.7978628835,_100,8,>100
4361,floyd,399,25912465,95.7993380012,_100,5,>100
4362,suspended,399,25912864,95.8008131189,_100,9,>100
4363,lightning,399,25913263,95.8022882366,_100,9,>100
4364,buck,398,25913661,95.8037596573,_100,4,>100
4365,burns,398,25914059,95.8052310779,_100,5,>100
4366,anthem,398,25914457,95.8067024986,_100,6,>100
4367,cinnamon,398,25914855,95.8081739193,_100,8,>100
4368,engage,398,25915253,95.8096453399,_100,6,>100
4369,practices,398,25915651,95.8111167606,_100,9,>100
4370,mavs,397,25916048,95.8125844842,_100,4,>100
4371,touchdown,397,25916445,95.8140522079,_100,9,>100
4372,chipotle,397,25916842,95.8155199315,_100,8,>100
4373,branch,397,25917239,95.8169876551,_100,6,>100
4374,keyboard,397,25917636,95.8184553787,_100,8,>100
4375,chrome,397,25918033,95.8199231024,_100,6,>100
4376,matthew,397,25918430,95.821390826,_100,7,>100
4377,oz,397,25918827,95.8228585496,_100,2,>100
4378,capitol,396,25919223,95.8243225762,_100,7,>100
4379,compete,396,25919619,95.8257866028,_100,7,>100
4380,promised,396,25920015,95.8272506294,_100,8,>100
4381,realizing,396,25920411,95.828714656,_100,9,>100
4382,useless,396,25920807,95.8301786826,_100,7,>100
4383,alike,396,25921203,95.8316427092,_100,5,>100
4384,properly,396,25921599,95.8331067358,_100,8,>100
4385,collins,396,25921995,95.8345707624,_100,7,>100
4386,presentations,396,25922391,95.836034789,_100,13,>100
4387,clip,396,25922787,95.8374988156,_100,4,>100
4388,http,396,25923183,95.8389628422,_100,4,>100
4389,steven,396,25923579,95.8404268687,_100,6,>100
4390,baking,395,25923974,95.8418871983,_100,6,>100
4391,accepting,395,25924369,95.8433475279,_100,9,>100
4392,carrying,395,25924764,95.8448078574,_100,8,>100
4393,shining,395,25925159,95.846268187,_100,7,>100
4394,voters,395,25925554,95.8477285165,_100,6,>100
4395,whom,395,25925949,95.8491888461,_100,4,>100
4396,elevator,395,25926344,95.8506491756,_100,8,>100
4397,refreshing,395,25926739,95.8521095052,_100,10,>100
4398,caffeine,394,25927133,95.8535661377,_100,8,>100
4399,claims,394,25927527,95.8550227702,_100,6,>100
4400,thick,394,25927921,95.8564794028,_100,5,>100
4401,castle,394,25928315,95.8579360353,_100,6,>100
4402,retweeted,394,25928709,95.8593926678,_100,9,>100
4403,arent,394,25929103,95.8608493003,_100,5,>100
4404,inc,394,25929497,95.8623059328,_100,3,>100
4405,began,394,25929891,95.8637625654,_100,5,>100
4406,profit,394,25930285,95.8652191979,_100,6,>100
4407,ghetto,394,25930679,95.8666758304,_100,6,>100
4408,styles,394,25931073,95.8681324629,_100,6,>100
4409,trucks,393,25931466,95.8695853984,_100,6,>100
4410,snacks,393,25931859,95.8710383339,_100,6,>100
4411,kindness,393,25932252,95.8724912694,_100,8,>100
4412,glorious,393,25932645,95.8739442048,_100,8,>100
4413,url,393,25933038,95.8753971403,_100,3,>100
4414,randy,393,25933431,95.8768500758,_100,5,>100
4415,plain,393,25933824,95.8783030113,_100,5,>100
4416,dish,393,25934217,95.8797559468,_100,4,>100
4417,username,393,25934610,95.8812088822,_100,8,>100
4418,richmond,393,25935003,95.8826618177,_100,8,>100
4419,reduce,393,25935396,95.8841147532,_100,6,>100
4420,cleaned,392,25935788,95.8855639917,_100,7,>100
4421,paradise,392,25936180,95.8870132301,_100,8,>100
4422,cheat,392,25936572,95.8884624686,_100,5,>100
4423,niece,392,25936964,95.889911707,_100,5,>100
4424,donna,392,25937356,95.8913609454,_100,5,>100
4425,spotted,392,25937748,95.8928101839,_100,7,>100
4426,mahone,392,25938140,95.8942594223,_100,6,>100
4427,struggling,391,25938531,95.8957049637,_100,10,>100
4428,whoop,391,25938922,95.8971505052,_100,5,>100
4429,navy,391,25939313,95.8985960466,_100,4,>100
4430,fridays,391,25939704,95.900041588,_100,7,>100
4431,bubble,391,25940095,95.9014871294,_100,6,>100
4432,jane,391,25940486,95.9029326708,_100,4,>100
4433,tracking,391,25940877,95.9043782122,_100,8,>100
4434,fry,391,25941268,95.9058237536,_100,3,>100
4435,joseph,391,25941659,95.907269295,_100,6,>100
4436,causes,390,25942049,95.9087111394,_100,6,>100
4437,replay,390,25942439,95.9101529838,_100,6,>100
4438,opener,390,25942829,95.9115948281,_100,6,>100
4439,elementary,390,25943219,95.9130366725,_100,10,>100
4440,alternative,390,25943609,95.9144785169,_100,11,>100
4441,dads,390,25943999,95.9159203612,_100,4,>100
4442,frustrated,390,25944389,95.9173622056,_100,10,>100
4443,shock,389,25944778,95.9188003529,_100,5,>100
4444,patty,389,25945167,95.9202385003,_100,5,>100
4445,excellence,389,25945556,95.9216766476,_100,10,>100
4446,carl,389,25945945,95.923114795,_100,4,>100
4447,cheating,389,25946334,95.9245529423,_100,8,>100
4448,fee,389,25946723,95.9259910896,_100,3,>100
4449,photographer,389,25947112,95.927429237,_100,12,>100
4450,gearing,389,25947501,95.9288673843,_100,7,>100
4451,laura,388,25947889,95.9303018346,_100,5,>100
4452,possibility,388,25948277,95.9317362849,_100,11,>100
4453,harris,388,25948665,95.9331707352,_100,6,>100
4454,launched,388,25949053,95.9346051855,_100,8,>100
4455,handed,388,25949441,95.9360396358,_100,6,>100
4456,ikr,388,25949829,95.9374740861,_100,3,>100
4457,posters,388,25950217,95.9389085364,_100,7,>100
4458,carlos,387,25950604,95.9403392896,_100,6,>100
4459,joking,387,25950991,95.9417700429,_100,6,>100
4460,emerson,386,25951377,95.9431970991,_100,7,>100
4461,anne,386,25951763,95.9446241554,_100,4,>100
4462,jamming,386,25952149,95.9460512116,_100,7,>100
4463,ashley,386,25952535,95.9474782678,_100,6,>100
4464,lean,385,25952920,95.948901627,_100,4,>100
4465,lawyer,384,25953304,95.9503212891,_100,6,>100
4466,lax,384,25953688,95.9517409513,_100,3,>100
4467,toys,384,25954072,95.9531606134,_100,4,>100
4468,blank,384,25954456,95.9545802756,_100,5,>100
4469,chasing,384,25954840,95.9559999377,_100,7,>100
4470,jewish,384,25955224,95.9574195999,_100,6,>100
4471,bugs,383,25955607,95.958835565,_100,4,>100
4472,diversity,383,25955990,95.9602515301,_100,9,>100
4473,disaster,383,25956373,95.9616674952,_100,8,>100
4474,onion,383,25956756,95.9630834603,_100,5,>100
4475,programming,383,25957139,95.9644994255,_100,11,>100
4476,kay,383,25957522,95.9659153906,_100,3,>100
4477,combination,383,25957905,95.9673313557,_100,11,>100
4478,revenge,383,25958288,95.9687473208,_100,7,>100
4479,psyched,382,25958670,95.9701595889,_100,7,>100
4480,mtg,382,25959052,95.971571857,_100,3,>100
4481,rewards,382,25959434,95.972984125,_100,7,>100
4482,footage,382,25959816,95.9743963931,_100,7,>100
4483,strangers,382,25960198,95.9758086612,_100,9,>100
4484,flights,382,25960580,95.9772209293,_100,7,>100
4485,tripped,382,25960962,95.9786331973,_100,7,>100
4486,developer,382,25961344,95.9800454654,_100,9,>100
4487,brotha,382,25961726,95.9814577335,_100,6,>100
4488,provides,382,25962108,95.9828700016,_100,8,>100
4489,answering,381,25962489,95.9842785726,_100,9,>100
4490,retweets,381,25962870,95.9856871437,_100,8,>100
4491,generally,381,25963251,95.9870957147,_100,9,>100
4492,pouring,381,25963632,95.9885042857,_100,7,>100
4493,luckily,381,25964013,95.9899128568,_100,7,>100
4494,inspirational,381,25964394,95.9913214278,_100,13,>100
4495,folk,381,25964775,95.9927299989,_100,4,>100
4496,bump,381,25965156,95.9941385699,_100,4,>100
4497,bball,380,25965536,95.9955434439,_100,5,>100
4498,knight,380,25965916,95.9969483179,_100,6,>100
4499,supply,380,25966296,95.9983531919,_100,6,>100
4500,charged,380,25966676,95.9997580659,_100,7,>100
4501,quiz,380,25967056,96.0011629399,_100,4,>100
4502,presidential,380,25967436,96.0025678139,_100,12,>100
4503,pushed,379,25967815,96.0039689909,_100,6,>100
4504,mayweather,379,25968194,96.0053701678,_100,10,>100
4505,rondo,379,25968573,96.0067713448,_100,5,>100
4506,crab,379,25968952,96.0081725218,_100,4,>100
4507,bond,379,25969331,96.0095736987,_100,4,>100
4508,protest,379,25969710,96.0109748757,_100,7,>100
4509,dressing,378,25970088,96.0123723556,_100,8,>100
4510,spelling,378,25970466,96.0137698356,_100,8,>100
4511,vehicle,378,25970844,96.0151673155,_100,7,>100
4512,nerves,378,25971222,96.0165647954,_100,6,>100
4513,lin,378,25971600,96.0179622754,_100,3,>100
4514,belated,378,25971978,96.0193597553,_100,7,>100
4515,humble,378,25972356,96.0207572352,_100,6,>100
4516,attendees,378,25972734,96.0221547152,_100,9,>100
4517,cough,377,25973111,96.023548498,_100,5,>100
4518,autism,377,25973488,96.0249422809,_100,6,>100
4519,empire,377,25973865,96.0263360638,_100,6,>100
4520,suffer,377,25974242,96.0277298467,_100,6,>100
4521,offices,377,25974619,96.0291236296,_100,7,>100
4522,unlimited,377,25974996,96.0305174125,_100,9,>100
4523,goat,377,25975373,96.0319111954,_100,4,>100
4524,governor,377,25975750,96.0333049783,_100,8,>100
4525,roasted,377,25976127,96.0346987612,_100,7,>100
4526,indianapolis,376,25976503,96.036088847,_100,12,>100
4527,hidden,376,25976879,96.0374789329,_100,6,>100
4528,thinkin,376,25977255,96.0388690188,_100,7,>100
4529,retarded,376,25977631,96.0402591046,_100,8,>100
4530,technical,376,25978007,96.0416491905,_100,9,>100
4531,emailed,376,25978383,96.0430392763,_100,7,>100
4532,hurricane,376,25978759,96.0444293622,_100,9,>100
4533,wallet,376,25979135,96.045819448,_100,6,>100
4534,receiving,376,25979511,96.0472095339,_100,9,>100
4535,cutie,375,25979886,96.0485959227,_100,5,>100
4536,kenny,375,25980261,96.0499823115,_100,5,>100
4537,showers,375,25980636,96.0513687003,_100,7,>100
4538,rsvp,375,25981011,96.0527550892,_100,4,>100
4539,lmaoo,375,25981386,96.054141478,_100,5,>100
4540,chosen,375,25981761,96.0555278668,_100,6,>100
4541,ac,375,25982136,96.0569142556,_100,2,>100
4542,recommended,375,25982511,96.0583006444,_100,11,>100
4543,reporter,375,25982886,96.0596870333,_100,8,>100
4544,douche,374,25983260,96.061069725,_100,6,>100
4545,wrapping,374,25983634,96.0624524168,_100,8,>100
4546,uw,374,25984008,96.0638351086,_100,2,>100
4547,destination,374,25984382,96.0652178004,_100,11,>100
4548,lied,374,25984756,96.0666004922,_100,4,>100
4549,clutch,374,25985130,96.067983184,_100,6,>100
4550,cus,374,25985504,96.0693658757,_100,3,>100
4551,normally,374,25985878,96.0707485675,_100,8,>100
4552,jelly,374,25986252,96.0721312593,_100,5,>100
4553,romance,373,25986625,96.073510254,_100,7,>100
4554,promises,373,25986998,96.0748892488,_100,8,>100
4555,relate,373,25987371,96.0762682435,_100,6,>100
4556,trigger,373,25987744,96.0776472383,_100,7,>100
4557,alley,373,25988117,96.079026233,_100,5,>100
4558,burrito,373,25988490,96.0804052278,_100,7,>100
4559,tower,372,25988862,96.0817805255,_100,5,>100
4560,innings,372,25989234,96.0831558232,_100,7,>100
4561,germany,372,25989606,96.0845311209,_100,7,>100
4562,highlights,372,25989978,96.0859064186,_100,10,>100
4563,sharp,372,25990350,96.0872817163,_100,5,>100
4564,ducks,372,25990722,96.088657014,_100,5,>100
4565,remains,372,25991094,96.0900323117,_100,7,>100
4566,spoken,372,25991466,96.0914076094,_100,6,>100
4567,extended,372,25991838,96.0927829071,_100,8,>100
4568,maria,372,25992210,96.0941582049,_100,5,>100
4569,jean,372,25992582,96.0955335026,_100,4,>100
4570,goodmorning,371,25992953,96.0969051032,_100,11,>100
4571,donations,371,25993324,96.0982767039,_100,9,>100
4572,situations,371,25993695,96.0996483046,_100,10,>100
4573,launching,371,25994066,96.1010199053,_100,9,>100
4574,determined,371,25994437,96.1023915059,_100,10,>100
4575,manhattan,371,25994808,96.1037631066,_100,9,>100
4576,exists,371,25995179,96.1051347073,_100,6,>100
4577,hater,370,25995549,96.1065026109,_100,5,>100
4578,dean,370,25995919,96.1078705145,_100,4,>100
4579,heroes,370,25996289,96.1092384182,_100,6,>100
4580,cents,370,25996659,96.1106063218,_100,5,>100
4581,waldo,369,25997028,96.1119705284,_100,5,>100
4582,bella,369,25997397,96.113334735,_100,5,>100
4583,laker,369,25997766,96.1146989416,_100,5,>100
4584,aim,369,25998135,96.1160631482,_100,3,>100
4585,penny,369,25998504,96.1174273548,_100,5,>100
4586,holes,369,25998873,96.1187915614,_100,5,>100
4587,replaced,368,25999241,96.120152071,_100,8,>100
4588,derek,368,25999609,96.1215125805,_100,5,>100
4589,internship,368,25999977,96.1228730901,_100,10,>100
4590,liam,368,26000345,96.1242335996,_100,4,>100
4591,sweater,368,26000713,96.1255941092,_100,7,>100
4592,kennedy,368,26001081,96.1269546188,_100,7,>100
4593,wealthy,367,26001448,96.1283114313,_100,7,>100
4594,materials,367,26001815,96.1296682438,_100,9,>100
4595,unlike,367,26002182,96.1310250563,_100,6,>100
4596,sundays,367,26002549,96.1323818689,_100,7,>100
4597,spelled,367,26002916,96.1337386814,_100,7,>100
4598,trading,366,26003282,96.1350917969,_100,7,>100
4599,madonna,366,26003648,96.1364449124,_100,7,>100
4600,refer,366,26004014,96.1377980278,_100,5,>100
4601,seo,366,26004380,96.1391511433,_100,3,>100
4602,urge,366,26004746,96.1405042588,_100,4,>100
4603,snl,366,26005112,96.1418573743,_100,3,>100
4604,variety,366,26005478,96.1432104898,_100,7,>100
4605,wines,366,26005844,96.1445636053,_100,5,>100
4606,flu,366,26006210,96.1459167208,_100,3,>100
4607,eli,365,26006575,96.1472661392,_100,3,>100
4608,365,365,26006940,96.1486155577,_100,3,>100
4609,intern,365,26007305,96.1499649761,_100,6,>100
4610,whos,365,26007670,96.1513143946,_100,4,>100
4611,snowing,365,26008035,96.152663813,_100,7,>100
4612,admin,364,26008399,96.1540095344,_100,5,>100
4613,selected,364,26008763,96.1553552558,_100,8,>100
4614,loan,364,26009127,96.1567009773,_100,4,>100
4615,amendment,364,26009491,96.1580466987,_100,9,>100
4616,fishing,364,26009855,96.1593924201,_100,7,>100
4617,spray,364,26010219,96.1607381415,_100,5,>100
4618,jefferson,364,26010583,96.1620838629,_100,9,>100
4619,parker,364,26010947,96.1634295843,_100,6,>100
4620,commission,364,26011311,96.1647753057,_100,10,>100
4621,courses,364,26011675,96.1661210272,_100,7,>100
4622,patients,364,26012039,96.1674667486,_100,8,>100
4623,happiest,363,26012402,96.168808773,_100,8,>100
4624,strikes,363,26012765,96.1701507973,_100,7,>100
4625,fuel,363,26013128,96.1714928217,_100,4,>100
4626,citizen,363,26013491,96.1728348461,_100,7,>100
4627,galaxy,363,26013854,96.1741768705,_100,6,>100
4628,devils,362,26014216,96.1755151978,_100,6,>100
4629,region,362,26014578,96.1768535251,_100,6,>100
4630,pg,362,26014940,96.1781918525,_100,2,>100
4631,fireworks,362,26015302,96.1795301798,_100,9,>100
4632,designers,362,26015664,96.1808685072,_100,9,>100
4633,starving,361,26016025,96.1822031375,_100,8,>100
4634,vancouver,361,26016386,96.1835377678,_100,9,>100
4635,clubs,361,26016747,96.1848723981,_100,5,>100
4636,hw,361,26017108,96.1862070284,_100,2,>100
4637,archive,361,26017469,96.1875416587,_100,7,>100
4638,microsoft,361,26017830,96.188876289,_100,9,>100
4639,ustream,361,26018191,96.1902109193,_100,7,>100
4640,margarita,361,26018552,96.1915455496,_100,9,>100
4641,enemies,361,26018913,96.1928801799,_100,7,>100
4642,acceptable,360,26019273,96.1942111132,_100,10,>100
4643,360,360,26019633,96.1955420464,_100,3,>100
4644,gen,360,26019993,96.1968729797,_100,3,>100
4645,debating,360,26020353,96.198203913,_100,8,>100
4646,releases,360,26020713,96.1995348462,_100,8,>100
4647,muscle,360,26021073,96.2008657795,_100,6,>100
4648,supported,360,26021433,96.2021967128,_100,9,>100
4649,dining,360,26021793,96.203527646,_100,6,>100
4650,pickup,360,26022153,96.2048585793,_100,6,>100
4651,ky,360,26022513,96.2061895125,_100,2,>100
4652,megan,360,26022873,96.2075204458,_100,5,>100
4653,inches,360,26023233,96.2088513791,_100,6,>100
4654,seeds,360,26023593,96.2101823123,_100,5,>100
4655,nate,360,26023953,96.2115132456,_100,4,>100
4656,religious,360,26024313,96.2128441789,_100,9,>100
4657,sings,360,26024673,96.2141751121,_100,5,>100
4658,houses,360,26025033,96.2155060454,_100,6,>100
4659,confirm,359,26025392,96.2168332816,_100,7,>100
4660,organizing,359,26025751,96.2181605179,_100,10,>100
4661,obsession,359,26026110,96.2194877541,_100,9,>100
4662,minneapolis,359,26026469,96.2208149903,_100,11,>100
4663,category,359,26026828,96.2221422266,_100,8,>100
4664,canadian,359,26027187,96.2234694628,_100,8,>100
4665,historic,359,26027546,96.224796699,_100,8,>100
4666,attorney,359,26027905,96.2261239352,_100,8,>100
4667,joel,359,26028264,96.2274511715,_100,4,>100
4668,oak,358,26028622,96.2287747107,_100,3,>100
4669,injured,358,26028980,96.2300982499,_100,7,>100
4670,fred,358,26029338,96.2314217891,_100,4,>100
4671,resist,358,26029696,96.2327453282,_100,6,>100
4672,bitter,358,26030054,96.2340688674,_100,6,>100
4673,produced,358,26030412,96.2353924066,_100,8,>100
4674,creates,358,26030770,96.2367159458,_100,7,>100
4675,actress,358,26031128,96.238039485,_100,7,>100
4676,granted,358,26031486,96.2393630242,_100,7,>100
4677,zimmerman,358,26031844,96.2406865634,_100,9,>100
4678,darling,357,26032201,96.2420064056,_100,7,>100
4679,equipment,357,26032558,96.2433262477,_100,9,>100
4680,todays,357,26032915,96.2446460899,_100,6,>100
4681,pdx,357,26033272,96.245965932,_100,3,>100
4682,decade,357,26033629,96.2472857742,_100,6,>100
4683,sweetest,357,26033986,96.2486056163,_100,8,>100
4684,privacy,357,26034343,96.2499254585,_100,7,>100
4685,dancers,357,26034700,96.2512453007,_100,7,>100
4686,museums,357,26035057,96.2525651428,_100,7,>100
4687,gala,357,26035414,96.253884985,_100,4,>100
4688,concern,357,26035771,96.2552048271,_100,7,>100
4689,tf,357,26036128,96.2565246693,_100,2,>100
4690,td,356,26036484,96.2578408144,_100,2,>100
4691,hired,356,26036840,96.2591569595,_100,5,>100
4692,northern,356,26037196,96.2604731046,_100,8,>100
4693,impression,356,26037552,96.2617892497,_100,10,>100
4694,uncomfortable,356,26037908,96.2631053949,_100,13,>100
4695,removed,356,26038264,96.26442154,_100,7,>100
4696,alan,356,26038620,96.2657376851,_100,4,>100
4697,stolen,355,26038975,96.2670501332,_100,6,>100
4698,na,355,26039330,96.2683625813,_100,2,>100
4699,attendance,355,26039685,96.2696750294,_100,10,>100
4700,pitcher,355,26040040,96.2709874774,_100,7,>100
4701,somewhat,355,26040395,96.2722999255,_100,8,>100
4702,unreal,355,26040750,96.2736123736,_100,6,>100
4703,nonsense,355,26041105,96.2749248217,_100,8,>100
4704,champs,354,26041459,96.2762335727,_100,6,>100
4705,regional,354,26041813,96.2775423238,_100,8,>100
4706,gossip,354,26042167,96.2788510748,_100,6,>100
4707,tn,354,26042521,96.2801598259,_100,2,>100
4708,dirt,354,26042875,96.2814685769,_100,4,>100
4709,tradition,354,26043229,96.282777328,_100,9,>100
4710,likewise,354,26043583,96.284086079,_100,8,>100
4711,accurate,354,26043937,96.28539483,_100,8,>100
4712,aug,354,26044291,96.2867035811,_100,3,>100
4713,eight,354,26044645,96.2880123321,_100,5,>100
4714,laughter,354,26044999,96.2893210832,_100,8,>100
4715,virgin,354,26045353,96.2906298342,_100,6,>100
4716,couples,354,26045707,96.2919385853,_100,7,>100
4717,commute,354,26046061,96.2932473363,_100,7,>100
4718,awesomeness,353,26046414,96.2945523903,_100,11,>100
4719,simon,353,26046767,96.2958574443,_100,5,>100
4720,dh,353,26047120,96.2971624983,_100,2,>100
4721,pan,353,26047473,96.2984675523,_100,3,>100
4722,bakery,353,26047826,96.2997726064,_100,6,>100
4723,nevermind,352,26048178,96.3010739633,_100,9,>100
4724,backup,352,26048530,96.3023753203,_100,6,>100
4725,smarter,352,26048882,96.3036766773,_100,7,>100
4726,forgetting,352,26049234,96.3049780342,_100,10,>100
4727,positions,352,26049586,96.3062793912,_100,9,>100
4728,practicing,351,26049937,96.3075770511,_100,10,>100
4729,columbia,351,26050288,96.3088747111,_100,8,>100
4730,premier,351,26050639,96.310172371,_100,7,>100
4731,wives,351,26050990,96.311470031,_100,5,>100
4732,midwest,351,26051341,96.3127676909,_100,7,>100
4733,casey,351,26051692,96.3140653508,_100,5,>100
4734,comp,351,26052043,96.3153630108,_100,4,>100
4735,cups,351,26052394,96.3166606707,_100,4,>100
4736,explode,351,26052745,96.3179583306,_100,7,>100
4737,possibilities,351,26053096,96.3192559906,_100,13,>100
4738,greatness,350,26053446,96.3205499535,_100,9,>100
4739,hash,350,26053796,96.3218439164,_100,4,>100
4740,wire,350,26054146,96.3231378793,_100,4,>100
4741,yuck,350,26054496,96.3244318421,_100,4,>100
4742,hangout,350,26054846,96.325725805,_100,7,>100
4743,overheard,350,26055196,96.3270197679,_100,9,>100
4744,donated,350,26055546,96.3283137308,_100,7,>100
4745,retweeting,350,26055896,96.3296076937,_100,10,>100
4746,lolz,350,26056246,96.3309016566,_100,4,>100
4747,stunning,350,26056596,96.3321956195,_100,8,>100
4748,combined,350,26056946,96.3334895824,_100,8,>100
4749,yal,349,26057295,96.3347798483,_100,3,>100
4750,various,349,26057644,96.3360701142,_100,7,>100
4751,israel,349,26057993,96.33736038,_100,6,>100
4752,tribe,349,26058342,96.3386506459,_100,5,>100
4753,bow,349,26058691,96.3399409117,_100,3,>100
4754,booze,349,26059040,96.3412311776,_100,5,>100
4755,katy,349,26059389,96.3425214435,_100,4,>100
4756,authors,349,26059738,96.3438117093,_100,7,>100
4757,presented,349,26060087,96.3451019752,_100,9,>100
4758,sticker,349,26060436,96.346392241,_100,7,>100
4759,viewing,349,26060785,96.3476825069,_100,7,>100
4760,conditions,349,26061134,96.3489727728,_100,10,>100
4761,terry,348,26061482,96.3502593416,_100,5,>100
4762,pound,348,26061830,96.3515459104,_100,5,>100
4763,ignorance,348,26062178,96.3528324792,_100,9,>100
4764,attached,348,26062526,96.3541190481,_100,8,>100
4765,cowboy,348,26062874,96.3554056169,_100,6,>100
4766,determine,348,26063222,96.3566921857,_100,9,>100
4767,cheaper,347,26063569,96.3579750575,_100,7,>100
4768,bum,347,26063916,96.3592579293,_100,3,>100
4769,hav,347,26064263,96.3605408011,_100,3,>100
4770,spain,347,26064610,96.3618236729,_100,5,>100
4771,residents,347,26064957,96.3631065446,_100,9,>100
4772,organized,347,26065304,96.3643894164,_100,9,>100
4773,challenging,346,26065650,96.3656685912,_100,11,>100
4774,tennessee,346,26065996,96.3669477659,_100,9,>100
4775,rides,346,26066342,96.3682269407,_100,5,>100
4776,supplies,346,26066688,96.3695061154,_100,8,>100
4777,journalism,346,26067034,96.3707852902,_100,10,>100
4778,lo,346,26067380,96.3720644649,_100,2,>100
4779,nm,346,26067726,96.3733436397,_100,2,>100
4780,judging,346,26068072,96.3746228144,_100,7,>100
4781,soap,346,26068418,96.3759019892,_100,4,>100
4782,commit,346,26068764,96.3771811639,_100,6,>100
4783,olds,346,26069110,96.3784603387,_100,4,>100
4784,darkness,346,26069456,96.3797395134,_100,8,>100
4785,deeply,346,26069802,96.3810186882,_100,6,>100
4786,prepping,346,26070148,96.3822978629,_100,8,>100
4787,stat,345,26070493,96.3835733407,_100,4,>100
4788,adore,345,26070838,96.3848488184,_100,5,>100
4789,whale,345,26071183,96.3861242961,_100,5,>100
4790,reform,345,26071528,96.3873997738,_100,6,>100
4791,description,345,26071873,96.3886752515,_100,11,>100
4792,traded,345,26072218,96.3899507292,_100,6,>100
4793,stations,345,26072563,96.3912262069,_100,8,>100
4794,curse,345,26072908,96.3925016846,_100,5,>100
4795,victim,345,26073253,96.3937771624,_100,6,>100
4796,toronto,345,26073598,96.3950526401,_100,7,>100
4797,suffering,345,26073943,96.3963281178,_100,9,>100
4798,stack,345,26074288,96.3976035955,_100,5,>100
4799,clay,345,26074633,96.3988790732,_100,4,>100
4800,cycle,345,26074978,96.4001545509,_100,5,>100
4801,workouts,344,26075322,96.4014263316,_100,8,>100
4802,ken,344,26075666,96.4026981123,_100,3,>100
4803,defeat,344,26076010,96.403969893,_100,6,>100
4804,citizens,344,26076354,96.4052416736,_100,8,>100
4805,berry,344,26076698,96.4065134543,_100,5,>100
4806,dot,344,26077042,96.407785235,_100,3,>100
4807,introduced,344,26077386,96.4090570157,_100,10,>100
4808,supreme,344,26077730,96.4103287963,_100,7,>100
4809,nelson,344,26078074,96.411600577,_100,6,>100
4810,believing,344,26078418,96.4128723577,_100,9,>100
4811,choosing,344,26078762,96.4141441384,_100,8,>100
4812,sticking,344,26079106,96.415415919,_100,8,>100
4813,markets,344,26079450,96.4166876997,_100,7,>100
4814,larger,344,26079794,96.4179594804,_100,6,>100
4815,betty,344,26080138,96.4192312611,_100,5,>100
4816,elizabeth,343,26080481,96.4204993447,_100,9,>100
4817,broad,343,26080824,96.4217674284,_100,5,>100
4818,releasing,343,26081167,96.423035512,_100,9,>100
4819,thompson,343,26081510,96.4243035956,_100,8,>100
4820,clinton,343,26081853,96.4255716793,_100,7,>100
4821,chamber,343,26082196,96.4268397629,_100,7,>100
4822,salmon,343,26082539,96.4281078466,_100,6,>100
4823,significant,343,26082882,96.4293759302,_100,11,>100
4824,safely,343,26083225,96.4306440138,_100,6,>100
4825,cart,342,26083567,96.4319084004,_100,4,>100
4826,differently,342,26083909,96.433172787,_100,11,>100
4827,arguing,342,26084251,96.4344371736,_100,7,>100
4828,remote,342,26084593,96.4357015602,_100,6,>100
4829,stressful,342,26084935,96.4369659469,_100,9,>100
4830,lobby,342,26085277,96.4382303335,_100,5,>100
4831,twitterverse,341,26085618,96.439491023,_100,12,>100
4832,scholarship,341,26085959,96.4407517126,_100,11,>100
4833,buffet,341,26086300,96.4420124022,_100,6,>100
4834,acoustic,341,26086641,96.4432730917,_100,8,>100
4835,cancel,341,26086982,96.4445337813,_100,6,>100
4836,drums,341,26087323,96.4457944709,_100,5,>100
4837,romantic,341,26087664,96.4470551604,_100,8,>100
4838,cracking,341,26088005,96.44831585,_100,8,>100
4839,turnout,340,26088345,96.4495728425,_100,7,>100
4840,braces,340,26088685,96.450829835,_100,6,>100
4841,examples,340,26089025,96.4520868276,_100,8,>100
4842,lifestyle,340,26089365,96.4533438201,_100,9,>100
4843,ct,340,26089705,96.4546008126,_100,2,>100
4844,katie,340,26090045,96.4558578052,_100,5,>100
4845,lap,340,26090385,96.4571147977,_100,3,>100
4846,saint,340,26090725,96.4583717902,_100,5,>100
4847,gingrich,340,26091065,96.4596287827,_100,8,>100
4848,defensive,340,26091405,96.4608857753,_100,9,>100
4849,ian,340,26091745,96.4621427678,_100,3,>100
4850,roy,340,26092085,96.4633997603,_100,3,>100
4851,recruiting,339,26092424,96.4646530558,_100,10,>100
4852,perfection,339,26092763,96.4659063513,_100,10,>100
4853,elected,339,26093102,96.4671596468,_100,7,>100
4854,locker,339,26093441,96.4684129423,_100,6,>100
4855,printed,339,26093780,96.4696662378,_100,7,>100
4856,installed,338,26094118,96.4709158363,_100,9,>100
4857,sb,338,26094456,96.4721654347,_100,2,>100
4858,bounce,338,26094794,96.4734150332,_100,6,>100
4859,enjoyable,338,26095132,96.4746646316,_100,9,>100
4860,worn,338,26095470,96.4759142301,_100,4,>100
4861,whining,338,26095808,96.4771638285,_100,7,>100
4862,underground,338,26096146,96.478413427,_100,11,>100
4863,spare,338,26096484,96.4796630254,_100,5,>100
4864,gates,338,26096822,96.4809126239,_100,5,>100
4865,wondered,338,26097160,96.4821622224,_100,8,>100
4866,albuquerque,338,26097498,96.4834118208,_100,11,>100
4867,stewart,338,26097836,96.4846614193,_100,7,>100
4868,hipster,338,26098174,96.4859110177,_100,7,>100
4869,blasting,338,26098512,96.4871606162,_100,8,>100
4870,rihanna,338,26098850,96.4884102146,_100,7,>100
4871,badge,338,26099188,96.4896598131,_100,5,>100
4872,length,337,26099525,96.4909057145,_100,6,>100
4873,marks,337,26099862,96.4921516159,_100,5,>100
4874,vinyl,337,26100199,96.4933975173,_100,5,>100
4875,affordable,337,26100536,96.4946434188,_100,10,>100
4876,busted,337,26100873,96.4958893202,_100,6,>100
4877,tanning,337,26101210,96.4971352216,_100,7,>100
4878,provided,336,26101546,96.498377426,_100,8,>100
4879,rains,336,26101882,96.4996196304,_100,5,>100
4880,anonymous,336,26102218,96.5008618347,_100,9,>100
4881,roads,336,26102554,96.5021040391,_100,5,>100
4882,crawl,336,26102890,96.5033462435,_100,5,>100
4883,clown,336,26103226,96.5045884479,_100,5,>100
4884,existence,336,26103562,96.5058306523,_100,9,>100
4885,ios,336,26103898,96.5070728567,_100,3,>100
4886,codes,336,26104234,96.508315061,_100,5,>100
4887,agents,336,26104570,96.5095572654,_100,6,>100
4888,upstairs,336,26104906,96.5107994698,_100,8,>100
4889,sonic,335,26105241,96.5120379771,_100,5,>100
4890,listing,335,26105576,96.5132764845,_100,7,>100
4891,mca,335,26105911,96.5145149918,_100,3,>100
4892,windy,335,26106246,96.5157534992,_100,5,>100
4893,griffin,335,26106581,96.5169920065,_100,7,>100
4894,sends,335,26106916,96.5182305139,_100,5,>100
4895,tavern,335,26107251,96.5194690212,_100,6,>100
4896,innovative,335,26107586,96.5207075286,_100,10,>100
4897,neat,335,26107921,96.5219460359,_100,4,>100
4898,bk,335,26108256,96.5231845433,_100,2,>100
4899,port,334,26108590,96.5244193536,_100,4,>100
4900,beastie,334,26108924,96.5256541639,_100,7,>100
4901,necessarily,334,26109258,96.5268889742,_100,11,>100
4902,ceiling,334,26109592,96.5281237845,_100,7,>100
4903,fwd,334,26109926,96.5293585948,_100,3,>100
4904,basket,334,26110260,96.5305934051,_100,6,>100
4905,anxiety,334,26110594,96.5318282154,_100,7,>100
4906,maintain,334,26110928,96.5330630257,_100,8,>100
4907,ignoring,334,26111262,96.534297836,_100,8,>100
4908,luther,334,26111596,96.5355326463,_100,6,>100
4909,wendy,334,26111930,96.5367674566,_100,5,>100
4910,updating,334,26112264,96.5380022669,_100,8,>100
4911,condition,334,26112598,96.5392370773,_100,9,>100
4912,fallen,333,26112931,96.5404681905,_100,6,>100
4913,bourbon,333,26113264,96.5416993038,_100,7,>100
4914,appeal,333,26113597,96.5429304171,_100,6,>100
4915,explains,333,26113930,96.5441615303,_100,8,>100
4916,install,333,26114263,96.5453926436,_100,7,>100
4917,pacific,333,26114596,96.5466237569,_100,7,>100
4918,wth,333,26114929,96.5478548702,_100,3,>100
4919,bynum,333,26115262,96.5490859834,_100,5,>100
4920,backyard,333,26115595,96.5503170967,_100,8,>100
4921,admire,333,26115928,96.55154821,_100,6,>100
4922,partying,333,26116261,96.5527793232,_100,8,>100
4923,linked,333,26116594,96.5540104365,_100,6,>100
4924,beliebers,332,26116926,96.5552378527,_100,9,>100
4925,disappointing,332,26117258,96.556465269,_100,13,>100
4926,selfish,332,26117590,96.5576926852,_100,7,>100
4927,checks,332,26117922,96.5589201015,_100,6,>100
4928,spit,332,26118254,96.5601475177,_100,4,>100
4929,shave,332,26118586,96.5613749339,_100,5,>100
4930,unexpected,332,26118918,96.5626023502,_100,10,>100
4931,viral,332,26119250,96.5638297664,_100,5,>100
4932,torn,332,26119582,96.5650571826,_100,4,>100
4933,unit,331,26119913,96.5662809018,_100,4,>100
4934,bullying,331,26120244,96.567504621,_100,8,>100
4935,salute,331,26120575,96.5687283402,_100,6,>100
4936,sunrise,331,26120906,96.5699520594,_100,7,>100
4937,fifth,331,26121237,96.5711757786,_100,5,>100
4938,experts,331,26121568,96.5723994978,_100,7,>100
4939,joey,331,26121899,96.573623217,_100,4,>100
4940,christopher,331,26122230,96.5748469362,_100,11,>100
4941,mee,331,26122561,96.5760706554,_100,3,>100
4942,smack,331,26122892,96.5772943746,_100,5,>100
4943,jen,330,26123222,96.5785143968,_100,3,>100
4944,input,330,26123552,96.5797344189,_100,5,>100
4945,lasts,330,26123882,96.5809544411,_100,5,>100
4946,judges,330,26124212,96.5821744632,_100,6,>100
4947,lick,330,26124542,96.5833944854,_100,4,>100
4948,stood,330,26124872,96.5846145076,_100,5,>100
4949,julie,330,26125202,96.5858345297,_100,5,>100
4950,deny,330,26125532,96.5870545519,_100,4,>100
4951,benjamin,329,26125861,96.588270877,_100,8,>100
4952,verizon,329,26126190,96.5894872021,_100,7,>100
4953,margaritas,329,26126519,96.5907035273,_100,10,>100
4954,toddler,329,26126848,96.5919198524,_100,7,>100
4955,overnight,329,26127177,96.5931361775,_100,9,>100
4956,yah,329,26127506,96.5943525026,_100,3,>100
4957,mortgage,329,26127835,96.5955688278,_100,8,>100
4958,oven,329,26128164,96.5967851529,_100,4,>100
4959,mob,329,26128493,96.598001478,_100,3,>100
4960,thai,329,26128822,96.5992178031,_100,4,>100
4961,machines,329,26129151,96.6004341282,_100,8,>100
4962,individuals,329,26129480,96.6016504534,_100,11,>100
4963,improv,329,26129809,96.6028667785,_100,6,>100
4964,harbor,329,26130138,96.6040831036,_100,6,>100
4965,interviewed,329,26130467,96.6052994287,_100,11,>100
4966,adds,329,26130796,96.6065157539,_100,4,>100
4967,marshall,329,26131125,96.607732079,_100,8,>100
4968,smoked,328,26131453,96.6089447071,_100,6,>100
4969,afterwards,328,26131781,96.6101573352,_100,10,>100
4970,belief,328,26132109,96.6113699633,_100,6,>100
4971,admission,328,26132437,96.6125825913,_100,9,>100
4972,resident,328,26132765,96.6137952194,_100,8,>100
4973,pointless,328,26133093,96.6150078475,_100,9,>100
4974,iu,328,26133421,96.6162204756,_100,2,>100
4975,avenue,328,26133749,96.6174331037,_100,6,>100
4976,pets,328,26134077,96.6186457318,_100,4,>100
4977,peaceful,328,26134405,96.6198583599,_100,8,>100
4978,pin,328,26134733,96.621070988,_100,3,>100
4979,finest,328,26135061,96.622283616,_100,6,>100
4980,whistle,327,26135388,96.6234925471,_100,7,>100
4981,directions,327,26135715,96.6247014781,_100,10,>100
4982,offended,327,26136042,96.6259104092,_100,8,>100
4983,steel,327,26136369,96.6271193402,_100,5,>100
4984,engaging,327,26136696,96.6283282713,_100,8,>100
4985,cloudy,327,26137023,96.6295372023,_100,6,>100
4986,shadow,327,26137350,96.6307461334,_100,6,>100
4987,agreement,327,26137677,96.6319550644,_100,9,>100
4988,mets,327,26138004,96.6331639955,_100,4,>100
4989,heyy,326,26138330,96.6343692295,_100,4,>100
4990,sm,326,26138656,96.6355744635,_100,2,>100
4991,policies,326,26138982,96.6367796975,_100,8,>100
4992,thee,326,26139308,96.6379849315,_100,4,>100
4993,miserable,326,26139634,96.6391901656,_100,9,>100
4994,invisible,326,26139960,96.6403953996,_100,9,>100
4995,roast,326,26140286,96.6416006336,_100,5,>100
4996,ops,326,26140612,96.6428058676,_100,3,>100
4997,wwe,326,26140938,96.6440111016,_100,3,>100
4998,pal,326,26141264,96.6452163356,_100,3,>100
4999,habits,326,26141590,96.6464215696,_100,6,>100
5000,vibes,326,26141916,96.6476268037,_100,5,>100
5001,nicole,326,26142242,96.6488320377,_100,6,>100
5002,karen,326,26142568,96.6500372717,_100,5,>100
5003,lamb,326,26142894,96.6512425057,_100,4,>100
5004,wrk,325,26143219,96.6524440427,_100,3,>100
5005,humanities,325,26143544,96.6536455796,_100,10,>100
5006,muscles,325,26143869,96.6548471166,_100,7,>100
5007,visitors,325,26144194,96.6560486536,_100,8,>100
5008,intelligence,325,26144519,96.6572501906,_100,12,>100
5009,veggies,325,26144844,96.6584517275,_100,7,>100
5010,hoops,325,26145169,96.6596532645,_100,5,>100
5011,wonderfully,325,26145494,96.6608548015,_100,11,>100
5012,barry,325,26145819,96.6620563385,_100,5,>100
5013,announcing,325,26146144,96.6632578755,_100,10,>100
5014,charges,325,26146469,96.6644594124,_100,7,>100
5015,grows,325,26146794,96.6656609494,_100,5,>100
5016,tooth,325,26147119,96.6668624864,_100,5,>100
5017,flavors,324,26147443,96.6680603263,_100,7,>100
5018,thumbs,324,26147767,96.6692581663,_100,6,>100
5019,boards,324,26148091,96.6704560062,_100,6,>100
5020,regularly,324,26148415,96.6716538461,_100,9,>100
5021,insanity,324,26148739,96.6728516861,_100,8,>100
5022,simpson,324,26149063,96.674049526,_100,7,>100
5023,gordon,324,26149387,96.675247366,_100,6,>100
5024,boost,324,26149711,96.6764452059,_100,5,>100
5025,heritage,324,26150035,96.6776430458,_100,8,>100
5026,improved,323,26150358,96.6788371887,_100,8,>100
5027,ping,323,26150681,96.6800313316,_100,4,>100
5028,uniform,323,26151004,96.6812254746,_100,7,>100
5029,harper,323,26151327,96.6824196175,_100,6,>100
5030,witness,323,26151650,96.6836137604,_100,7,>100
5031,switched,323,26151973,96.6848079033,_100,8,>100
5032,eagle,323,26152296,96.6860020462,_100,5,>100
5033,hart,323,26152619,96.6871961891,_100,4,>100
5034,pretending,322,26152941,96.6883866349,_100,10,>100
5035,anna,322,26153263,96.6895770808,_100,4,>100
5036,purse,322,26153585,96.6907675267,_100,5,>100
5037,cabin,322,26153907,96.6919579725,_100,5,>100
5038,responding,322,26154229,96.6931484184,_100,10,>100
5039,wherever,322,26154551,96.6943388643,_100,8,>100
5040,funeral,322,26154873,96.6955293101,_100,7,>100
5041,roller,322,26155195,96.696719756,_100,6,>100
5042,portfolio,322,26155517,96.6979102019,_100,9,>100
5043,insights,322,26155839,96.6991006477,_100,8,>100
5044,outcome,322,26156161,96.7002910936,_100,7,>100
5045,ideal,322,26156483,96.7014815395,_100,5,>100
5046,porch,322,26156805,96.7026719853,_100,5,>100
5047,noble,321,26157126,96.7038587342,_100,5,>100
5048,prior,321,26157447,96.705045483,_100,5,>100
5049,sue,321,26157768,96.7062322318,_100,3,>100
5050,applied,321,26158089,96.7074189806,_100,7,>100
5051,bosh,321,26158410,96.7086057295,_100,4,>100
5052,maintenance,321,26158731,96.7097924783,_100,11,>100
5053,tucson,321,26159052,96.7109792271,_100,6,>100
5054,permanent,321,26159373,96.712165976,_100,9,>100
5055,penalty,321,26159694,96.7133527248,_100,7,>100
5056,producers,321,26160015,96.7145394736,_100,9,>100
5057,checkout,321,26160336,96.7157262224,_100,8,>100
5058,population,321,26160657,96.7169129713,_100,10,>100
5059,capacity,321,26160978,96.7180997201,_100,8,>100
5060,desert,321,26161299,96.7192864689,_100,6,>100
5061,ironic,320,26161619,96.7204695207,_100,6,>100
5062,dozen,320,26161939,96.7216525725,_100,5,>100
5063,medium,320,26162259,96.7228356243,_100,6,>100
5064,ban,320,26162579,96.7240186761,_100,3,>100
5065,govt,320,26162899,96.7252017279,_100,4,>100
5066,sc,320,26163219,96.7263847797,_100,2,>100
5067,wasting,320,26163539,96.7275678315,_100,7,>100
5068,touches,320,26163859,96.7287508833,_100,7,>100
5069,blunt,320,26164179,96.7299339351,_100,5,>100
5070,sacramento,320,26164499,96.7311169869,_100,10,>100
5071,spaces,320,26164819,96.7323000386,_100,6,>100
5072,evans,319,26165138,96.7334793934,_100,5,>100
5073,specifically,319,26165457,96.7346587482,_100,12,>100
5074,dylan,319,26165776,96.7358381029,_100,5,>100
5075,developed,319,26166095,96.7370174577,_100,9,>100
5076,drum,319,26166414,96.7381968124,_100,4,>100
5077,interests,319,26166733,96.7393761672,_100,9,>100
5078,rolled,319,26167052,96.7405555219,_100,6,>100
5079,sober,319,26167371,96.7417348767,_100,5,>100
5080,feat,319,26167690,96.7429142314,_100,4,>100
5081,imo,319,26168009,96.7440935862,_100,3,>100
5082,upside,319,26168328,96.745272941,_100,6,>100
5083,approve,319,26168647,96.7464522957,_100,7,>100
5084,capable,319,26168966,96.7476316505,_100,7,>100
5085,awh,319,26169285,96.7488110052,_100,3,>100
5086,newspaper,319,26169604,96.74999036,_100,9,>100
5087,vikings,319,26169923,96.7511697147,_100,7,>100
5088,cooked,318,26170241,96.7523453725,_100,6,>100
5089,wright,318,26170559,96.7535210302,_100,6,>100
5090,vinny,318,26170877,96.7546966879,_100,5,>100
5091,ace,318,26171195,96.7558723456,_100,3,>100
5092,mixing,318,26171513,96.7570480033,_100,6,>100
5093,mentioning,318,26171831,96.758223661,_100,10,>100
5094,athletic,318,26172149,96.7593993188,_100,8,>100
5095,halfway,318,26172467,96.7605749765,_100,7,>100
5096,grammar,318,26172785,96.7617506342,_100,7,>100
5097,ranch,318,26173103,96.7629262919,_100,5,>100
5098,gospel,318,26173421,96.7641019496,_100,6,>100
5099,cakes,318,26173739,96.7652776074,_100,5,>100
5100,officials,318,26174057,96.7664532651,_100,9,>100
5101,poised,317,26174374,96.7676252258,_100,6,>100
5102,survived,317,26174691,96.7687971864,_100,8,>100
5103,explore,317,26175008,96.7699691471,_100,7,>100
5104,stuffed,317,26175325,96.7711411078,_100,7,>100
5105,mustache,317,26175642,96.7723130685,_100,8,>100
5106,priceless,317,26175959,96.7734850292,_100,9,>100
5107,bryan,317,26176276,96.7746569898,_100,5,>100
5108,usc,317,26176593,96.7758289505,_100,3,>100
5109,acct,316,26176909,96.7769972142,_100,4,>100
5110,engine,316,26177225,96.7781654778,_100,6,>100
5111,priority,316,26177541,96.7793337415,_100,8,>100
5112,rub,316,26177857,96.7805020051,_100,3,>100
5113,failing,316,26178173,96.7816702688,_100,7,>100
5114,defend,316,26178489,96.7828385324,_100,6,>100
5115,vibe,316,26178805,96.784006796,_100,4,>100
5116,singers,316,26179121,96.7851750597,_100,7,>100
5117,hammer,315,26179436,96.7863396263,_100,6,>100
5118,runners,315,26179751,96.7875041929,_100,7,>100
5119,emotion,315,26180066,96.7886687595,_100,7,>100
5120,dale,315,26180381,96.7898333261,_100,4,>100
5121,exit,315,26180696,96.7909978927,_100,4,>100
5122,jonathan,315,26181011,96.7921624593,_100,8,>100
5123,slice,315,26181326,96.7933270259,_100,5,>100
5124,rental,315,26181641,96.7944915926,_100,6,>100
5125,nola,315,26181956,96.7956561592,_100,4,>100
5126,surprising,315,26182271,96.7968207258,_100,10,>100
5127,fields,315,26182586,96.7979852924,_100,6,>100
5128,rodgers,315,26182901,96.799149859,_100,7,>100
5129,nancy,315,26183216,96.8003144256,_100,5,>100
5130,retail,315,26183531,96.8014789922,_100,6,>100
5131,replacement,314,26183845,96.8026398618,_100,11,>100
5132,hoodie,314,26184159,96.8038007313,_100,6,>100
5133,enthusiasm,314,26184473,96.8049616009,_100,10,>100
5134,column,314,26184787,96.8061224705,_100,6,>100
5135,belongs,314,26185101,96.8072833401,_100,7,>100
5136,creator,314,26185415,96.8084442096,_100,7,>100
5137,hustle,314,26185729,96.8096050792,_100,6,>100
5138,phenomenal,313,26186042,96.8107622517,_100,10,>100
5139,ego,313,26186355,96.8119194243,_100,3,>100
5140,dip,313,26186668,96.8130765968,_100,3,>100
5141,choir,313,26186981,96.8142337693,_100,5,>100
5142,peppers,313,26187294,96.8153909419,_100,7,>100
5143,bid,313,26187607,96.8165481144,_100,3,>100
5144,meds,313,26187920,96.8177052869,_100,4,>100
5145,facial,313,26188233,96.8188624595,_100,6,>100
5146,trek,312,26188545,96.820015935,_100,4,>100
5147,th,312,26188857,96.8211694105,_100,2,>100
5148,saves,312,26189169,96.822322886,_100,5,>100
5149,brooks,312,26189481,96.8234763615,_100,6,>100
5150,revenue,312,26189793,96.824629837,_100,7,>100
5151,oral,311,26190104,96.8257796154,_100,4,>100
5152,approval,311,26190415,96.8269293939,_100,8,>100
5153,joshua,311,26190726,96.8280791723,_100,6,>100
5154,popped,311,26191037,96.8292289508,_100,6,>100
5155,dedication,311,26191348,96.8303787293,_100,10,>100
5156,cameras,311,26191659,96.8315285077,_100,7,>100
5157,closest,311,26191970,96.8326782862,_100,7,>100
5158,beware,311,26192281,96.8338280646,_100,6,>100
5159,intelligent,311,26192592,96.8349778431,_100,11,>100
5160,sen,311,26192903,96.8361276216,_100,3,>100
5161,protein,310,26193213,96.837273703,_100,7,>100
5162,predict,310,26193523,96.8384197844,_100,7,>100
5163,stepped,310,26193833,96.8395658658,_100,7,>100
5164,plants,310,26194143,96.8407119473,_100,6,>100
5165,poem,310,26194453,96.8418580287,_100,4,>100
5166,suggested,310,26194763,96.8430041101,_100,9,>100
5167,stalking,310,26195073,96.8441501915,_100,8,>100
5168,shops,310,26195383,96.845296273,_100,5,>100
5169,placed,310,26195693,96.8464423544,_100,6,>100
5170,vp,310,26196003,96.8475884358,_100,2,>100
5171,directed,310,26196313,96.8487345172,_100,8,>100
5172,bold,309,26196622,96.8498769016,_100,4,>100
5173,fears,309,26196931,96.851019286,_100,5,>100
5174,approved,309,26197240,96.8521616704,_100,8,>100
5175,conservative,309,26197549,96.8533040548,_100,12,>100
5176,indians,309,26197858,96.8544464392,_100,7,>100
5177,pimp,309,26198167,96.8555888235,_100,4,>100
5178,finance,309,26198476,96.8567312079,_100,7,>100
5179,directors,309,26198785,96.8578735923,_100,9,>100
5180,shoulda,309,26199094,96.8590159767,_100,7,>100
5181,rabbit,309,26199403,96.8601583611,_100,6,>100
5182,ellen,309,26199712,96.8613007455,_100,5,>100
5183,burnt,308,26200020,96.8624394328,_100,5,>100
5184,preach,308,26200328,96.8635781202,_100,6,>100
5185,worldwide,308,26200636,96.8647168075,_100,9,>100
5186,kanye,308,26200944,96.8658554949,_100,5,>100
5187,ties,308,26201252,96.8669941822,_100,4,>100
5188,wa,308,26201560,96.8681328696,_100,2,>100
5189,genre,308,26201868,96.8692715569,_100,5,>100
5190,shoulders,308,26202176,96.8704102443,_100,9,>100
5191,setup,307,26202483,96.8715452346,_100,5,>100
5192,spiritual,307,26202790,96.8726802249,_100,9,>100
5193,shoots,307,26203097,96.8738152152,_100,6,>100
5194,expand,307,26203404,96.8749502055,_100,6,>100
5195,plot,307,26203711,96.8760851958,_100,4,>100
5196,warren,307,26204018,96.8772201862,_100,6,>100
5197,gurl,307,26204325,96.8783551765,_100,4,>100
5198,impress,307,26204632,96.8794901668,_100,7,>100
5199,bodies,307,26204939,96.8806251571,_100,6,>100
5200,rogers,307,26205246,96.8817601474,_100,6,>100
5201,knw,307,26205553,96.8828951377,_100,3,>100
5202,ta,307,26205860,96.884030128,_100,2,>100
5203,panic,306,26206166,96.8851614213,_100,5,>100
5204,newsletter,306,26206472,96.8862927146,_100,10,>100
5205,ignored,306,26206778,96.8874240079,_100,7,>100
5206,climb,306,26207084,96.8885553011,_100,5,>100
5207,churchill,306,26207390,96.8896865944,_100,9,>100
5208,permission,306,26207696,96.8908178877,_100,10,>100
5209,touching,306,26208002,96.891949181,_100,8,>100
5210,hbo,306,26208308,96.8930804743,_100,3,>100
5211,tweeter,306,26208614,96.8942117675,_100,7,>100
5212,amanda,306,26208920,96.8953430608,_100,6,>100
5213,minus,306,26209226,96.8964743541,_100,5,>100
5214,queens,306,26209532,96.8976056474,_100,6,>100
5215,reservations,305,26209837,96.8987332436,_100,12,>100
5216,kit,305,26210142,96.8998608398,_100,3,>100
5217,lsu,305,26210447,96.9009884361,_100,3,>100
5218,neil,305,26210752,96.9021160323,_100,4,>100
5219,lb,305,26211057,96.9032436286,_100,2,>100
5220,osu,305,26211362,96.9043712248,_100,3,>100
5221,drafted,305,26211667,96.905498821,_100,7,>100
5222,retirement,305,26211972,96.9066264173,_100,10,>100
5223,healing,305,26212277,96.9077540135,_100,7,>100
5224,maker,305,26212582,96.9088816098,_100,5,>100
5225,kingdom,305,26212887,96.910009206,_100,7,>100
5226,particularly,305,26213192,96.9111368022,_100,12,>100
5227,weirdo,305,26213497,96.9122643985,_100,6,>100
5228,patron,305,26213802,96.9133919947,_100,6,>100
5229,ordering,304,26214106,96.9145158939,_100,8,>100
5230,twain,304,26214410,96.9156397931,_100,5,>100
5231,generous,304,26214714,96.9167636923,_100,8,>100
5232,weakness,304,26215018,96.9178875915,_100,8,>100
5233,melissa,304,26215322,96.9190114907,_100,7,>100
5234,fairly,304,26215626,96.9201353899,_100,6,>100
5235,trap,304,26215930,96.9212592891,_100,4,>100
5236,pros,304,26216234,96.9223831883,_100,4,>100
5237,daughters,304,26216538,96.9235070875,_100,9,>100
5238,heal,304,26216842,96.9246309867,_100,4,>100
5239,interviewing,304,26217146,96.9257548859,_100,12,>100
5240,needa,304,26217450,96.9268787851,_100,5,>100
5241,communications,304,26217754,96.9280026843,_100,14,>100
5242,fo,303,26218057,96.9291228865,_100,2,>100
5243,verse,303,26218360,96.9302430887,_100,5,>100
5244,newark,303,26218663,96.9313632908,_100,6,>100
5245,garlic,303,26218966,96.932483493,_100,6,>100
5246,operation,303,26219269,96.9336036952,_100,9,>100
5247,wished,303,26219572,96.9347238973,_100,6,>100
5248,ho,303,26219875,96.9358440995,_100,2,>100
5249,equality,303,26220178,96.9369643017,_100,8,>100
5250,sin,303,26220481,96.9380845038,_100,3,>100
5251,goodies,303,26220784,96.939204706,_100,7,>100
5252,ease,303,26221087,96.9403249082,_100,4,>100
5253,barnes,303,26221390,96.9414451103,_100,6,>100
5254,photoshop,303,26221693,96.9425653125,_100,9,>100
5255,frame,302,26221995,96.9436818176,_100,5,>100
5256,jacksonville,302,26222297,96.9447983228,_100,12,>100
5257,scout,302,26222599,96.9459148279,_100,5,>100
5258,vids,302,26222901,96.947031333,_100,4,>100
5259,wiz,302,26223203,96.9481478381,_100,3,>100
5260,divine,302,26223505,96.9492643433,_100,6,>100
5261,mlk,302,26223807,96.9503808484,_100,3,>100
5262,courtesy,302,26224109,96.9514973535,_100,8,>100
5263,shares,302,26224411,96.9526138587,_100,6,>100
5264,races,301,26224712,96.9537266668,_100,5,>100
5265,charger,301,26225013,96.9548394748,_100,7,>100
5266,slip,301,26225314,96.9559522829,_100,4,>100
5267,bravo,301,26225615,96.957065091,_100,5,>100
5268,russian,301,26225916,96.9581778991,_100,7,>100
5269,rappers,301,26226217,96.9592907072,_100,7,>100
5270,organizations,301,26226518,96.9604035153,_100,13,>100
5271,tab,301,26226819,96.9615163234,_100,3,>100
5272,tommy,301,26227120,96.9626291315,_100,5,>100
5273,responses,301,26227421,96.9637419396,_100,9,>100
5274,butler,300,26227721,96.9648510506,_100,6,>100
5275,literary,300,26228021,96.9659601617,_100,8,>100
5276,buddies,300,26228321,96.9670692727,_100,7,>100
5277,rochester,300,26228621,96.9681783838,_100,9,>100
5278,sacrifice,300,26228921,96.9692874949,_100,9,>100
5279,300,300,26229221,96.9703966059,_100,3,>100
5280,driven,300,26229521,96.971505717,_100,6,>100
5281,sounding,300,26229821,96.972614828,_100,8,>100
5282,affected,300,26230121,96.9737239391,_100,8,>100
5283,exhibition,300,26230421,96.9748330501,_100,10,>100
5284,pile,300,26230721,96.9759421612,_100,4,>100
5285,switching,300,26231021,96.9770512722,_100,9,>100
5286,utah,300,26231321,96.9781603833,_100,4,>100
5287,oprah,299,26231620,96.9792657973,_100,5,>100
5288,concerns,299,26231919,96.9803712113,_100,8,>100
5289,gardens,299,26232218,96.9814766254,_100,7,>100
5290,greetings,299,26232517,96.9825820394,_100,9,>100
5291,cared,299,26232816,96.9836874534,_100,5,>100
5292,brains,299,26233115,96.9847928674,_100,6,>100
5293,motto,299,26233414,96.9858982814,_100,5,>100
5294,tail,299,26233713,96.9870036954,_100,4,>100
5295,overrated,299,26234012,96.9881091095,_100,9,>100
5296,tours,299,26234311,96.9892145235,_100,5,>100
5297,slides,298,26234609,96.9903162405,_100,6,>100
5298,cooper,298,26234907,96.9914179574,_100,6,>100
5299,alas,298,26235205,96.9925196744,_100,4,>100
5300,fixing,298,26235503,96.9936213914,_100,6,>100
5301,pills,298,26235801,96.9947231084,_100,5,>100
5302,fathers,298,26236099,96.9958248254,_100,7,>100
5303,meetup,298,26236397,96.9969265424,_100,6,>100
5304,leaf,298,26236695,96.9980282593,_100,4,>100
5305,camping,298,26236993,96.9991299763,_100,7,>100
5306,fist,298,26237291,97.0002316933,_100,4,>100
5307,lawrence,298,26237589,97.0013334103,_100,8,>100
5308,housewives,298,26237887,97.0024351273,_100,10,>100
5309,gimme,298,26238185,97.0035368442,_100,5,>100
5310,bestie,297,26238482,97.0046348642,_100,6,>100
5311,deeper,297,26238779,97.0057328841,_100,6,>100
5312,graduated,297,26239076,97.0068309041,_100,9,>100
5313,monsters,297,26239373,97.007928924,_100,8,>100
5314,turner,297,26239670,97.009026944,_100,6,>100
5315,european,297,26239967,97.0101249639,_100,8,>100
5316,vendors,297,26240264,97.0112229839,_100,7,>100
5317,stanley,297,26240561,97.0123210038,_100,7,>100
5318,cheesecake,297,26240858,97.0134190237,_100,10,>100
5319,brewery,297,26241155,97.0145170437,_100,7,>100
5320,closes,296,26241451,97.0156113666,_100,6,>100
5321,distracted,296,26241747,97.0167056895,_100,10,>100
5322,behalf,296,26242043,97.0178000124,_100,6,>100
5323,logic,296,26242339,97.0188943353,_100,5,>100
5324,brutal,296,26242635,97.0199886582,_100,6,>100
5325,bikes,296,26242931,97.0210829811,_100,5,>100
5326,naturally,296,26243227,97.022177304,_100,9,>100
5327,plaza,296,26243523,97.023271627,_100,5,>100
5328,blanket,296,26243819,97.0243659499,_100,7,>100
5329,liz,296,26244115,97.0254602728,_100,3,>100
5330,trio,296,26244411,97.0265545957,_100,4,>100
5331,thankfully,296,26244707,97.0276489186,_100,10,>100
5332,bites,296,26245003,97.0287432415,_100,5,>100
5333,matches,296,26245299,97.0298375644,_100,7,>100
5334,recognized,295,26245594,97.0309281903,_100,10,>100
5335,mentally,295,26245889,97.0320188161,_100,8,>100
5336,method,295,26246184,97.033109442,_100,6,>100
5337,haiti,295,26246479,97.0342000679,_100,5,>100
5338,believed,295,26246774,97.0352906938,_100,8,>100
5339,morn,295,26247069,97.0363813196,_100,4,>100
5340,kurt,295,26247364,97.0374719455,_100,4,>100
5341,extension,294,26247658,97.0385588743,_100,9,>100
5342,owns,294,26247952,97.0396458032,_100,4,>100
5343,pour,294,26248246,97.040732732,_100,4,>100
5344,sprint,294,26248540,97.0418196608,_100,6,>100
5345,airlines,294,26248834,97.0429065897,_100,8,>100
5346,hosts,294,26249128,97.0439935185,_100,5,>100
5347,phase,294,26249422,97.0450804473,_100,5,>100
5348,maine,294,26249716,97.0461673762,_100,5,>100
5349,database,294,26250010,97.047254305,_100,8,>100
5350,wr,293,26250303,97.0483375368,_100,2,>100
5351,frm,293,26250596,97.0494207686,_100,3,>100
5352,proven,293,26250889,97.0505040004,_100,6,>100
5353,waffle,293,26251182,97.0515872322,_100,6,>100
5354,credits,293,26251475,97.052670464,_100,7,>100
5355,ipa,293,26251768,97.0537536958,_100,3,>100
5356,mask,293,26252061,97.0548369276,_100,4,>100
5357,goose,293,26252354,97.0559201594,_100,5,>100
5358,consistent,293,26252647,97.0570033912,_100,10,>100
5359,tummy,293,26252940,97.058086623,_100,5,>100
5360,gee,293,26253233,97.0591698548,_100,3,>100
5361,faithful,293,26253526,97.0602530866,_100,8,>100
5362,kissing,293,26253819,97.0613363184,_100,7,>100
5363,cain,293,26254112,97.0624195502,_100,4,>100
5364,hundreds,292,26254404,97.0634990849,_100,8,>100
5365,focusing,292,26254696,97.0645786197,_100,8,>100
5366,bend,292,26254988,97.0656581544,_100,4,>100
5367,counter,292,26255280,97.0667376892,_100,7,>100
5368,protection,292,26255572,97.067817224,_100,10,>100
5369,cracked,292,26255864,97.0688967587,_100,7,>100
5370,nathan,292,26256156,97.0699762935,_100,6,>100
5371,flew,292,26256448,97.0710558283,_100,4,>100
5372,bein,292,26256740,97.072135363,_100,4,>100
5373,reminding,291,26257031,97.0732112007,_100,9,>100
5374,palin,291,26257322,97.0742870385,_100,5,>100
5375,jesse,291,26257613,97.0753628762,_100,5,>100
5376,lou,291,26257904,97.0764387139,_100,3,>100
5377,legacy,291,26258195,97.0775145516,_100,6,>100
5378,trayvon,291,26258486,97.0785903894,_100,7,>100
5379,foursquare,291,26258777,97.0796662271,_100,10,>100
5380,printer,291,26259068,97.0807420648,_100,7,>100
5381,apparel,291,26259359,97.0818179025,_100,7,>100
5382,musician,291,26259650,97.0828937402,_100,8,>100
5383,qr,291,26259941,97.083969578,_100,2,>100
5384,ref,291,26260232,97.0850454157,_100,3,>100
5385,participants,291,26260523,97.0861212534,_100,12,>100
5386,ripped,290,26260813,97.0871933941,_100,6,>100
5387,urself,290,26261103,97.0882655348,_100,6,>100
5388,talents,290,26261393,97.0893376755,_100,7,>100
5389,decides,290,26261683,97.0904098162,_100,7,>100
5390,detail,290,26261973,97.0914819569,_100,6,>100
5391,sensitive,290,26262263,97.0925540975,_100,9,>100
5392,circus,290,26262553,97.0936262382,_100,6,>100
5393,espresso,290,26262843,97.0946983789,_100,8,>100
5394,dump,290,26263133,97.0957705196,_100,4,>100
5395,dancer,290,26263423,97.0968426603,_100,6,>100
5396,den,289,26263712,97.0979111039,_100,3,>100
5397,increased,289,26264001,97.0989795476,_100,9,>100
5398,destroyed,289,26264290,97.1000479912,_100,9,>100
5399,fees,289,26264579,97.1011164349,_100,4,>100
5400,mines,289,26264868,97.1021848785,_100,5,>100
5401,lib,289,26265157,97.1032533222,_100,3,>100
5402,joins,288,26265445,97.1043180688,_100,5,>100
5403,creep,288,26265733,97.1053828154,_100,5,>100
5404,dairy,288,26266021,97.106447562,_100,5,>100
5405,np,288,26266309,97.1075123086,_100,2,>100
5406,thrones,288,26266597,97.1085770553,_100,7,>100
5407,apples,288,26266885,97.1096418019,_100,6,>100
5408,oldest,288,26267173,97.1107065485,_100,6,>100
5409,errors,288,26267461,97.1117712951,_100,6,>100
5410,poverty,288,26267749,97.1128360417,_100,7,>100
5411,yards,288,26268037,97.1139007883,_100,5,>100
5412,destiny,287,26268324,97.1149618379,_100,7,>100
5413,lawyers,287,26268611,97.1160228875,_100,7,>100
5414,lobster,287,26268898,97.117083937,_100,7,>100
5415,headline,287,26269185,97.1181449866,_100,8,>100
5416,outlook,287,26269472,97.1192060362,_100,7,>100
5417,partnership,287,26269759,97.1202670858,_100,11,>100
5418,atmosphere,287,26270046,97.1213281353,_100,10,>100
5419,pump,287,26270333,97.1223891849,_100,4,>100
5420,innocent,287,26270620,97.1234502345,_100,8,>100
5421,tire,287,26270907,97.1245112841,_100,4,>100
5422,shakespeare,287,26271194,97.1255723337,_100,11,>100
5423,gender,287,26271481,97.1266333832,_100,6,>100
5424,vocal,287,26271768,97.1276944328,_100,5,>100
5425,hilton,287,26272055,97.1287554824,_100,6,>100
5426,knife,287,26272342,97.129816532,_100,5,>100
5427,founder,287,26272629,97.1308775815,_100,7,>100
5428,achieved,287,26272916,97.1319386311,_100,8,>100
5429,fog,286,26273202,97.1329959837,_100,3,>100
5430,understands,286,26273488,97.1340533362,_100,11,>100
5431,educational,286,26273774,97.1351106887,_100,11,>100
5432,temporary,286,26274060,97.1361680413,_100,9,>100
5433,georgetown,286,26274346,97.1372253938,_100,10,>100
5434,horses,286,26274632,97.1382827463,_100,6,>100
5435,wonders,286,26274918,97.1393400989,_100,7,>100
5436,overcome,285,26275203,97.1403937544,_100,8,>100
5437,tops,285,26275488,97.1414474099,_100,4,>100
5438,roster,285,26275773,97.1425010654,_100,6,>100
5439,priorities,285,26276058,97.1435547209,_100,10,>100
5440,symposium,285,26276343,97.1446083764,_100,9,>100
5441,abroad,285,26276628,97.1456620319,_100,6,>100
5442,vince,285,26276913,97.1467156874,_100,5,>100
5443,olympics,284,26277197,97.1477656459,_100,8,>100
5444,retire,284,26277481,97.1488156043,_100,6,>100
5445,unc,284,26277765,97.1498655628,_100,3,>100
5446,eachother,284,26278049,97.1509155213,_100,9,>100
5447,greet,284,26278333,97.1519654797,_100,5,>100
5448,enterprise,284,26278617,97.1530154382,_100,10,>100
5449,papa,284,26278901,97.1540653967,_100,4,>100
5450,shelter,284,26279185,97.1551153551,_100,7,>100
5451,flower,284,26279469,97.1561653136,_100,6,>100
5452,coincidence,284,26279753,97.1572152721,_100,11,>100
5453,theyre,284,26280037,97.1582652305,_100,6,>100
5454,roosevelt,283,26280320,97.159311492,_100,9,>100
5455,slam,283,26280603,97.1603577534,_100,4,>100
5456,amazingly,283,26280886,97.1614040148,_100,9,>100
5457,blvd,283,26281169,97.1624502762,_100,4,>100
5458,anxious,283,26281452,97.1634965377,_100,7,>100
5459,killin,283,26281735,97.1645427991,_100,6,>100
5460,prez,283,26282018,97.1655890605,_100,4,>100
5461,vice,283,26282301,97.166635322,_100,4,>100
5462,cage,283,26282584,97.1676815834,_100,4,>100
5463,signal,282,26282866,97.1687241478,_100,6,>100
5464,un,282,26283148,97.1697667122,_100,2,>100
5465,travis,282,26283430,97.1708092766,_100,6,>100
5466,expression,282,26283712,97.171851841,_100,10,>100
5467,visits,282,26283994,97.1728944053,_100,6,>100
5468,landing,282,26284276,97.1739369697,_100,7,>100
5469,olympic,282,26284558,97.1749795341,_100,7,>100
5470,coupons,282,26284840,97.1760220985,_100,7,>100
5471,goods,282,26285122,97.1770646629,_100,5,>100
5472,independence,282,26285404,97.1781072273,_100,12,>100
5473,performed,282,26285686,97.1791497917,_100,9,>100
5474,html,282,26285968,97.1801923561,_100,4,>100
5475,depending,282,26286250,97.1812349205,_100,9,>100
5476,warming,282,26286532,97.1822774849,_100,7,>100
5477,ole,282,26286814,97.1833200493,_100,3,>100
5478,seth,281,26287095,97.1843589166,_100,4,>100
5479,mil,281,26287376,97.185397784,_100,3,>100
5480,pleasant,281,26287657,97.1864366513,_100,8,>100
5481,crunch,281,26287938,97.1874755187,_100,6,>100
5482,comm,281,26288219,97.188514386,_100,4,>100
5483,robinson,281,26288500,97.1895532534,_100,8,>100
5484,improvement,281,26288781,97.1905921207,_100,11,>100
5485,ebay,281,26289062,97.1916309881,_100,4,>100
5486,desktop,281,26289343,97.1926698555,_100,7,>100
5487,whatsoever,281,26289624,97.1937087228,_100,10,>100
5488,humanity,280,26289904,97.1947438931,_100,8,>100
5489,tricks,280,26290184,97.1957790635,_100,6,>100
5490,certificate,280,26290464,97.1968142338,_100,11,>100
5491,scares,280,26290744,97.1978494041,_100,6,>100
5492,inch,280,26291024,97.1988845744,_100,4,>100
5493,sanchez,280,26291304,97.1999197447,_100,7,>100
5494,fought,280,26291584,97.200954915,_100,6,>100
5495,balloon,280,26291864,97.2019900854,_100,7,>100
5496,shadows,280,26292144,97.2030252557,_100,7,>100
5497,pix,280,26292424,97.204060426,_100,3,>100
5498,fiesta,280,26292704,97.2050955963,_100,6,>100
5499,pointing,280,26292984,97.2061307666,_100,8,>100
5500,panda,279,26293263,97.2071622399,_100,5,>100
5501,missouri,279,26293542,97.2081937132,_100,8,>100
5502,lime,279,26293821,97.2092251865,_100,4,>100
5503,kissed,279,26294100,97.2102566598,_100,6,>100
5504,twist,279,26294379,97.211288133,_100,5,>100
5505,winds,279,26294658,97.2123196063,_100,5,>100
5506,theirs,279,26294937,97.2133510796,_100,6,>100
5507,barbara,279,26295216,97.2143825529,_100,7,>100
5508,pitches,279,26295495,97.2154140262,_100,7,>100
5509,athlete,279,26295774,97.2164454994,_100,7,>100
5510,skate,279,26296053,97.2174769727,_100,5,>100
5511,thanking,279,26296332,97.218508446,_100,8,>100
5512,banned,279,26296611,97.2195399193,_100,6,>100
5513,brazil,279,26296890,97.2205713926,_100,6,>100
5514,ratings,278,26297168,97.2215991688,_100,7,>100
5515,volleyball,278,26297446,97.2226269451,_100,10,>100
5516,artwork,278,26297724,97.2236547213,_100,7,>100
5517,cameron,278,26298002,97.2246824976,_100,7,>100
5518,producing,278,26298280,97.2257102738,_100,9,>100
5519,maurice,278,26298558,97.22673805,_100,7,>100
5520,potus,278,26298836,97.2277658263,_100,5,>100
5521,murray,278,26299114,97.2287936025,_100,6,>100
5522,grading,278,26299392,97.2298213788,_100,7,>100
5523,drummer,278,26299670,97.230849155,_100,7,>100
5524,worrying,278,26299948,97.2318769313,_100,8,>100
5525,washing,278,26300226,97.2329047075,_100,7,>100
5526,explaining,278,26300504,97.2339324838,_100,10,>100
5527,washed,278,26300782,97.23496026,_100,6,>100
5528,informative,278,26301060,97.2359880362,_100,11,>100
5529,authentic,278,26301338,97.2370158125,_100,9,>100
5530,thou,278,26301616,97.2380435887,_100,4,>100
5531,achievement,278,26301894,97.239071365,_100,11,>100
5532,jeez,278,26302172,97.2400991412,_100,4,>100
5533,psalm,277,26302449,97.2411232204,_100,5,>100
5534,commentary,277,26302726,97.2421472996,_100,10,>100
5535,tackle,277,26303003,97.2431713788,_100,6,>100
5536,starring,277,26303280,97.244195458,_100,8,>100
5537,elbow,277,26303557,97.2452195373,_100,5,>100
5538,backs,277,26303834,97.2462436165,_100,5,>100
5539,brett,277,26304111,97.2472676957,_100,5,>100
5540,watches,277,26304388,97.2482917749,_100,7,>100
5541,grove,277,26304665,97.2493158541,_100,5,>100
5542,bloggers,277,26304942,97.2503399333,_100,8,>100
5543,remaining,276,26305218,97.2513603155,_100,9,>100
5544,discounts,276,26305494,97.2523806976,_100,9,>100
5545,facing,276,26305770,97.2534010798,_100,6,>100
5546,harvard,276,26306046,97.254421462,_100,7,>100
5547,orchestra,276,26306322,97.2554418442,_100,9,>100
5548,exposure,276,26306598,97.2564622263,_100,8,>100
5549,satisfied,276,26306874,97.2574826085,_100,9,>100
5550,dialogue,276,26307150,97.2585029907,_100,8,>100
5551,nickname,276,26307426,97.2595233728,_100,8,>100
5552,instantly,276,26307702,97.260543755,_100,9,>100
5553,involve,276,26307978,97.2615641372,_100,7,>100
5554,jerseys,276,26308254,97.2625845193,_100,7,>100
5555,louder,276,26308530,97.2636049015,_100,6,>100
5556,resort,276,26308806,97.2646252837,_100,6,>100
5557,pole,275,26309081,97.2656419688,_100,4,>100
5558,mature,275,26309356,97.266658654,_100,6,>100
5559,fran,275,26309631,97.2676753391,_100,4,>100
5560,warmer,275,26309906,97.2686920242,_100,6,>100
5561,crushed,275,26310181,97.2697087094,_100,7,>100
5562,endless,275,26310456,97.2707253945,_100,7,>100
5563,default,275,26310731,97.2717420796,_100,7,>100
5564,browser,275,26311006,97.2727587648,_100,7,>100
5565,gained,275,26311281,97.2737754499,_100,6,>100
5566,latte,275,26311556,97.274792135,_100,5,>100
5567,melt,275,26311831,97.2758088202,_100,4,>100
5568,droid,275,26312106,97.2768255053,_100,5,>100
5569,communicate,274,26312380,97.2778384934,_100,11,>100
5570,motorcycle,274,26312654,97.2788514815,_100,10,>100
5571,surrounded,274,26312928,97.2798644696,_100,10,>100
5572,structure,274,26313202,97.2808774577,_100,9,>100
5573,additional,274,26313476,97.2818904458,_100,10,>100
5574,reps,274,26313750,97.2829034339,_100,4,>100
5575,elections,274,26314024,97.283916422,_100,9,>100
5576,waters,274,26314298,97.2849294101,_100,6,>100
5577,filter,274,26314572,97.2859423982,_100,6,>100
5578,tracy,274,26314846,97.2869553863,_100,5,>100
5579,spoiled,274,26315120,97.2879683744,_100,7,>100
5580,inn,273,26315393,97.2889776654,_100,3,>100
5581,reasonable,273,26315666,97.2899869565,_100,10,>100
5582,continuing,273,26315939,97.2909962475,_100,10,>100
5583,jackie,273,26316212,97.2920055386,_100,6,>100
5584,dramatic,273,26316485,97.2930148297,_100,8,>100
5585,gloves,273,26316758,97.2940241207,_100,6,>100
5586,cardinals,273,26317031,97.2950334118,_100,9,>100
5587,lesbian,273,26317304,97.2960427028,_100,7,>100
5588,mj,273,26317577,97.2970519939,_100,2,>100
5589,reputation,273,26317850,97.298061285,_100,10,>100
5590,fart,273,26318123,97.299070576,_100,4,>100
5591,transition,273,26318396,97.3000798671,_100,10,>100
5592,experiment,272,26318668,97.3010854611,_100,10,>100
5593,derrick,272,26318940,97.3020910551,_100,7,>100
5594,technically,272,26319212,97.3030966492,_100,11,>100
5595,donating,272,26319484,97.3041022432,_100,8,>100
5596,interface,272,26319756,97.3051078372,_100,9,>100
5597,jacob,272,26320028,97.3061134312,_100,5,>100
5598,depth,272,26320300,97.3071190253,_100,5,>100
5599,scoop,272,26320572,97.3081246193,_100,5,>100
5600,mango,272,26320844,97.3091302133,_100,5,>100
5601,andre,272,26321116,97.3101358073,_100,5,>100
5602,sheets,272,26321388,97.3111414013,_100,6,>100
5603,suits,272,26321660,97.3121469954,_100,5,>100
5604,bartender,272,26321932,97.3131525894,_100,9,>100
5605,poppin,271,26322203,97.3141544864,_100,6,>100
5606,mentor,271,26322474,97.3151563834,_100,6,>100
5607,productivity,271,26322745,97.3161582804,_100,12,>100
5608,collect,271,26323016,97.3171601773,_100,7,>100
5609,responded,271,26323287,97.3181620743,_100,9,>100
5610,tempted,271,26323558,97.3191639713,_100,7,>100
5611,gathering,270,26323828,97.3201621713,_100,9,>100
5612,successfully,270,26324098,97.3211603712,_100,12,>100
5613,goo,270,26324368,97.3221585712,_100,3,>100
5614,charging,270,26324638,97.3231567711,_100,8,>100
5615,candle,270,26324908,97.3241549711,_100,6,>100
5616,syracuse,270,26325178,97.325153171,_100,8,>100
5617,bandwagon,270,26325448,97.326151371,_100,9,>100
5618,nye,270,26325718,97.3271495709,_100,3,>100
5619,skirt,270,26325988,97.3281477709,_100,5,>100
5620,mahomie,270,26326258,97.3291459708,_100,7,>100
5621,copyright,270,26326528,97.3301441708,_100,9,>100
5622,approaching,270,26326798,97.3311423707,_100,11,>100
5623,channels,270,26327068,97.3321405707,_100,8,>100
5624,string,270,26327338,97.3331387706,_100,6,>100
5625,brief,269,26327607,97.3341332735,_100,5,>100
5626,sh,269,26327876,97.3351277764,_100,2,>100
5627,skies,269,26328145,97.3361222793,_100,5,>100
5628,eva,269,26328414,97.3371167823,_100,3,>100
5629,alaska,269,26328683,97.3381112852,_100,6,>100
5630,thoughtful,269,26328952,97.3391057881,_100,10,>100
5631,blazers,269,26329221,97.340100291,_100,7,>100
5632,annoy,269,26329490,97.3410947939,_100,5,>100
5633,solved,268,26329758,97.3420855998,_100,6,>100
5634,submissions,268,26330026,97.3430764057,_100,11,>100
5635,chilly,268,26330294,97.3440672115,_100,6,>100
5636,daylight,268,26330562,97.3450580174,_100,8,>100
5637,leather,268,26330830,97.3460488233,_100,7,>100
5638,starter,268,26331098,97.3470396292,_100,7,>100
5639,uhh,268,26331366,97.348030435,_100,3,>100
5640,zach,268,26331634,97.3490212409,_100,4,>100
5641,campbell,268,26331902,97.3500120468,_100,8,>100
5642,reflect,268,26332170,97.3510028527,_100,7,>100
5643,wrist,268,26332438,97.3519936585,_100,5,>100
5644,retired,268,26332706,97.3529844644,_100,7,>100
5645,phillips,267,26332973,97.3539715733,_100,8,>100
5646,cardio,267,26333240,97.3549586821,_100,6,>100
5647,troops,267,26333507,97.3559457909,_100,6,>100
5648,stupidity,267,26333774,97.3569328998,_100,9,>100
5649,developers,267,26334041,97.3579200086,_100,10,>100
5650,bahaha,267,26334308,97.3589071175,_100,6,>100
5651,bells,267,26334575,97.3598942263,_100,5,>100
5652,hudson,267,26334842,97.3608813351,_100,6,>100
5653,preparation,267,26335109,97.361868444,_100,11,>100
5654,gut,267,26335376,97.3628555528,_100,3,>100
5655,thursdays,267,26335643,97.3638426617,_100,9,>100
5656,hike,267,26335910,97.3648297705,_100,4,>100
5657,secure,267,26336177,97.3658168793,_100,6,>100
5658,beatles,267,26336444,97.3668039882,_100,7,>100
5659,contribute,266,26336710,97.3677874,_100,10,>100
5660,feeding,266,26336976,97.3687708118,_100,7,>100
5661,ireland,266,26337242,97.3697542236,_100,7,>100
5662,velvet,266,26337508,97.3707376354,_100,6,>100
5663,havin,266,26337774,97.3717210472,_100,5,>100
5664,intended,266,26338040,97.372704459,_100,8,>100
5665,loans,266,26338306,97.3736878708,_100,5,>100
5666,surprises,266,26338572,97.3746712826,_100,9,>100
5667,writes,266,26338838,97.3756546944,_100,6,>100
5668,entering,266,26339104,97.3766381062,_100,8,>100
5669,gaming,266,26339370,97.377621518,_100,6,>100
5670,needing,266,26339636,97.3786049298,_100,7,>100
5671,vet,265,26339901,97.3795846446,_100,3,>100
5672,christina,265,26340166,97.3805643593,_100,9,>100
5673,mountains,265,26340431,97.3815440741,_100,9,>100
5674,marc,265,26340696,97.3825237889,_100,4,>100
5675,cape,265,26340961,97.3835035036,_100,4,>100
5676,coworkers,265,26341226,97.3844832184,_100,9,>100
5677,sponsored,265,26341491,97.3854629332,_100,9,>100
5678,edward,265,26341756,97.3864426479,_100,6,>100
5679,whack,265,26342021,97.3874223627,_100,5,>100
5680,chemistry,265,26342286,97.3884020775,_100,9,>100
5681,nut,265,26342551,97.3893817922,_100,3,>100
5682,spotify,265,26342816,97.390361507,_100,7,>100
5683,proposed,265,26343081,97.3913412218,_100,8,>100
5684,gentleman,264,26343345,97.3923172395,_100,9,>100
5685,torture,264,26343609,97.3932932572,_100,7,>100
5686,physically,264,26343873,97.3942692749,_100,10,>100
5687,pearl,264,26344137,97.3952452927,_100,5,>100
5688,ali,264,26344401,97.3962213104,_100,3,>100
5689,applying,264,26344665,97.3971973281,_100,8,>100
5690,domestic,264,26344929,97.3981733459,_100,8,>100
5691,occasion,264,26345193,97.3991493636,_100,8,>100
5692,recover,264,26345457,97.4001253813,_100,7,>100
5693,maps,264,26345721,97.401101399,_100,4,>100
5694,matching,264,26345985,97.4020774168,_100,8,>100
5695,politicians,264,26346249,97.4030534345,_100,11,>100
5696,comparison,264,26346513,97.4040294522,_100,10,>100
5697,nominated,263,26346776,97.4050017729,_100,9,>100
5698,skool,263,26347039,97.4059740936,_100,5,>100
5699,britney,263,26347302,97.4069464143,_100,7,>100
5700,glenn,263,26347565,97.407918735,_100,5,>100
5701,zayn,263,26347828,97.4088910557,_100,4,>100
5702,abq,263,26348091,97.4098633764,_100,3,>100
5703,pitt,263,26348354,97.4108356971,_100,4,>100
5704,equally,263,26348617,97.4118080178,_100,7,>100
5705,stickers,263,26348880,97.4127803384,_100,8,>100
5706,collections,263,26349143,97.4137526591,_100,11,>100
5707,disco,263,26349406,97.4147249798,_100,5,>100
5708,causing,263,26349669,97.4156973005,_100,7,>100
5709,experiencing,263,26349932,97.4166696212,_100,12,>100
5710,trained,262,26350194,97.4176382449,_100,7,>100
5711,sheesh,262,26350456,97.4186068685,_100,6,>100
5712,pts,262,26350718,97.4195754922,_100,3,>100
5713,touring,262,26350980,97.4205441158,_100,7,>100
5714,discussions,262,26351242,97.4215127395,_100,11,>100
5715,mls,262,26351504,97.4224813631,_100,3,>100
5716,forces,262,26351766,97.4234499868,_100,6,>100
5717,demi,262,26352028,97.4244186105,_100,4,>100
5718,secretly,262,26352290,97.4253872341,_100,8,>100
5719,api,262,26352552,97.4263558578,_100,3,>100
5720,franchise,262,26352814,97.4273244814,_100,9,>100
5721,sidewalk,262,26353076,97.4282931051,_100,8,>100
5722,costumes,262,26353338,97.4292617287,_100,8,>100
5723,mars,262,26353600,97.4302303524,_100,4,>100
5724,efficient,262,26353862,97.431198976,_100,9,>100
5725,cent,262,26354124,97.4321675997,_100,4,>100
5726,ik,261,26354385,97.4331325263,_100,2,>100
5727,emma,261,26354646,97.4340974529,_100,4,>100
5728,korean,261,26354907,97.4350623795,_100,6,>100
5729,npr,261,26355168,97.4360273062,_100,3,>100
5730,wireless,261,26355429,97.4369922328,_100,8,>100
5731,someones,261,26355690,97.4379571594,_100,8,>100
5732,mug,261,26355951,97.438922086,_100,3,>100
5733,explanation,261,26356212,97.4398870126,_100,11,>100
5734,whites,261,26356473,97.4408519393,_100,6,>100
5735,championships,261,26356734,97.4418168659,_100,13,>100
5736,saturdays,261,26356995,97.4427817925,_100,9,>100
5737,vincent,261,26357256,97.4437467191,_100,7,>100
5738,wht,261,26357517,97.4447116457,_100,3,>100
5739,fellas,261,26357778,97.4456765723,_100,6,>100
5740,reverse,260,26358038,97.4466378019,_100,7,>100
5741,pockets,260,26358298,97.4475990315,_100,7,>100
5742,hannah,260,26358558,97.4485602611,_100,6,>100
5743,umbrella,260,26358818,97.4495214907,_100,8,>100
5744,alice,260,26359078,97.4504827203,_100,5,>100
5745,fitting,260,26359338,97.4514439498,_100,7,>100
5746,rotation,260,26359598,97.4524051794,_100,8,>100
5747,grandpa,260,26359858,97.453366409,_100,7,>100
5748,invites,260,26360118,97.4543276386,_100,7,>100
5749,shouldnt,260,26360378,97.4552888682,_100,8,>100
5750,grinding,260,26360638,97.4562500977,_100,8,>100
5751,comfy,260,26360898,97.4572113273,_100,5,>100
5752,helmet,260,26361158,97.4581725569,_100,6,>100
5753,pi,260,26361418,97.4591337865,_100,2,>100
5754,tablet,260,26361678,97.4600950161,_100,6,>100
5755,jb,259,26361937,97.4610525486,_100,2,>100
5756,organize,259,26362196,97.4620100812,_100,8,>100
5757,brownies,259,26362455,97.4629676137,_100,8,>100
5758,involves,259,26362714,97.4639251462,_100,8,>100
5759,collective,259,26362973,97.4648826788,_100,10,>100
5760,yourselves,259,26363232,97.4658402113,_100,10,>100
5761,ucla,259,26363491,97.4667977439,_100,4,>100
5762,objects,259,26363750,97.4677552764,_100,7,>100
5763,rebecca,259,26364009,97.468712809,_100,7,>100
5764,nutella,259,26364268,97.4696703415,_100,7,>100
5765,encouragement,259,26364527,97.4706278741,_100,13,>100
5766,chad,259,26364786,97.4715854066,_100,4,>100
5767,colleague,259,26365045,97.4725429391,_100,9,>100
5768,sa,259,26365304,97.4735004717,_100,2,>100
5769,breeze,259,26365563,97.4744580042,_100,6,>100
5770,tonights,258,26365821,97.4754118397,_100,8,>100
5771,wallace,258,26366079,97.4763656752,_100,7,>100
5772,highway,258,26366337,97.4773195108,_100,7,>100
5773,attacks,258,26366595,97.4782733463,_100,7,>100
5774,confusion,258,26366853,97.4792271818,_100,9,>100
5775,tapped,258,26367111,97.4801810173,_100,6,>100
5776,mocha,258,26367369,97.4811348528,_100,5,>100
5777,globe,258,26367627,97.4820886883,_100,5,>100
5778,bedtime,258,26367885,97.4830425238,_100,7,>100
5779,korea,258,26368143,97.4839963593,_100,5,>100
5780,ab,258,26368401,97.4849501948,_100,2,>100
5781,molly,258,26368659,97.4859040303,_100,5,>100
5782,beings,258,26368917,97.4868578658,_100,6,>100
5783,identify,257,26369174,97.4878080043,_100,8,>100
5784,tags,257,26369431,97.4887581428,_100,4,>100
5785,phillip,257,26369688,97.4897082812,_100,7,>100
5786,philosophy,257,26369945,97.4906584197,_100,10,>100
5787,worms,257,26370202,97.4916085582,_100,5,>100
5788,meaningful,257,26370459,97.4925586967,_100,10,>100
5789,disappoint,257,26370716,97.4935088351,_100,10,>100
5790,robot,257,26370973,97.4944589736,_100,5,>100
5791,ribs,257,26371230,97.4954091121,_100,4,>100
5792,stalker,257,26371487,97.4963592505,_100,7,>100
5793,parked,257,26371744,97.497309389,_100,6,>100
5794,stepping,257,26372001,97.4982595275,_100,8,>100
5795,melo,257,26372258,97.4992096659,_100,4,>100
5796,runner,257,26372515,97.5001598044,_100,6,>100
5797,encouraging,256,26372771,97.5011062459,_100,11,>100
5798,pricing,256,26373027,97.5020526873,_100,7,>100
5799,loyalty,256,26373283,97.5029991287,_100,7,>100
5800,nicer,256,26373539,97.5039455702,_100,5,>100
5801,mailing,256,26373795,97.5048920116,_100,7,>100
5802,survivor,256,26374051,97.505838453,_100,8,>100
5803,reveal,255,26374306,97.5067811974,_100,6,>100
5804,aggressive,255,26374561,97.5077239418,_100,10,>100
5805,reggie,255,26374816,97.5086666862,_100,6,>100
5806,recovering,255,26375071,97.5096094306,_100,10,>100
5807,merch,255,26375326,97.510552175,_100,5,>100
5808,graduates,255,26375581,97.5114949194,_100,9,>100
5809,catalog,255,26375836,97.5124376638,_100,7,>100
5810,contain,255,26376091,97.5133804082,_100,7,>100
5811,pierce,255,26376346,97.5143231526,_100,6,>100
5812,badgers,255,26376601,97.515265897,_100,7,>100
5813,fade,255,26376856,97.5162086414,_100,4,>100
5814,bingo,255,26377111,97.5171513858,_100,5,>100
5815,yer,255,26377366,97.5180941302,_100,3,>100
5816,ruining,255,26377621,97.5190368746,_100,7,>100
5817,liar,255,26377876,97.519979619,_100,4,>100
5818,autograph,255,26378131,97.5209223634,_100,9,>100
5819,watson,254,26378385,97.5218614107,_100,6,>100
5820,wells,254,26378639,97.5228004581,_100,5,>100
5821,moral,254,26378893,97.5237395055,_100,5,>100
5822,clips,254,26379147,97.5246785528,_100,5,>100
5823,cds,254,26379401,97.5256176002,_100,3,>100
5824,flick,254,26379655,97.5265566475,_100,5,>100
5825,flawless,254,26379909,97.5274956949,_100,8,>100
5826,gomez,254,26380163,97.5284347423,_100,5,>100
5827,crowded,254,26380417,97.5293737896,_100,7,>100
5828,gb,254,26380671,97.530312837,_100,2,>100
5829,irony,254,26380925,97.5312518843,_100,5,>100
5830,domain,254,26381179,97.5321909317,_100,6,>100
5831,rocky,254,26381433,97.5331299791,_100,5,>100
5832,servers,254,26381687,97.5340690264,_100,7,>100
5833,capture,253,26381940,97.5350043767,_100,7,>100
5834,reds,253,26382193,97.5359397271,_100,4,>100
5835,delta,253,26382446,97.5368750774,_100,5,>100
5836,homies,253,26382699,97.5378104277,_100,6,>100
5837,laden,253,26382952,97.538745778,_100,5,>100
5838,aids,253,26383205,97.5396811284,_100,4,>100
5839,nerve,253,26383458,97.5406164787,_100,5,>100
5840,troy,253,26383711,97.541551829,_100,4,>100
5841,dems,253,26383964,97.5424871793,_100,4,>100
5842,bon,253,26384217,97.5434225296,_100,3,>100
5843,elvis,253,26384470,97.54435788,_100,5,>100
5844,sheet,253,26384723,97.5452932303,_100,5,>100
5845,representing,253,26384976,97.5462285806,_100,12,>100
5846,victoria,253,26385229,97.5471639309,_100,8,>100
5847,sara,253,26385482,97.5480992813,_100,4,>100
5848,authority,252,26385734,97.5490309345,_100,9,>100
5849,dive,252,26385986,97.5499625878,_100,4,>100
5850,brick,252,26386238,97.5508942411,_100,5,>100
5851,disturbing,252,26386490,97.5518258944,_100,10,>100
5852,depression,252,26386742,97.5527575477,_100,10,>100
5853,sorta,252,26386994,97.553689201,_100,5,>100
5854,thesis,252,26387246,97.5546208543,_100,6,>100
5855,taxi,252,26387498,97.5555525076,_100,4,>100
5856,modeling,252,26387750,97.5564841608,_100,8,>100
5857,comics,252,26388002,97.5574158141,_100,6,>100
5858,faded,252,26388254,97.5583474674,_100,5,>100
5859,originally,252,26388506,97.5592791207,_100,10,>100
5860,loads,252,26388758,97.560210774,_100,5,>100
5861,danger,251,26389009,97.5611387302,_100,6,>100
5862,tomatoes,251,26389260,97.5620666865,_100,8,>100
5863,exec,251,26389511,97.5629946427,_100,4,>100
5864,screens,251,26389762,97.563922599,_100,7,>100
5865,amber,251,26390013,97.5648505552,_100,5,>100
5866,unhappy,251,26390264,97.5657785115,_100,7,>100
5867,minimum,251,26390515,97.5667064677,_100,7,>100
5868,rant,251,26390766,97.567634424,_100,4,>100
5869,ought,251,26391017,97.5685623802,_100,5,>100
5870,reflection,251,26391268,97.5694903365,_100,10,>100
5871,wana,251,26391519,97.5704182927,_100,4,>100
5872,equivalent,251,26391770,97.571346249,_100,10,>100
5873,gigs,251,26392021,97.5722742052,_100,4,>100
5874,circles,251,26392272,97.5732021615,_100,7,>100
5875,delightful,251,26392523,97.5741301177,_100,10,>100
5876,internal,251,26392774,97.575058074,_100,8,>100
5877,dodgers,251,26393025,97.5759860302,_100,7,>100
5878,worker,251,26393276,97.5769139865,_100,6,>100
5879,mason,251,26393527,97.5778419427,_100,5,>100
5880,invitation,251,26393778,97.578769899,_100,10,>100
5881,hardcore,250,26394028,97.5796941582,_100,8,>100
5882,erin,250,26394278,97.5806184174,_100,4,>100
5883,entrepreneurs,250,26394528,97.5815426766,_100,13,>100
5884,slick,250,26394778,97.5824669358,_100,5,>100
5885,hack,250,26395028,97.583391195,_100,4,>100
5886,hulk,250,26395278,97.5843154543,_100,4,>100
5887,ensure,250,26395528,97.5852397135,_100,6,>100
5888,rays,250,26395778,97.5861639727,_100,4,>100
5889,settings,250,26396028,97.5870882319,_100,8,>100
5890,ily,250,26396278,97.5880124911,_100,3,>100
5891,hoop,250,26396528,97.5889367503,_100,4,>100
5892,fate,250,26396778,97.5898610095,_100,4,>100
5893,happily,250,26397028,97.5907852687,_100,7,>100
5894,250,250,26397278,97.591709528,_100,3,>100
5895,ballot,250,26397528,97.5926337872,_100,6,>100
5896,catholic,249,26397777,97.5935543493,_100,8,>100
5897,crashed,249,26398026,97.5944749115,_100,7,>100
5898,corp,249,26398275,97.5953954737,_100,4,>100
5899,beg,249,26398524,97.5963160359,_100,3,>100
5900,charm,249,26398773,97.597236598,_100,5,>100
5901,integrity,249,26399022,97.5981571602,_100,9,>100
5902,eyebrows,249,26399271,97.5990777224,_100,8,>100
5903,chairs,249,26399520,97.5999982846,_100,6,>100
5904,guaranteed,249,26399769,97.6009188468,_100,10,>100
5905,oscars,249,26400018,97.6018394089,_100,6,>100
5906,abraham,249,26400267,97.6027599711,_100,7,>100
5907,shorter,249,26400516,97.6036805333,_100,7,>100
5908,civic,249,26400765,97.6046010955,_100,5,>100
5909,nxt,249,26401014,97.6055216576,_100,3,>100
5910,fairy,249,26401263,97.6064422198,_100,5,>100
5911,envy,248,26401511,97.6073590849,_100,4,>100
5912,painted,248,26401759,97.6082759501,_100,7,>100
5913,cotto,248,26402007,97.6091928152,_100,5,>100
5914,ufc,248,26402255,97.6101096804,_100,3,>100
5915,downstairs,248,26402503,97.6110265455,_100,10,>100
5916,sorts,248,26402751,97.6119434106,_100,5,>100
5917,rat,248,26402999,97.6128602758,_100,3,>100
5918,ricky,248,26403247,97.6137771409,_100,5,>100
5919,nowadays,248,26403495,97.6146940061,_100,8,>100
5920,strategic,248,26403743,97.6156108712,_100,9,>100
5921,messy,248,26403991,97.6165277363,_100,5,>100
5922,recognition,248,26404239,97.6174446015,_100,11,>100
5923,handy,248,26404487,97.6183614666,_100,5,>100
5924,inviting,247,26404734,97.6192746347,_100,8,>100
5925,dwight,247,26404981,97.6201878028,_100,6,>100
5926,marcus,247,26405228,97.6211009709,_100,6,>100
5927,replies,247,26405475,97.622014139,_100,7,>100
5928,failures,247,26405722,97.6229273071,_100,8,>100
5929,joan,247,26405969,97.6238404752,_100,4,>100
5930,publish,247,26406216,97.6247536433,_100,7,>100
5931,calendars,247,26406463,97.6256668114,_100,9,>100
5932,graphics,247,26406710,97.6265799795,_100,8,>100
5933,uploaded,247,26406957,97.6274931476,_100,8,>100
5934,pulls,247,26407204,97.6284063157,_100,5,>100
5935,liberal,247,26407451,97.6293194838,_100,7,>100
5936,charts,246,26407697,97.6302289549,_100,6,>100
5937,virus,246,26407943,97.631138426,_100,5,>100
5938,heather,246,26408189,97.632047897,_100,7,>100
5939,venture,246,26408435,97.6329573681,_100,7,>100
5940,typo,246,26408681,97.6338668392,_100,4,>100
5941,wikipedia,246,26408927,97.6347763102,_100,9,>100
5942,bullpen,246,26409173,97.6356857813,_100,7,>100
5943,tested,246,26409419,97.6365952524,_100,6,>100
5944,increases,246,26409665,97.6375047234,_100,9,>100
5945,importantly,246,26409911,97.6384141945,_100,11,>100
5946,consistently,246,26410157,97.6393236656,_100,12,>100
5947,figures,246,26410403,97.6402331366,_100,7,>100
5948,settled,245,26410648,97.6411389107,_100,7,>100
5949,privilege,245,26410893,97.6420446847,_100,9,>100
5950,bryant,245,26411138,97.6429504587,_100,6,>100
5951,bizarre,245,26411383,97.6438562327,_100,7,>100
5952,kardashian,245,26411628,97.6447620068,_100,10,>100
5953,unfollowing,245,26411873,97.6456677808,_100,11,>100
5954,dennis,245,26412118,97.6465735548,_100,6,>100
5955,pad,245,26412363,97.6474793289,_100,3,>100
5956,mississippi,245,26412608,97.6483851029,_100,11,>100
5957,tt,245,26412853,97.6492908769,_100,2,>100
5958,freeze,245,26413098,97.6501966509,_100,6,>100
5959,ridiculously,245,26413343,97.651102425,_100,12,>100
5960,beyonce,245,26413588,97.652008199,_100,7,>100
5961,depend,245,26413833,97.652913973,_100,6,>100
5962,montana,245,26414078,97.653819747,_100,7,>100
5963,cruz,245,26414323,97.6547255211,_100,4,>100
5964,bases,244,26414567,97.6556275981,_100,5,>100
5965,ingredients,244,26414811,97.6565296751,_100,11,>100
5966,syrup,244,26415055,97.6574317521,_100,5,>100
5967,uhm,244,26415299,97.658333829,_100,3,>100
5968,rounds,244,26415543,97.659235906,_100,6,>100
5969,gal,244,26415787,97.660137983,_100,3,>100
5970,monitor,244,26416031,97.66104006,_100,7,>100
5971,cray,244,26416275,97.661942137,_100,4,>100
5972,nat,244,26416519,97.662844214,_100,3,>100
5973,orioles,244,26416763,97.663746291,_100,7,>100
5974,graders,244,26417007,97.664648368,_100,7,>100
5975,siri,244,26417251,97.665550445,_100,4,>100
5976,von,244,26417495,97.666452522,_100,3,>100
5977,opposed,244,26417739,97.667354599,_100,7,>100
5978,trophy,244,26417983,97.668256676,_100,6,>100
5979,freaked,243,26418226,97.6691550559,_100,7,>100
5980,sharks,243,26418469,97.6700534359,_100,6,>100
5981,steady,243,26418712,97.6709518158,_100,6,>100
5982,buys,243,26418955,97.6718501958,_100,4,>100
5983,sells,243,26419198,97.6727485757,_100,5,>100
5984,unemployment,243,26419441,97.6736469557,_100,12,>100
5985,yearbook,243,26419684,97.6745453356,_100,8,>100
5986,blogger,243,26419927,97.6754437156,_100,7,>100
5987,pitchers,243,26420170,97.6763420955,_100,8,>100
5988,spectacular,243,26420413,97.6772404755,_100,11,>100
5989,momentum,243,26420656,97.6781388555,_100,8,>100
5990,bananas,243,26420899,97.6790372354,_100,7,>100
5991,sits,243,26421142,97.6799356154,_100,4,>100
5992,waves,243,26421385,97.6808339953,_100,5,>100
5993,clap,243,26421628,97.6817323753,_100,4,>100
5994,ariana,243,26421871,97.6826307552,_100,6,>100
5995,existing,242,26422113,97.6835254381,_100,8,>100
5996,tube,242,26422355,97.6844201211,_100,4,>100
5997,integration,242,26422597,97.685314804,_100,11,>100
5998,payment,242,26422839,97.6862094869,_100,7,>100
5999,cheesy,242,26423081,97.6871041698,_100,6,>100
6000,mph,242,26423323,97.6879988527,_100,3,>100
6001,festivities,242,26423565,97.6888935357,_100,11,>100
6002,legends,242,26423807,97.6897882186,_100,7,>100
6003,figuring,241,26424048,97.6906792045,_100,8,>100
6004,initial,241,26424289,97.6915701903,_100,7,>100
6005,consumers,241,26424530,97.6924611762,_100,9,>100
6006,abs,241,26424771,97.6933521621,_100,3,>100
6007,foo,241,26425012,97.694243148,_100,3,>100
6008,compliments,241,26425253,97.6951341339,_100,11,>100
6009,wellness,241,26425494,97.6960251197,_100,8,>100
6010,pisses,241,26425735,97.6969161056,_100,6,>100
6011,jonas,240,26425975,97.6978033945,_100,5,>100
6012,electronic,240,26426215,97.6986906833,_100,10,>100
6013,dew,240,26426455,97.6995779722,_100,3,>100
6014,wack,240,26426695,97.700465261,_100,4,>100
6015,raffle,240,26426935,97.7013525498,_100,6,>100
6016,roles,240,26427175,97.7022398387,_100,5,>100
6017,awsome,240,26427415,97.7031271275,_100,6,>100
6018,onions,240,26427655,97.7040144164,_100,6,>100
6019,pill,240,26427895,97.7049017052,_100,4,>100
6020,sponsoring,240,26428135,97.7057889941,_100,10,>100
6021,tent,240,26428375,97.7066762829,_100,4,>100
6022,improving,240,26428615,97.7075635718,_100,9,>100
6023,maple,240,26428855,97.7084508606,_100,5,>100
6024,nun,240,26429095,97.7093381494,_100,3,>100
6025,ie,240,26429335,97.7102254383,_100,2,>100
6026,atlantic,240,26429575,97.7111127271,_100,8,>100
6027,oatmeal,240,26429815,97.712000016,_100,7,>100
6028,pursue,240,26430055,97.7128873048,_100,6,>100
6029,convenient,239,26430294,97.7137708966,_100,10,>100
6030,layout,239,26430533,97.7146544884,_100,6,>100
6031,accomplishment,239,26430772,97.7155380802,_100,14,>100
6032,shaw,239,26431011,97.716421672,_100,4,>100
6033,barack,239,26431250,97.7173052639,_100,6,>100
6034,unnecessary,239,26431489,97.7181888557,_100,11,>100
6035,warner,239,26431728,97.7190724475,_100,6,>100
6036,curry,239,26431967,97.7199560393,_100,5,>100
6037,cheated,239,26432206,97.7208396311,_100,7,>100
6038,inspires,239,26432445,97.7217232229,_100,8,>100
6039,ala,238,26432683,97.7226031177,_100,3,>100
6040,cartoon,238,26432921,97.7234830124,_100,7,>100
6041,celebrities,238,26433159,97.7243629072,_100,11,>100
6042,packages,238,26433397,97.725242802,_100,8,>100
6043,rack,238,26433635,97.7261226967,_100,4,>100
6044,alum,238,26433873,97.7270025915,_100,4,>100
6045,object,238,26434111,97.7278824863,_100,6,>100
6046,teenager,238,26434349,97.7287623811,_100,8,>100
6047,sarcasm,238,26434587,97.7296422758,_100,7,>100
6048,legendary,238,26434825,97.7305221706,_100,9,>100
6049,popping,238,26435063,97.7314020654,_100,7,>100
6050,bully,238,26435301,97.7322819601,_100,5,>100
6051,portion,238,26435539,97.7331618549,_100,7,>100
6052,ip,238,26435777,97.7340417497,_100,2,>100
6053,dmv,238,26436015,97.7349216444,_100,3,>100
6054,loll,238,26436253,97.7358015392,_100,4,>100
6055,introducing,237,26436490,97.736677737,_100,11,>100
6056,mar,237,26436727,97.7375539347,_100,3,>100
6057,irrelevant,237,26436964,97.7384301324,_100,10,>100
6058,trains,237,26437201,97.7393063302,_100,6,>100
6059,aboard,237,26437438,97.7401825279,_100,6,>100
6060,mat,237,26437675,97.7410587256,_100,3,>100
6061,gap,237,26437912,97.7419349234,_100,3,>100
6062,discipline,237,26438149,97.7428111211,_100,10,>100
6063,blocking,237,26438386,97.7436873188,_100,8,>100
6064,manchester,237,26438623,97.7445635166,_100,10,>100
6065,flowing,237,26438860,97.7454397143,_100,7,>100
6066,prints,236,26439096,97.746312215,_100,6,>100
6067,overwhelming,236,26439332,97.7471847157,_100,12,>100
6068,packer,236,26439568,97.7480572164,_100,6,>100
6069,proves,236,26439804,97.7489297171,_100,6,>100
6070,lucas,236,26440040,97.7498022178,_100,5,>100
6071,losers,236,26440276,97.7506747185,_100,6,>100
6072,noah,236,26440512,97.7515472192,_100,4,>100
6073,favs,236,26440748,97.7524197199,_100,4,>100
6074,sizes,236,26440984,97.7532922206,_100,5,>100
6075,porter,236,26441220,97.7541647213,_100,6,>100
6076,os,236,26441456,97.755037222,_100,2,>100
6077,signature,236,26441692,97.7559097226,_100,9,>100
6078,regrets,236,26441928,97.7567822233,_100,7,>100
6079,downloading,236,26442164,97.757654724,_100,11,>100
6080,fundraising,236,26442400,97.7585272247,_100,11,>100
6081,courtney,236,26442636,97.7593997254,_100,8,>100
6082,tires,235,26442871,97.7602685291,_100,5,>100
6083,lighter,235,26443106,97.7611373328,_100,7,>100
6084,remembers,235,26443341,97.7620061364,_100,9,>100
6085,usage,235,26443576,97.7628749401,_100,5,>100
6086,discussed,235,26443811,97.7637437437,_100,9,>100
6087,dose,235,26444046,97.7646125474,_100,4,>100
6088,teenage,235,26444281,97.7654813511,_100,7,>100
6089,ova,235,26444516,97.7663501547,_100,3,>100
6090,cruel,235,26444751,97.7672189584,_100,5,>100
6091,donut,235,26444986,97.768087762,_100,5,>100
6092,dull,235,26445221,97.7689565657,_100,4,>100
6093,jams,234,26445455,97.7698216723,_100,4,>100
6094,dough,234,26445689,97.7706867789,_100,5,>100
6095,dye,234,26445923,97.7715518856,_100,3,>100
6096,grandmother,234,26446157,97.7724169922,_100,11,>100
6097,subscription,234,26446391,97.7732820988,_100,12,>100
6098,takin,234,26446625,97.7741472054,_100,5,>100
6099,shawn,234,26446859,97.7750123121,_100,5,>100
6100,corey,234,26447093,97.7758774187,_100,5,>100
6101,hotter,234,26447327,97.7767425253,_100,6,>100
6102,collecting,234,26447561,97.7776076319,_100,10,>100
6103,overwhelmed,234,26447795,97.7784727385,_100,11,>100
6104,teddy,234,26448029,97.7793378452,_100,5,>100
6105,rb,234,26448263,97.7802029518,_100,2,>100
6106,fewer,234,26448497,97.7810680584,_100,5,>100
6107,anatomy,233,26448730,97.781929468,_100,7,>100
6108,mm,233,26448963,97.7827908776,_100,2,>100
6109,thumb,233,26449196,97.7836522872,_100,5,>100
6110,faves,233,26449429,97.7845136968,_100,5,>100
6111,polls,233,26449662,97.7853751063,_100,5,>100
6112,immediate,233,26449895,97.7862365159,_100,9,>100
6113,valid,233,26450128,97.7870979255,_100,5,>100
6114,casual,233,26450361,97.7879593351,_100,6,>100
6115,salary,233,26450594,97.7888207447,_100,6,>100
6116,naps,233,26450827,97.7896821543,_100,4,>100
6117,que,233,26451060,97.7905435639,_100,3,>100
6118,penguins,233,26451293,97.7914049735,_100,8,>100
6119,mainly,233,26451526,97.792266383,_100,6,>100
6120,memorable,233,26451759,97.7931277926,_100,9,>100
6121,weapon,232,26451991,97.7939855052,_100,6,>100
6122,shelf,232,26452223,97.7948432177,_100,5,>100
6123,cinema,232,26452455,97.7957009303,_100,6,>100
6124,rely,232,26452687,97.7965586428,_100,4,>100
6125,react,232,26452919,97.7974163554,_100,5,>100
6126,graham,232,26453151,97.7982740679,_100,6,>100
6127,expanding,232,26453383,97.7991317805,_100,9,>100
6128,strawberries,232,26453615,97.799989493,_100,12,>100
6129,errands,232,26453847,97.8008472056,_100,7,>100
6130,feeds,232,26454079,97.8017049181,_100,5,>100
6131,honesty,232,26454311,97.8025626307,_100,7,>100
6132,helen,232,26454543,97.8034203432,_100,5,>100
6133,fr,232,26454775,97.8042780558,_100,2,>100
6134,beverly,232,26455007,97.8051357683,_100,7,>100
6135,command,232,26455239,97.8059934809,_100,7,>100
6136,wee,232,26455471,97.8068511934,_100,3,>100
6137,branding,231,26455702,97.8077052089,_100,8,>100
6138,sync,231,26455933,97.8085592244,_100,4,>100
6139,ultra,231,26456164,97.80941324,_100,5,>100
6140,cos,231,26456395,97.8102672555,_100,3,>100
6141,brag,231,26456626,97.811121271,_100,4,>100
6142,tragic,231,26456857,97.8119752865,_100,6,>100
6143,gentlemen,231,26457088,97.812829302,_100,9,>100
6144,beliefs,231,26457319,97.8136833175,_100,7,>100
6145,educated,231,26457550,97.814537333,_100,8,>100
6146,strategies,231,26457781,97.8153913485,_100,10,>100
6147,mikey,231,26458012,97.8162453641,_100,5,>100
6148,rivers,231,26458243,97.8170993796,_100,6,>100
6149,offline,231,26458474,97.8179533951,_100,7,>100
6150,risks,231,26458705,97.8188074106,_100,5,>100
6151,batch,231,26458936,97.8196614261,_100,5,>100
6152,collab,230,26459166,97.8205117446,_100,6,>100
6153,tuesdays,230,26459396,97.8213620631,_100,8,>100
6154,edu,230,26459626,97.8222123815,_100,3,>100
6155,filmed,230,26459856,97.8230627,_100,6,>100
6156,disappointment,230,26460086,97.8239130185,_100,14,>100
6157,chop,230,26460316,97.824763337,_100,4,>100
6158,attacked,230,26460546,97.8256136554,_100,8,>100
6159,juan,230,26460776,97.8264639739,_100,4,>100
6160,reporters,230,26461006,97.8273142924,_100,9,>100
6161,singles,230,26461236,97.8281646109,_100,7,>100
6162,twit,230,26461466,97.8290149293,_100,4,>100
6163,shell,229,26461695,97.8298615508,_100,5,>100
6164,arthur,229,26461924,97.8307081722,_100,6,>100
6165,uniforms,229,26462153,97.8315547937,_100,8,>100
6166,horny,229,26462382,97.8324014151,_100,5,>100
6167,vegetarian,229,26462611,97.8332480365,_100,10,>100
6168,knocking,229,26462840,97.834094658,_100,8,>100
6169,inappropriate,229,26463069,97.8349412794,_100,13,>100
6170,climbing,229,26463298,97.8357879008,_100,8,>100
6171,monroe,229,26463527,97.8366345223,_100,6,>100
6172,cans,229,26463756,97.8374811437,_100,4,>100
6173,murphy,229,26463985,97.8383277652,_100,6,>100
6174,puppies,228,26464213,97.8391706896,_100,7,>100
6175,designing,228,26464441,97.840013614,_100,9,>100
6176,jar,228,26464669,97.8408565384,_100,3,>100
6177,boutique,228,26464897,97.8416994628,_100,8,>100
6178,acceptance,228,26465125,97.8425423872,_100,10,>100
6179,coachella,228,26465353,97.8433853116,_100,9,>100
6180,arlington,228,26465581,97.844228236,_100,9,>100
6181,drafts,228,26465809,97.8450711604,_100,6,>100
6182,insult,228,26466037,97.8459140848,_100,6,>100
6183,losses,228,26466265,97.8467570092,_100,6,>100
6184,references,228,26466493,97.8475999336,_100,10,>100
6185,smoothie,228,26466721,97.848442858,_100,8,>100
6186,transportation,228,26466949,97.8492857824,_100,14,>100
6187,norris,228,26467177,97.8501287068,_100,6,>100
6188,smartphone,228,26467405,97.8509716312,_100,10,>100
6189,julia,227,26467632,97.8518108586,_100,5,>100
6190,formal,227,26467859,97.8526500859,_100,6,>100
6191,pattern,227,26468086,97.8534893133,_100,7,>100
6192,idc,227,26468313,97.8543285407,_100,3,>100
6193,conflict,227,26468540,97.855167768,_100,8,>100
6194,comcast,227,26468767,97.8560069954,_100,7,>100
6195,chew,227,26468994,97.8568462228,_100,4,>100
6196,arrest,227,26469221,97.8576854501,_100,6,>100
6197,luxury,227,26469448,97.8585246775,_100,6,>100
6198,dawg,227,26469675,97.8593639048,_100,4,>100
6199,prediction,227,26469902,97.8602031322,_100,10,>100
6200,wizard,226,26470128,97.8610386625,_100,6,>100
6201,avail,226,26470354,97.8618741929,_100,5,>100
6202,marquette,226,26470580,97.8627097232,_100,9,>100
6203,carnival,226,26470806,97.8635452535,_100,8,>100
6204,sleeve,226,26471032,97.8643807839,_100,6,>100
6205,bullet,226,26471258,97.8652163142,_100,6,>100
6206,sendak,226,26471484,97.8660518445,_100,6,>100
6207,tina,226,26471710,97.8668873748,_100,4,>100
6208,alpha,226,26471936,97.8677229052,_100,5,>100
6209,herman,226,26472162,97.8685584355,_100,6,>100
6210,baylor,226,26472388,97.8693939658,_100,6,>100
6211,merely,226,26472614,97.8702294962,_100,6,>100
6212,beside,226,26472840,97.8710650265,_100,6,>100
6213,everyones,226,26473066,97.8719005568,_100,9,>100
6214,yeahh,226,26473292,97.8727360871,_100,5,>100
6215,employment,226,26473518,97.8735716175,_100,10,>100
6216,ancient,226,26473744,97.8744071478,_100,7,>100
6217,dated,226,26473970,97.8752426781,_100,5,>100
6218,bruins,225,26474195,97.8760745114,_100,6,>100
6219,harsh,225,26474420,97.8769063447,_100,5,>100
6220,craigslist,225,26474645,97.877738178,_100,10,>100
6221,delish,225,26474870,97.8785700113,_100,6,>100
6222,lent,225,26475095,97.8794018446,_100,4,>100
6223,chaos,225,26475320,97.8802336779,_100,5,>100
6224,ordinary,225,26475545,97.8810655112,_100,8,>100
6225,shyt,225,26475770,97.8818973445,_100,4,>100
6226,dl,225,26475995,97.8827291777,_100,2,>100
6227,lowest,225,26476220,97.883561011,_100,6,>100
6228,announcements,225,26476445,97.8843928443,_100,13,>100
6229,stanford,225,26476670,97.8852246776,_100,8,>100
6230,pint,225,26476895,97.8860565109,_100,4,>100
6231,ranked,224,26477119,97.8868846472,_100,6,>100
6232,criticism,224,26477343,97.8877127834,_100,9,>100
6233,hay,224,26477567,97.8885409197,_100,3,>100
6234,differences,224,26477791,97.8893690559,_100,11,>100
6235,bookstore,224,26478015,97.8901971922,_100,9,>100
6236,interaction,224,26478239,97.8910253284,_100,11,>100
6237,allergic,224,26478463,97.8918534647,_100,8,>100
6238,referred,224,26478687,97.8926816009,_100,8,>100
6239,obnoxious,224,26478911,97.8935097372,_100,9,>100
6240,chills,224,26479135,97.8943378735,_100,6,>100
6241,diving,224,26479359,97.8951660097,_100,6,>100
6242,mag,224,26479583,97.895994146,_100,3,>100
6243,buildings,224,26479807,97.8968222822,_100,9,>100
6244,mb,224,26480031,97.8976504185,_100,2,>100
6245,suggests,224,26480255,97.8984785547,_100,8,>100
6246,arrives,224,26480479,97.899306691,_100,7,>100
6247,persons,224,26480703,97.9001348272,_100,7,>100
6248,radar,223,26480926,97.9009592665,_100,5,>100
6249,managing,223,26481149,97.9017837057,_100,8,>100
6250,rio,223,26481372,97.9026081449,_100,3,>100
6251,guts,223,26481595,97.9034325841,_100,4,>100
6252,liquid,223,26481818,97.9042570233,_100,6,>100
6253,cnt,223,26482041,97.9050814625,_100,3,>100
6254,pac,223,26482264,97.9059059018,_100,3,>100
6255,biased,223,26482487,97.906730341,_100,6,>100
6256,conferences,223,26482710,97.9075547802,_100,11,>100
6257,fence,223,26482933,97.9083792194,_100,5,>100
6258,photoshoot,223,26483156,97.9092036586,_100,10,>100
6259,linda,223,26483379,97.9100280978,_100,5,>100
6260,louisiana,223,26483602,97.9108525371,_100,9,>100
6261,blueberry,223,26483825,97.9116769763,_100,9,>100
6262,drawn,223,26484048,97.9125014155,_100,5,>100
6263,alexander,223,26484271,97.9133258547,_100,9,>100
6264,klout,223,26484494,97.9141502939,_100,5,>100
6265,sho,223,26484717,97.9149747332,_100,3,>100
6266,dictionary,222,26484939,97.9157954753,_100,10,>100
6267,barrett,222,26485161,97.9166162175,_100,7,>100
6268,protected,222,26485383,97.9174369597,_100,9,>100
6269,thug,222,26485605,97.9182577019,_100,4,>100
6270,tommorow,222,26485827,97.9190784441,_100,8,>100
6271,confuse,222,26486049,97.9198991862,_100,7,>100
6272,harm,222,26486271,97.9207199284,_100,4,>100
6273,treasure,222,26486493,97.9215406706,_100,8,>100
6274,stellar,222,26486715,97.9223614128,_100,7,>100
6275,unfortunate,222,26486937,97.923182155,_100,11,>100
6276,sheep,222,26487159,97.9240028971,_100,5,>100
6277,collaborate,222,26487381,97.9248236393,_100,11,>100
6278,lindsay,222,26487603,97.9256443815,_100,7,>100
6279,colored,222,26487825,97.9264651237,_100,7,>100
6280,witnessed,222,26488047,97.9272858659,_100,9,>100
6281,hq,222,26488269,97.9281066081,_100,2,>100
6282,shed,222,26488491,97.9289273502,_100,4,>100
6283,tripping,221,26488712,97.9297443954,_100,8,>100
6284,fortunate,221,26488933,97.9305614405,_100,9,>100
6285,paths,221,26489154,97.9313784857,_100,5,>100
6286,gud,221,26489375,97.9321955308,_100,3,>100
6287,wardrobe,221,26489596,97.933012576,_100,8,>100
6288,replying,221,26489817,97.9338296211,_100,8,>100
6289,skating,221,26490038,97.9346466662,_100,7,>100
6290,intellectual,221,26490259,97.9354637114,_100,12,>100
6291,bastard,221,26490480,97.9362807565,_100,7,>100
6292,absence,221,26490701,97.9370978017,_100,7,>100
6293,entertain,221,26490922,97.9379148468,_100,9,>100
6294,marlins,221,26491143,97.938731892,_100,7,>100
6295,phillies,221,26491364,97.9395489371,_100,8,>100
6296,platforms,221,26491585,97.9403659822,_100,9,>100
6297,unable,221,26491806,97.9411830274,_100,6,>100
6298,versions,220,26492026,97.9419963755,_100,8,>100
6299,underestimate,220,26492246,97.9428097236,_100,13,>100
6300,elsewhere,220,26492466,97.9436230717,_100,9,>100
6301,shannon,220,26492686,97.9444364198,_100,7,>100
6302,arnold,220,26492906,97.9452497679,_100,6,>100
6303,uploading,220,26493126,97.946063116,_100,9,>100
6304,stinks,220,26493346,97.9468764641,_100,6,>100
6305,fastest,220,26493566,97.9476898122,_100,7,>100
6306,liver,220,26493786,97.9485031604,_100,5,>100
6307,logan,220,26494006,97.9493165085,_100,5,>100
6308,waffles,220,26494226,97.9501298566,_100,7,>100
6309,nicest,220,26494446,97.9509432047,_100,6,>100
6310,ut,219,26494665,97.9517528557,_100,2,>100
6311,ui,219,26494884,97.9525625068,_100,2,>100
6312,begging,219,26495103,97.9533721579,_100,7,>100
6313,facility,219,26495322,97.954181809,_100,8,>100
6314,francis,219,26495541,97.95499146,_100,7,>100
6315,prank,219,26495760,97.9558011111,_100,5,>100
6316,souls,219,26495979,97.9566107622,_100,5,>100
6317,practically,219,26496198,97.9574204132,_100,11,>100
6318,boi,219,26496417,97.9582300643,_100,3,>100
6319,grammy,219,26496636,97.9590397154,_100,6,>100
6320,acl,219,26496855,97.9598493665,_100,3,>100
6321,morris,219,26497074,97.9606590175,_100,6,>100
6322,slight,219,26497293,97.9614686686,_100,6,>100
6323,weights,219,26497512,97.9622783197,_100,7,>100
6324,grads,219,26497731,97.9630879707,_100,5,>100
6325,gays,219,26497950,97.9638976218,_100,4,>100
6326,nomination,218,26498168,97.9647035758,_100,10,>100
6327,noticing,218,26498386,97.9655095299,_100,8,>100
6328,samuel,218,26498604,97.9663154839,_100,6,>100
6329,blend,218,26498822,97.9671214379,_100,5,>100
6330,pencil,218,26499040,97.967927392,_100,6,>100
6331,tees,218,26499258,97.968733346,_100,4,>100
6332,minaj,218,26499476,97.9695393,_100,5,>100
6333,mitchell,218,26499694,97.9703452541,_100,8,>100
6334,exception,218,26499912,97.9711512081,_100,9,>100
6335,proceeds,218,26500130,97.9719571621,_100,8,>100
6336,marilyn,218,26500348,97.9727631162,_100,7,>100
6337,severe,218,26500566,97.9735690702,_100,6,>100
6338,arkansas,218,26500784,97.9743750242,_100,8,>100
6339,cigarette,218,26501002,97.9751809783,_100,9,>100
6340,nearby,218,26501220,97.9759869323,_100,6,>100
6341,kickoff,217,26501437,97.9767891893,_100,7,>100
6342,extend,217,26501654,97.9775914463,_100,6,>100
6343,turtle,217,26501871,97.9783937033,_100,6,>100
6344,incident,217,26502088,97.9791959603,_100,8,>100
6345,tupac,217,26502305,97.9799982173,_100,5,>100
6346,convert,217,26502522,97.9808004743,_100,7,>100
6347,kathy,217,26502739,97.9816027313,_100,5,>100
6348,mornin,217,26502956,97.9824049883,_100,6,>100
6349,aspect,217,26503173,97.9832072453,_100,6,>100
6350,contracts,217,26503390,97.9840095023,_100,9,>100
6351,atm,216,26503606,97.9848080622,_100,3,>100
6352,wks,216,26503822,97.9856066222,_100,3,>100
6353,literacy,216,26504038,97.9864051822,_100,8,>100
6354,reservation,216,26504254,97.9872037421,_100,11,>100
6355,retreat,216,26504470,97.9880023021,_100,7,>100
6356,thy,216,26504686,97.988800862,_100,3,>100
6357,du,216,26504902,97.989599422,_100,2,>100
6358,deciding,216,26505118,97.990397982,_100,8,>100
6359,qualify,216,26505334,97.9911965419,_100,7,>100
6360,sip,216,26505550,97.9919951019,_100,3,>100
6361,toothbrush,216,26505766,97.9927936618,_100,10,>100
6362,outage,216,26505982,97.9935922218,_100,6,>100
6363,reagan,216,26506198,97.9943907817,_100,6,>100
6364,backed,216,26506414,97.9951893417,_100,6,>100
6365,solar,216,26506630,97.9959879017,_100,5,>100
6366,creeping,216,26506846,97.9967864616,_100,8,>100
6367,tunnel,216,26507062,97.9975850216,_100,6,>100
6368,dell,215,26507277,97.9983798845,_100,4,>100
6369,bits,215,26507492,97.9991747474,_100,4,>100
6370,edwards,215,26507707,97.9999696104,_100,7,>100
6371,evan,215,26507922,98.0007644733,_100,4,>100
6372,cracks,215,26508137,98.0015593362,_100,6,>100
6373,fighters,215,26508352,98.0023541991,_100,8,>100
6374,ratchet,215,26508567,98.003149062,_100,7,>100
6375,trey,215,26508782,98.003943925,_100,4,>100
6376,cleared,215,26508997,98.0047387879,_100,7,>100
6377,harrison,215,26509212,98.0055336508,_100,8,>100
6378,bracelet,215,26509427,98.0063285137,_100,8,>100
6379,flipping,215,26509642,98.0071233767,_100,8,>100
6380,arguments,214,26509856,98.0079145425,_100,9,>100
6381,beloved,214,26510070,98.0087057084,_100,7,>100
6382,languages,214,26510284,98.0094968743,_100,9,>100
6383,sloppy,214,26510498,98.0102880402,_100,6,>100
6384,supportive,214,26510712,98.0110792061,_100,10,>100
6385,tweetdeck,214,26510926,98.011870372,_100,9,>100
6386,flops,214,26511140,98.0126615379,_100,5,>100
6387,adopted,214,26511354,98.0134527038,_100,7,>100
6388,unusual,214,26511568,98.0142438696,_100,7,>100
6389,trapped,214,26511782,98.0150350355,_100,7,>100
6390,bald,214,26511996,98.0158262014,_100,4,>100
6391,iran,214,26512210,98.0166173673,_100,4,>100
6392,rated,214,26512424,98.0174085332,_100,5,>100
6393,defined,214,26512638,98.0181996991,_100,7,>100
6394,imagined,214,26512852,98.018990865,_100,8,>100
6395,cigarettes,214,26513066,98.0197820308,_100,10,>100
6396,orientation,213,26513279,98.0205694997,_100,11,>100
6397,climate,213,26513492,98.0213569685,_100,7,>100
6398,sharon,213,26513705,98.0221444374,_100,6,>100
6399,influential,213,26513918,98.0229319062,_100,11,>100
6400,bagel,213,26514131,98.0237193751,_100,5,>100
6401,choke,213,26514344,98.0245068439,_100,5,>100
6402,noodles,213,26514557,98.0252943128,_100,7,>100
6403,rome,213,26514770,98.0260817816,_100,4,>100
6404,outfits,213,26514983,98.0268692505,_100,7,>100
6405,deleting,213,26515196,98.0276567193,_100,8,>100
6406,temps,213,26515409,98.0284441882,_100,5,>100
6407,gem,213,26515622,98.029231657,_100,3,>100
6408,kristen,213,26515835,98.0300191259,_100,7,>100
6409,crucial,213,26516048,98.0308065947,_100,7,>100
6410,surface,213,26516261,98.0315940636,_100,7,>100
6411,poet,213,26516474,98.0323815324,_100,4,>100
6412,brighter,213,26516687,98.0331690013,_100,8,>100
6413,border,213,26516900,98.0339564701,_100,6,>100
6414,spill,213,26517113,98.034743939,_100,5,>100
6415,balanced,213,26517326,98.0355314078,_100,8,>100
6416,puerto,213,26517539,98.0363188767,_100,6,>100
6417,sleeps,213,26517752,98.0371063455,_100,6,>100
6418,tearing,212,26517964,98.0378901173,_100,7,>100
6419,ye,212,26518176,98.0386738891,_100,2,>100
6420,airplane,212,26518388,98.039457661,_100,8,>100
6421,requested,212,26518600,98.0402414328,_100,9,>100
6422,reduced,212,26518812,98.0410252046,_100,7,>100
6423,confirmation,212,26519024,98.0418089764,_100,12,>100
6424,nerds,212,26519236,98.0425927482,_100,5,>100
6425,swept,212,26519448,98.04337652,_100,5,>100
6426,attract,212,26519660,98.0441602918,_100,7,>100
6427,participated,212,26519872,98.0449440636,_100,12,>100
6428,overdue,212,26520084,98.0457278355,_100,7,>100
6429,agrees,212,26520296,98.0465116073,_100,6,>100
6430,bryce,212,26520508,98.0472953791,_100,5,>100
6431,sarcastic,212,26520720,98.0480791509,_100,9,>100
6432,powder,212,26520932,98.0488629227,_100,6,>100
6433,paintings,212,26521144,98.0496466945,_100,9,>100
6434,walter,212,26521356,98.0504304663,_100,6,>100
6435,funnier,212,26521568,98.0512142381,_100,7,>100
6436,skipping,212,26521780,98.05199801,_100,8,>100
6437,durant,212,26521992,98.0527817818,_100,6,>100
6438,freaks,212,26522204,98.0535655536,_100,6,>100
6439,celebrated,212,26522416,98.0543493254,_100,10,>100
6440,beverage,212,26522628,98.0551330972,_100,8,>100
6441,infection,212,26522840,98.055916869,_100,9,>100
6442,pregnancy,212,26523052,98.0567006408,_100,9,>100
6443,carrie,211,26523263,98.0574807156,_100,6,>100
6444,hmu,211,26523474,98.0582607904,_100,3,>100
6445,mainstream,211,26523685,98.0590408652,_100,10,>100
6446,repeatedly,211,26523896,98.0598209399,_100,10,>100
6447,lololol,211,26524107,98.0606010147,_100,7,>100
6448,weigh,211,26524318,98.0613810895,_100,5,>100
6449,dats,211,26524529,98.0621611643,_100,4,>100
6450,toss,211,26524740,98.062941239,_100,4,>100
6451,adobe,211,26524951,98.0637213138,_100,5,>100
6452,welp,211,26525162,98.0645013886,_100,4,>100
6453,duncan,211,26525373,98.0652814634,_100,6,>100
6454,expertise,211,26525584,98.0660615381,_100,9,>100
6455,methods,211,26525795,98.0668416129,_100,7,>100
6456,slot,211,26526006,98.0676216877,_100,4,>100
6457,extraordinary,211,26526217,98.0684017625,_100,13,>100
6458,reliable,211,26526428,98.0691818372,_100,8,>100
6459,awaiting,210,26526638,98.069958215,_100,8,>100
6460,shuffle,210,26526848,98.0707345927,_100,7,>100
6461,sustainable,210,26527058,98.0715109705,_100,11,>100
6462,airing,210,26527268,98.0722873482,_100,6,>100
6463,pairs,210,26527478,98.0730637259,_100,5,>100
6464,racism,210,26527688,98.0738401037,_100,6,>100
6465,flop,210,26527898,98.0746164814,_100,4,>100
6466,dryer,210,26528108,98.0753928592,_100,5,>100
6467,stevie,210,26528318,98.0761692369,_100,6,>100
6468,aj,210,26528528,98.0769456146,_100,2,>100
6469,coworker,210,26528738,98.0777219924,_100,8,>100
6470,chart,210,26528948,98.0784983701,_100,5,>100
6471,apology,210,26529158,98.0792747478,_100,7,>100
6472,tasted,210,26529368,98.0800511256,_100,6,>100
6473,height,210,26529578,98.0808275033,_100,6,>100
6474,frequently,210,26529788,98.0816038811,_100,10,>100
6475,juicy,210,26529998,98.0823802588,_100,5,>100
6476,douglas,210,26530208,98.0831566365,_100,7,>100
6477,horizon,210,26530418,98.0839330143,_100,7,>100
6478,suspension,210,26530628,98.084709392,_100,10,>100
6479,nascar,210,26530838,98.0854857698,_100,6,>100
6480,panthers,209,26531047,98.0862584505,_100,8,>100
6481,barkley,209,26531256,98.0870311312,_100,7,>100
6482,rockies,209,26531465,98.0878038119,_100,7,>100
6483,bennett,209,26531674,98.0885764926,_100,7,>100
6484,excel,209,26531883,98.0893491733,_100,5,>100
6485,sketch,209,26532092,98.090121854,_100,6,>100
6486,charming,209,26532301,98.0908945347,_100,8,>100
6487,twisted,209,26532510,98.0916672154,_100,7,>100
6488,flirting,209,26532719,98.0924398961,_100,8,>100
6489,funky,209,26532928,98.0932125768,_100,5,>100
6490,promising,209,26533137,98.0939852575,_100,9,>100
6491,reg,209,26533346,98.0947579382,_100,3,>100
6492,difficulties,209,26533555,98.0955306189,_100,12,>100
6493,loading,209,26533764,98.0963032996,_100,7,>100
6494,metta,209,26533973,98.0970759803,_100,5,>100
6495,rocket,209,26534182,98.097848661,_100,6,>100
6496,punched,209,26534391,98.0986213417,_100,7,>100
6497,realistic,209,26534600,98.0993940224,_100,9,>100
6498,zuckerberg,208,26534808,98.1001630061,_100,10,>100
6499,rohn,208,26535016,98.1009319897,_100,4,>100
6500,riot,208,26535224,98.1017009734,_100,4,>100
6501,educators,208,26535432,98.102469957,_100,9,>100
6502,boyfriends,208,26535640,98.1032389407,_100,10,>100
6503,motivate,208,26535848,98.1040079244,_100,8,>100
6504,initiative,208,26536056,98.104776908,_100,10,>100
6505,samsung,208,26536264,98.1055458917,_100,7,>100
6506,hp,208,26536472,98.1063148754,_100,2,>100
6507,shiny,208,26536680,98.107083859,_100,5,>100
6508,kitten,208,26536888,98.1078528427,_100,6,>100
6509,launches,208,26537096,98.1086218264,_100,8,>100
6510,jess,208,26537304,98.10939081,_100,4,>100
6511,lloyd,208,26537512,98.1101597937,_100,5,>100
6512,addicting,208,26537720,98.1109287774,_100,9,>100
6513,healthier,208,26537928,98.111697761,_100,9,>100
6514,macbook,208,26538136,98.1124667447,_100,7,>100
6515,foolish,208,26538344,98.1132357284,_100,7,>100
6516,sack,207,26538551,98.114001015,_100,4,>100
6517,complaints,207,26538758,98.1147663016,_100,10,>100
6518,patch,207,26538965,98.1155315882,_100,5,>100
6519,yauch,207,26539172,98.1162968749,_100,5,>100
6520,defending,207,26539379,98.1170621615,_100,9,>100
6521,optimistic,207,26539586,98.1178274481,_100,10,>100
6522,lexington,207,26539793,98.1185927348,_100,9,>100
6523,birthdays,207,26540000,98.1193580214,_100,9,>100
6524,oliver,207,26540207,98.120123308,_100,6,>100
6525,underrated,207,26540414,98.1208885946,_100,10,>100
6526,artest,207,26540621,98.1216538813,_100,6,>100
6527,evolution,207,26540828,98.1224191679,_100,9,>100
6528,hotels,207,26541035,98.1231844545,_100,6,>100
6529,winston,207,26541242,98.1239497412,_100,7,>100
6530,jj,207,26541449,98.1247150278,_100,2,>100
6531,newly,207,26541656,98.1254803144,_100,5,>100
6532,thoroughly,207,26541863,98.126245601,_100,10,>100
6533,celebs,207,26542070,98.1270108877,_100,6,>100
6534,vendor,207,26542277,98.1277761743,_100,6,>100
6535,perfume,206,26542483,98.1285377639,_100,7,>100
6536,equals,206,26542689,98.1292993535,_100,6,>100
6537,homer,206,26542895,98.1300609431,_100,5,>100
6538,supporter,206,26543101,98.1308225327,_100,9,>100
6539,fork,206,26543307,98.1315841222,_100,4,>100
6540,maya,206,26543513,98.1323457118,_100,4,>100
6541,plates,206,26543719,98.1331073014,_100,6,>100
6542,freaky,206,26543925,98.133868891,_100,6,>100
6543,interns,206,26544131,98.1346304806,_100,7,>100
6544,competing,206,26544337,98.1353920702,_100,9,>100
6545,holmes,206,26544543,98.1361536598,_100,6,>100
6546,natalie,206,26544749,98.1369152494,_100,7,>100
6547,grandparents,206,26544955,98.137676839,_100,12,>100
6548,mum,206,26545161,98.1384384286,_100,3,>100
6549,exploring,206,26545367,98.1392000182,_100,9,>100
6550,fenway,206,26545573,98.1399616078,_100,6,>100
6551,abbey,206,26545779,98.1407231973,_100,5,>100
6552,lifting,206,26545985,98.1414847869,_100,7,>100
6553,thread,206,26546191,98.1422463765,_100,6,>100
6554,brazilian,205,26546396,98.1430042691,_100,9,>100
6555,flags,205,26546601,98.1437621616,_100,5,>100
6556,banner,205,26546806,98.1445200542,_100,6,>100
6557,conquer,205,26547011,98.1452779467,_100,7,>100
6558,badger,205,26547216,98.1460358393,_100,6,>100
6559,accessible,205,26547421,98.1467937319,_100,10,>100
6560,enjoys,205,26547626,98.1475516244,_100,6,>100
6561,buses,205,26547831,98.148309517,_100,5,>100
6562,afghanistan,205,26548036,98.1490674095,_100,11,>100
6563,dynamic,205,26548241,98.1498253021,_100,7,>100
6564,inevitable,205,26548446,98.1505831946,_100,10,>100
6565,flexible,205,26548651,98.1513410872,_100,8,>100
6566,forgiveness,205,26548856,98.1520989797,_100,11,>100
6567,microwave,204,26549060,98.1528531753,_100,9,>100
6568,nash,204,26549264,98.1536073708,_100,4,>100
6569,joints,204,26549468,98.1543615663,_100,6,>100
6570,weapons,204,26549672,98.1551157618,_100,7,>100
6571,mud,204,26549876,98.1558699573,_100,3,>100
6572,punishment,204,26550080,98.1566241528,_100,10,>100
6573,meow,204,26550284,98.1573783484,_100,4,>100
6574,predictions,204,26550488,98.1581325439,_100,11,>100
6575,tasks,204,26550692,98.1588867394,_100,5,>100
6576,officers,204,26550896,98.1596409349,_100,8,>100
6577,publicly,204,26551100,98.1603951304,_100,8,>100
6578,hacking,204,26551304,98.1611493259,_100,7,>100
6579,certified,204,26551508,98.1619035215,_100,9,>100
6580,locally,204,26551712,98.162657717,_100,7,>100
6581,statements,204,26551916,98.1634119125,_100,10,>100
6582,batteries,204,26552120,98.164166108,_100,9,>100
6583,marie,203,26552323,98.1649166065,_100,5,>100
6584,spaghetti,203,26552526,98.165667105,_100,9,>100
6585,twenty,203,26552729,98.1664176035,_100,6,>100
6586,faced,203,26552932,98.1671681019,_100,5,>100
6587,bicycle,203,26553135,98.1679186004,_100,7,>100
6588,shipped,203,26553338,98.1686690989,_100,7,>100
6589,magazines,203,26553541,98.1694195974,_100,9,>100
6590,easiest,203,26553744,98.1701700959,_100,7,>100
6591,mans,203,26553947,98.1709205943,_100,4,>100
6592,ux,203,26554150,98.1716710928,_100,2,>100
6593,raiders,203,26554353,98.1724215913,_100,7,>100
6594,drill,203,26554556,98.1731720898,_100,5,>100
6595,insanely,203,26554759,98.1739225883,_100,8,>100
6596,luncheon,203,26554962,98.1746730867,_100,8,>100
6597,ebook,203,26555165,98.1754235852,_100,5,>100
6598,proved,203,26555368,98.1761740837,_100,6,>100
6599,bcuz,203,26555571,98.1769245822,_100,4,>100
6600,jill,203,26555774,98.1776750807,_100,4,>100
6601,hitter,203,26555977,98.1784255791,_100,6,>100
6602,lookout,203,26556180,98.1791760776,_100,7,>100
6603,rehab,202,26556382,98.1799228791,_100,5,>100
6604,shade,202,26556584,98.1806696805,_100,5,>100
6605,downs,202,26556786,98.181416482,_100,5,>100
6606,shocking,202,26556988,98.1821632834,_100,8,>100
6607,babes,202,26557190,98.1829100848,_100,5,>100
6608,lanes,202,26557392,98.1836568863,_100,5,>100
6609,latter,202,26557594,98.1844036877,_100,6,>100
6610,managers,202,26557796,98.1851504892,_100,8,>100
6611,amounts,202,26557998,98.1858972906,_100,7,>100
6612,grizzlies,202,26558200,98.1866440921,_100,9,>100
6613,bak,202,26558402,98.1873908935,_100,3,>100
6614,rating,202,26558604,98.188137695,_100,6,>100
6615,tide,202,26558806,98.1888844964,_100,4,>100
6616,pujols,202,26559008,98.1896312978,_100,6,>100
6617,dreamed,202,26559210,98.1903780993,_100,7,>100
6618,wipe,201,26559411,98.1911212037,_100,4,>100
6619,reviewing,201,26559612,98.1918643081,_100,9,>100
6620,buried,201,26559813,98.1926074125,_100,6,>100
6621,giveaways,201,26560014,98.1933505169,_100,9,>100
6622,peak,201,26560215,98.1940936213,_100,4,>100
6623,chargers,201,26560416,98.1948367257,_100,8,>100
6624,bbc,201,26560617,98.1955798301,_100,3,>100
6625,mma,201,26560818,98.1963229345,_100,3,>100
6626,candles,201,26561019,98.1970660389,_100,7,>100
6627,sony,201,26561220,98.1978091434,_100,4,>100
6628,mickey,201,26561421,98.1985522478,_100,6,>100
6629,strongly,201,26561622,98.1992953522,_100,8,>100
6630,brewer,201,26561823,98.2000384566,_100,6,>100
6631,nightmares,201,26562024,98.200781561,_100,10,>100
6632,eternal,201,26562225,98.2015246654,_100,7,>100
6633,entertained,201,26562426,98.2022677698,_100,11,>100
6634,orgs,201,26562627,98.2030108742,_100,4,>100
6635,rapping,201,26562828,98.2037539786,_100,7,>100
6636,leslie,201,26563029,98.204497083,_100,6,>100
6637,tuning,201,26563230,98.2052401874,_100,6,>100
6638,venues,201,26563431,98.2059832918,_100,6,>100
6639,bailey,201,26563632,98.2067263962,_100,6,>100
6640,disappear,201,26563833,98.2074695006,_100,9,>100
6641,dms,201,26564034,98.2082126051,_100,3,>100
6642,chandler,201,26564235,98.2089557095,_100,8,>100
6643,lungs,200,26564435,98.2096951168,_100,5,>100
6644,chin,200,26564635,98.2104345242,_100,4,>100
6645,200th,200,26564835,98.2111739316,_100,5,>100
6646,vegetables,200,26565035,98.2119133389,_100,10,>100
6647,200,200,26565235,98.2126527463,_100,3,>100
6648,stud,200,26565435,98.2133921537,_100,4,>100
6649,hologram,200,26565635,98.2141315611,_100,8,>100
6650,peek,200,26565835,98.2148709684,_100,4,>100
6651,yhu,200,26566035,98.2156103758,_100,3,>100
6652,consensus,200,26566235,98.2163497832,_100,9,>100
6653,ebooks,200,26566435,98.2170891905,_100,6,>100
6654,novels,200,26566635,98.2178285979,_100,6,>100
6655,insomnia,200,26566835,98.2185680053,_100,8,>100
6656,electricity,200,26567035,98.2193074126,_100,11,>100
6657,timbers,200,26567235,98.22004682,_100,7,>100
6658,delays,200,26567435,98.2207862274,_100,6,>100
6659,smelling,199,26567634,98.2215219377,_100,8,>100
6660,superior,199,26567833,98.2222576481,_100,8,>100
6661,encouraged,199,26568032,98.2229933584,_100,10,>100
6662,starters,199,26568231,98.2237290687,_100,8,>100
6663,concentrate,199,26568430,98.2244647791,_100,11,>100
6664,advise,199,26568629,98.2252004894,_100,6,>100
6665,janet,199,26568828,98.2259361997,_100,5,>100
6666,gibson,199,26569027,98.2266719101,_100,6,>100
6667,beth,199,26569226,98.2274076204,_100,4,>100
6668,buyers,199,26569425,98.2281433307,_100,6,>100
6669,annie,199,26569624,98.2288790411,_100,5,>100
6670,insightful,199,26569823,98.2296147514,_100,10,>100
6671,eminem,199,26570022,98.2303504617,_100,6,>100
6672,tomorrows,199,26570221,98.2310861721,_100,9,>100
6673,sadness,199,26570420,98.2318218824,_100,7,>100
6674,hiatus,199,26570619,98.2325575927,_100,6,>100
6675,legislation,199,26570818,98.2332933031,_100,11,>100
6676,les,199,26571017,98.2340290134,_100,3,>100
6677,leo,199,26571216,98.2347647237,_100,3,>100
6678,asia,198,26571414,98.235496737,_100,4,>100
6679,slave,198,26571612,98.2362287503,_100,5,>100
6680,subscribe,198,26571810,98.2369607636,_100,9,>100
6681,spoon,198,26572008,98.2376927769,_100,5,>100
6682,wbu,198,26572206,98.2384247902,_100,3,>100
6683,matchup,198,26572404,98.2391568035,_100,7,>100
6684,hoped,198,26572602,98.2398888168,_100,5,>100
6685,lease,198,26572800,98.2406208301,_100,5,>100
6686,spinach,198,26572998,98.2413528434,_100,7,>100
6687,arriving,198,26573196,98.2420848567,_100,8,>100
6688,carrots,198,26573394,98.24281687,_100,7,>100
6689,edited,198,26573592,98.2435488833,_100,6,>100
6690,genuine,198,26573790,98.2442808966,_100,7,>100
6691,clicked,198,26573988,98.2450129099,_100,7,>100
6692,pledge,198,26574186,98.2457449232,_100,6,>100
6693,omaha,198,26574384,98.2464769365,_100,5,>100
6694,bumper,198,26574582,98.2472089498,_100,6,>100
6695,educate,198,26574780,98.2479409631,_100,7,>100
6696,investigation,198,26574978,98.2486729764,_100,13,>100
6697,teenagers,198,26575176,98.2494049896,_100,9,>100
6698,flirt,197,26575373,98.2501333059,_100,5,>100
6699,lined,197,26575570,98.2508616222,_100,5,>100
6700,protesters,197,26575767,98.2515899384,_100,10,>100
6701,ski,197,26575964,98.2523182547,_100,3,>100
6702,teaches,197,26576161,98.2530465709,_100,7,>100
6703,nailed,197,26576358,98.2537748872,_100,6,>100
6704,biden,197,26576555,98.2545032035,_100,5,>100
6705,trusted,197,26576752,98.2552315197,_100,7,>100
6706,mc,197,26576949,98.255959836,_100,2,>100
6707,clarify,197,26577146,98.2566881522,_100,7,>100
6708,pipe,197,26577343,98.2574164685,_100,4,>100
6709,effectively,197,26577540,98.2581447848,_100,11,>100
6710,soy,197,26577737,98.258873101,_100,3,>100
6711,irene,197,26577934,98.2596014173,_100,5,>100
6712,grave,197,26578131,98.2603297335,_100,5,>100
6713,pose,197,26578328,98.2610580498,_100,4,>100
6714,morrison,197,26578525,98.2617863661,_100,8,>100
6715,swap,197,26578722,98.2625146823,_100,4,>100
6716,nevada,197,26578919,98.2632429986,_100,6,>100
6717,literature,197,26579116,98.2639713148,_100,10,>100
6718,household,196,26579312,98.2646959341,_100,9,>100
6719,lamar,196,26579508,98.2654205533,_100,5,>100
6720,closely,196,26579704,98.2661451725,_100,7,>100
6721,versus,196,26579900,98.2668697917,_100,6,>100
6722,guilt,196,26580096,98.267594411,_100,5,>100
6723,involving,196,26580292,98.2683190302,_100,9,>100
6724,forcing,196,26580488,98.2690436494,_100,7,>100
6725,twitters,196,26580684,98.2697682686,_100,8,>100
6726,forreal,196,26580880,98.2704928878,_100,7,>100
6727,harden,196,26581076,98.2712175071,_100,6,>100
6728,puck,196,26581272,98.2719421263,_100,4,>100
6729,naughty,196,26581468,98.2726667455,_100,7,>100
6730,favre,196,26581664,98.2733913647,_100,5,>100
6731,aight,196,26581860,98.274115984,_100,5,>100
6732,coding,196,26582056,98.2748406032,_100,6,>100
6733,democrats,196,26582252,98.2755652224,_100,9,>100
6734,warned,196,26582448,98.2762898416,_100,6,>100
6735,serves,196,26582644,98.2770144608,_100,6,>100
6736,profits,196,26582840,98.2777390801,_100,7,>100
6737,visible,196,26583036,98.2784636993,_100,7,>100
6738,kg,195,26583231,98.2791846215,_100,2,>100
6739,senator,195,26583426,98.2799055437,_100,7,>100
6740,reno,195,26583621,98.2806264659,_100,4,>100
6741,refund,195,26583816,98.281347388,_100,6,>100
6742,stroke,195,26584011,98.2820683102,_100,6,>100
6743,font,195,26584206,98.2827892324,_100,4,>100
6744,drown,195,26584401,98.2835101546,_100,5,>100
6745,youngest,195,26584596,98.2842310768,_100,8,>100
6746,leonard,195,26584791,98.284951999,_100,7,>100
6747,norman,195,26584986,98.2856729212,_100,6,>100
6748,ditch,195,26585181,98.2863938433,_100,5,>100
6749,fires,195,26585376,98.2871147655,_100,5,>100
6750,profession,195,26585571,98.2878356877,_100,10,>100
6751,riley,195,26585766,98.2885566099,_100,5,>100
6752,fighter,195,26585961,98.2892775321,_100,7,>100
6753,batting,195,26586156,98.2899984543,_100,7,>100
6754,temperature,195,26586351,98.2907193765,_100,11,>100
6755,stones,195,26586546,98.2914402986,_100,6,>100
6756,revealed,194,26586740,98.2921575238,_100,8,>100
6757,effing,194,26586934,98.2928747489,_100,6,>100
6758,instructor,194,26587128,98.2935919741,_100,10,>100
6759,consecutive,194,26587322,98.2943091992,_100,11,>100
6760,entries,194,26587516,98.2950264244,_100,7,>100
6761,arrival,194,26587710,98.2957436495,_100,7,>100
6762,hospitality,194,26587904,98.2964608747,_100,11,>100
6763,accessories,194,26588098,98.2971780998,_100,11,>100
6764,pbs,194,26588292,98.297895325,_100,3,>100
6765,rev,194,26588486,98.2986125501,_100,3,>100
6766,miley,194,26588680,98.2993297753,_100,5,>100
6767,eliminated,194,26588874,98.3000470004,_100,10,>100
6768,karl,194,26589068,98.3007642256,_100,4,>100
6769,adopt,194,26589262,98.3014814507,_100,5,>100
6770,renewed,194,26589456,98.3021986759,_100,7,>100
6771,pals,194,26589650,98.302915901,_100,4,>100
6772,uc,194,26589844,98.3036331262,_100,2,>100
6773,labels,194,26590038,98.3043503513,_100,6,>100
6774,wv,194,26590232,98.3050675765,_100,2,>100
6775,float,194,26590426,98.3057848016,_100,5,>100
6776,abdc,194,26590620,98.3065020268,_100,4,>100
6777,fruits,194,26590814,98.3072192519,_100,6,>100
6778,spoil,193,26591007,98.30793278,_100,5,>100
6779,researching,193,26591200,98.3086463081,_100,11,>100
6780,buds,193,26591393,98.3093598363,_100,4,>100
6781,yur,193,26591586,98.3100733644,_100,3,>100
6782,bernard,193,26591779,98.3107868925,_100,7,>100
6783,preferred,193,26591972,98.3115004206,_100,9,>100
6784,crashing,193,26592165,98.3122139487,_100,8,>100
6785,aliens,193,26592358,98.3129274768,_100,6,>100
6786,pepsi,193,26592551,98.3136410049,_100,5,>100
6787,angle,193,26592744,98.314354533,_100,5,>100
6788,reed,193,26592937,98.3150680612,_100,4,>100
6789,intrigued,193,26593130,98.3157815893,_100,9,>100
6790,conscious,193,26593323,98.3164951174,_100,9,>100
6791,participation,193,26593516,98.3172086455,_100,13,>100
6792,increasing,193,26593709,98.3179221736,_100,10,>100
6793,groupon,193,26593902,98.3186357017,_100,7,>100
6794,ownership,193,26594095,98.3193492298,_100,9,>100
6795,podcasts,193,26594288,98.3200627579,_100,8,>100
6796,worthless,193,26594481,98.3207762861,_100,9,>100
6797,placement,193,26594674,98.3214898142,_100,9,>100
6798,proverbs,193,26594867,98.3222033423,_100,8,>100
6799,campaigns,193,26595060,98.3229168704,_100,9,>100
6800,funk,192,26595252,98.3236267015,_100,4,>100
6801,victor,192,26595444,98.3243365325,_100,6,>100
6802,barcelona,192,26595636,98.3250463636,_100,9,>100
6803,rex,192,26595828,98.3257561947,_100,3,>100
6804,soldiers,192,26596020,98.3264660258,_100,8,>100
6805,distribution,192,26596212,98.3271758568,_100,12,>100
6806,avoiding,192,26596404,98.3278856879,_100,8,>100
6807,nyt,192,26596596,98.328595519,_100,3,>100
6808,lopez,192,26596788,98.3293053501,_100,5,>100
6809,ku,192,26596980,98.3300151811,_100,2,>100
6810,salty,192,26597172,98.3307250122,_100,5,>100
6811,baker,192,26597364,98.3314348433,_100,5,>100
6812,bats,192,26597556,98.3321446744,_100,4,>100
6813,raleigh,192,26597748,98.3328545054,_100,7,>100
6814,measured,192,26597940,98.3335643365,_100,8,>100
6815,qualified,192,26598132,98.3342741676,_100,9,>100
6816,picnic,191,26598323,98.3349803016,_100,6,>100
6817,themed,191,26598514,98.3356864357,_100,6,>100
6818,remake,191,26598705,98.3363925697,_100,6,>100
6819,careers,191,26598896,98.3370987037,_100,7,>100
6820,alien,191,26599087,98.3378048378,_100,5,>100
6821,possession,191,26599278,98.3385109718,_100,10,>100
6822,edits,191,26599469,98.3392171059,_100,5,>100
6823,exhausting,191,26599660,98.3399232399,_100,10,>100
6824,principles,191,26599851,98.3406293739,_100,10,>100
6825,instructions,191,26600042,98.341335508,_100,12,>100
6826,slower,191,26600233,98.342041642,_100,6,>100
6827,slapped,191,26600424,98.3427477761,_100,7,>100
6828,girlfriends,191,26600615,98.3434539101,_100,11,>100
6829,regards,191,26600806,98.3441600441,_100,7,>100
6830,banging,191,26600997,98.3448661782,_100,7,>100
6831,delight,191,26601188,98.3455723122,_100,7,>100
6832,existed,191,26601379,98.3462784462,_100,7,>100
6833,typically,191,26601570,98.3469845803,_100,9,>100
6834,accents,191,26601761,98.3476907143,_100,7,>100
6835,braves,191,26601952,98.3483968484,_100,6,>100
6836,woody,191,26602143,98.3491029824,_100,5,>100
6837,immature,191,26602334,98.3498091164,_100,8,>100
6838,tuna,191,26602525,98.3505152505,_100,4,>100
6839,elephant,191,26602716,98.3512213845,_100,8,>100
6840,ss,191,26602907,98.3519275186,_100,2,>100
6841,grounded,191,26603098,98.3526336526,_100,8,>100
6842,wax,191,26603289,98.3533397866,_100,3,>100
6843,nurse,191,26603480,98.3540459207,_100,5,>100
6844,cj,191,26603671,98.3547520547,_100,2,>100
6845,glitter,191,26603862,98.3554581887,_100,7,>100
6846,lasted,191,26604053,98.3561643228,_100,6,>100
6847,stink,191,26604244,98.3568704568,_100,5,>100
6848,diverse,191,26604435,98.3575765909,_100,7,>100
6849,handling,191,26604626,98.3582827249,_100,8,>100
6850,caramel,191,26604817,98.3589888589,_100,7,>100
6851,spilled,190,26605007,98.3596912959,_100,7,>100
6852,colleges,190,26605197,98.3603937329,_100,8,>100
6853,grounds,190,26605387,98.3610961699,_100,7,>100
6854,publishers,190,26605577,98.3617986069,_100,10,>100
6855,acquired,190,26605767,98.362501044,_100,8,>100
6856,feast,190,26605957,98.363203481,_100,5,>100
6857,fold,190,26606147,98.363905918,_100,4,>100
6858,hardware,190,26606337,98.364608355,_100,8,>100
6859,nursing,190,26606527,98.365310792,_100,7,>100
6860,screamed,190,26606717,98.366013229,_100,8,>100
6861,trunk,190,26606907,98.366715666,_100,5,>100
6862,minded,190,26607097,98.367418103,_100,6,>100
6863,attempting,190,26607287,98.36812054,_100,10,>100
6864,diabetes,190,26607477,98.368822977,_100,8,>100
6865,betta,190,26607667,98.369525414,_100,5,>100
6866,delivering,190,26607857,98.370227851,_100,10,>100
6867,corrected,190,26608047,98.370930288,_100,9,>100
6868,welcomes,190,26608237,98.371632725,_100,8,>100
6869,xox,190,26608427,98.372335162,_100,3,>100
6870,ruins,190,26608617,98.373037599,_100,5,>100
6871,colin,189,26608806,98.3737363389,_100,5,>100
6872,flood,189,26608995,98.3744350789,_100,5,>100
6873,hatred,189,26609184,98.3751338189,_100,6,>100
6874,noises,189,26609373,98.3758325588,_100,6,>100
6875,units,189,26609562,98.3765312988,_100,5,>100
6876,florence,189,26609751,98.3772300388,_100,8,>100
6877,collaborative,189,26609940,98.3779287787,_100,13,>100
6878,amongst,189,26610129,98.3786275187,_100,7,>100
6879,marley,189,26610318,98.3793262587,_100,6,>100
6880,comparing,189,26610507,98.3800249986,_100,9,>100
6881,cuban,189,26610696,98.3807237386,_100,5,>100
6882,pointed,189,26610885,98.3814224786,_100,7,>100
6883,wheat,189,26611074,98.3821212185,_100,5,>100
6884,pst,189,26611263,98.3828199585,_100,3,>100
6885,humidity,189,26611452,98.3835186984,_100,8,>100
6886,carol,189,26611641,98.3842174384,_100,5,>100
6887,exp,189,26611830,98.3849161784,_100,3,>100
6888,diary,189,26612019,98.3856149183,_100,5,>100
6889,translate,189,26612208,98.3863136583,_100,9,>100
6890,carried,189,26612397,98.3870123983,_100,7,>100
6891,fullest,189,26612586,98.3877111382,_100,7,>100
6892,kris,188,26612774,98.3884061812,_100,4,>100
6893,leftovers,188,26612962,98.3891012241,_100,9,>100
6894,viewers,188,26613150,98.389796267,_100,7,>100
6895,mock,188,26613338,98.3904913099,_100,4,>100
6896,dana,188,26613526,98.3911863529,_100,4,>100
6897,carnegie,188,26613714,98.3918813958,_100,8,>100
6898,survival,188,26613902,98.3925764387,_100,8,>100
6899,floors,188,26614090,98.3932714817,_100,6,>100
6900,frustration,188,26614278,98.3939665246,_100,11,>100
6901,bby,188,26614466,98.3946615675,_100,3,>100
6902,strings,188,26614654,98.3953566104,_100,7,>100
6903,blaming,188,26614842,98.3960516534,_100,7,>100
6904,kindly,188,26615030,98.3967466963,_100,6,>100
6905,dey,188,26615218,98.3974417392,_100,3,>100
6906,taping,188,26615406,98.3981367822,_100,6,>100
6907,gluten,188,26615594,98.3988318251,_100,6,>100
6908,demos,188,26615782,98.399526868,_100,5,>100
6909,gather,188,26615970,98.4002219109,_100,6,>100
6910,anticipation,187,26616157,98.4009132568,_100,12,>100
6911,sequel,187,26616344,98.4016046027,_100,6,>100
6912,resolve,187,26616531,98.4022959486,_100,7,>100
6913,filed,187,26616718,98.4029872945,_100,5,>100
6914,packs,187,26616905,98.4036786404,_100,5,>100
6915,contains,187,26617092,98.4043699863,_100,8,>100
6916,nutrition,187,26617279,98.4050613322,_100,9,>100
6917,claire,187,26617466,98.4057526781,_100,6,>100
6918,redskins,187,26617653,98.406444024,_100,8,>100
6919,claiming,187,26617840,98.4071353699,_100,8,>100
6920,crackers,187,26618027,98.4078267157,_100,8,>100
6921,rams,187,26618214,98.4085180616,_100,4,>100
6922,med,187,26618401,98.4092094075,_100,3,>100
6923,guessed,187,26618588,98.4099007534,_100,7,>100
6924,hashtags,187,26618775,98.4105920993,_100,8,>100
6925,satisfying,186,26618961,98.4112797482,_100,10,>100
6926,naming,186,26619147,98.411967397,_100,6,>100
6927,latino,186,26619333,98.4126550459,_100,6,>100
6928,pause,186,26619519,98.4133426947,_100,5,>100
6929,fraud,186,26619705,98.4140303436,_100,5,>100
6930,describes,186,26619891,98.4147179924,_100,9,>100
6931,logged,186,26620077,98.4154056413,_100,6,>100
6932,biking,186,26620263,98.4160932901,_100,6,>100
6933,earl,186,26620449,98.416780939,_100,4,>100
6934,boise,186,26620635,98.4174685878,_100,5,>100
6935,unfair,186,26620821,98.4181562367,_100,6,>100
6936,bombs,186,26621007,98.4188438856,_100,5,>100
6937,giggle,186,26621193,98.4195315344,_100,6,>100
6938,allergy,186,26621379,98.4202191833,_100,7,>100
6939,carefully,186,26621565,98.4209068321,_100,9,>100
6940,garcia,186,26621751,98.421594481,_100,6,>100
6941,bleeding,186,26621937,98.4222821298,_100,8,>100
6942,wednesdays,186,26622123,98.4229697787,_100,10,>100
6943,glow,186,26622309,98.4236574275,_100,4,>100
6944,hungover,186,26622495,98.4243450764,_100,8,>100
6945,egypt,186,26622681,98.4250327252,_100,5,>100
6946,necklace,186,26622867,98.4257203741,_100,8,>100
6947,adoption,186,26623053,98.426408023,_100,8,>100
6948,murdered,186,26623239,98.4270956718,_100,8,>100
6949,sw,186,26623425,98.4277833207,_100,2,>100
6950,speedy,186,26623611,98.4284709695,_100,6,>100
6951,stern,186,26623797,98.4291586184,_100,5,>100
6952,roberts,186,26623983,98.4298462672,_100,7,>100
6953,democracy,185,26624168,98.430530219,_100,9,>100
6954,childish,185,26624353,98.4312141709,_100,8,>100
6955,dealer,185,26624538,98.4318981227,_100,6,>100
6956,scan,185,26624723,98.4325820745,_100,4,>100
6957,occur,185,26624908,98.4332660263,_100,5,>100
6958,leftover,185,26625093,98.4339499781,_100,8,>100
6959,curly,185,26625278,98.4346339299,_100,5,>100
6960,ellis,185,26625463,98.4353178818,_100,5,>100
6961,dime,185,26625648,98.4360018336,_100,4,>100
6962,curtis,185,26625833,98.4366857854,_100,6,>100
6963,catches,185,26626018,98.4373697372,_100,7,>100
6964,percentage,185,26626203,98.438053689,_100,10,>100
6965,accused,185,26626388,98.4387376409,_100,7,>100
6966,ringing,185,26626573,98.4394215927,_100,7,>100
6967,burst,185,26626758,98.4401055445,_100,5,>100
6968,tellin,185,26626943,98.4407894963,_100,6,>100
6969,rivera,184,26627127,98.4414697511,_100,6,>100
6970,principle,184,26627311,98.4421500059,_100,9,>100
6971,indoor,184,26627495,98.4428302606,_100,6,>100
6972,bikini,184,26627679,98.4435105154,_100,6,>100
6973,strongest,184,26627863,98.4441907702,_100,9,>100
6974,vital,184,26628047,98.444871025,_100,5,>100
6975,forehead,184,26628231,98.4455512798,_100,8,>100
6976,bees,184,26628415,98.4462315345,_100,4,>100
6977,probs,184,26628599,98.4469117893,_100,5,>100
6978,hallway,184,26628783,98.4475920441,_100,7,>100
6979,appointments,184,26628967,98.4482722989,_100,12,>100
6980,ipads,184,26629151,98.4489525537,_100,5,>100
6981,southwest,184,26629335,98.4496328085,_100,9,>100
6982,gravy,184,26629519,98.4503130632,_100,5,>100
6983,premium,184,26629703,98.450993318,_100,7,>100
6984,pd,184,26629887,98.4516735728,_100,2,>100
6985,emotionally,184,26630071,98.4523538276,_100,11,>100
6986,pudding,184,26630255,98.4530340824,_100,7,>100
6987,chess,184,26630439,98.4537143371,_100,5,>100
6988,panels,184,26630623,98.4543945919,_100,6,>100
6989,raises,184,26630807,98.4550748467,_100,6,>100
6990,juliet,184,26630991,98.4557551015,_100,6,>100
6991,perception,184,26631175,98.4564353563,_100,10,>100
6992,greens,183,26631358,98.457111914,_100,6,>100
6993,damon,183,26631541,98.4577884717,_100,5,>100
6994,wilde,183,26631724,98.4584650295,_100,5,>100
6995,adjust,183,26631907,98.4591415872,_100,6,>100
6996,justify,183,26632090,98.459818145,_100,7,>100
6997,backing,183,26632273,98.4604947027,_100,7,>100
6998,elements,183,26632456,98.4611712605,_100,8,>100
6999,mediocre,183,26632639,98.4618478182,_100,8,>100
7000,denied,183,26632822,98.462524376,_100,6,>100
7001,pong,183,26633005,98.4632009337,_100,4,>100
7002,urs,183,26633188,98.4638774914,_100,3,>100
7003,practical,183,26633371,98.4645540492,_100,9,>100
7004,consists,183,26633554,98.4652306069,_100,8,>100
7005,tremendous,183,26633737,98.4659071647,_100,10,>100
7006,takers,183,26633920,98.4665837224,_100,6,>100
7007,insecure,183,26634103,98.4672602802,_100,8,>100
7008,australian,183,26634286,98.4679368379,_100,10,>100
7009,puke,183,26634469,98.4686133956,_100,4,>100
7010,cartoons,183,26634652,98.4692899534,_100,8,>100
7011,shaped,183,26634835,98.4699665111,_100,6,>100
7012,stripper,183,26635018,98.4706430689,_100,8,>100
7013,outlet,182,26635200,98.4713159296,_100,6,>100
7014,bt,182,26635382,98.4719887903,_100,2,>100
7015,univ,182,26635564,98.472661651,_100,4,>100
7016,viggle,182,26635746,98.4733345117,_100,6,>100
7017,login,182,26635928,98.4740073724,_100,5,>100
7018,sweating,182,26636110,98.4746802331,_100,8,>100
7019,described,182,26636292,98.4753530938,_100,9,>100
7020,kemp,182,26636474,98.4760259545,_100,4,>100
7021,tailgate,182,26636656,98.4766988152,_100,8,>100
7022,pierced,182,26636838,98.4773716759,_100,7,>100
7023,dominate,182,26637020,98.4780445367,_100,8,>100
7024,lens,182,26637202,98.4787173974,_100,4,>100
7025,strive,182,26637384,98.4793902581,_100,6,>100
7026,rail,182,26637566,98.4800631188,_100,4,>100
7027,followback,182,26637748,98.4807359795,_100,10,>100
7028,spencer,182,26637930,98.4814088402,_100,7,>100
7029,sixers,182,26638112,98.4820817009,_100,6,>100
7030,terrifying,182,26638294,98.4827545616,_100,10,>100
7031,java,182,26638476,98.4834274223,_100,4,>100
7032,sentiment,182,26638658,98.484100283,_100,9,>100
7033,stephanie,182,26638840,98.4847731437,_100,9,>100
7034,bubba,182,26639022,98.4854460044,_100,5,>100
7035,nebraska,182,26639204,98.4861188651,_100,8,>100
7036,wld,182,26639386,98.4867917258,_100,3,>100
7037,gals,182,26639568,98.4874645865,_100,4,>100
7038,rum,181,26639749,98.4881337502,_100,3,>100
7039,lotion,181,26639930,98.4888029139,_100,6,>100
7040,messaging,181,26640111,98.4894720776,_100,9,>100
7041,holly,181,26640292,98.4901412412,_100,5,>100
7042,observation,181,26640473,98.4908104049,_100,11,>100
7043,heated,181,26640654,98.4914795686,_100,6,>100
7044,voter,181,26640835,98.4921487322,_100,5,>100
7045,opponent,181,26641016,98.4928178959,_100,8,>100
7046,damned,181,26641197,98.4934870596,_100,6,>100
7047,simmons,181,26641378,98.4941562232,_100,7,>100
7048,gasol,181,26641559,98.4948253869,_100,5,>100
7049,listens,181,26641740,98.4954945506,_100,7,>100
7050,notifications,181,26641921,98.4961637143,_100,13,>100
7051,relative,181,26642102,98.4968328779,_100,8,>100
7052,vehicles,181,26642283,98.4975020416,_100,8,>100
7053,madden,181,26642464,98.4981712053,_100,6,>100
7054,rubber,181,26642645,98.4988403689,_100,6,>100
7055,fisher,181,26642826,98.4995095326,_100,6,>100
7056,narrative,181,26643007,98.5001786963,_100,9,>100
7057,disc,181,26643188,98.5008478599,_100,4,>100
7058,disneyland,181,26643369,98.5015170236,_100,10,>100
7059,surf,181,26643550,98.5021861873,_100,4,>100
7060,teammates,181,26643731,98.502855351,_100,9,>100
7061,tnt,180,26643911,98.5035208176,_100,3,>100
7062,bare,180,26644091,98.5041862842,_100,4,>100
7063,jared,180,26644271,98.5048517509,_100,5,>100
7064,sector,180,26644451,98.5055172175,_100,6,>100
7065,marijuana,180,26644631,98.5061826841,_100,9,>100
7066,shucks,180,26644811,98.5068481508,_100,6,>100
7067,memo,180,26644991,98.5075136174,_100,4,>100
7068,worm,180,26645171,98.508179084,_100,4,>100
7069,berlin,180,26645351,98.5088445507,_100,6,>100
7070,proving,180,26645531,98.5095100173,_100,7,>100
7071,outing,180,26645711,98.5101754839,_100,6,>100
7072,loudly,180,26645891,98.5108409506,_100,6,>100
7073,funded,180,26646071,98.5115064172,_100,6,>100
7074,disrespect,180,26646251,98.5121718838,_100,10,>100
7075,investors,180,26646431,98.5128373505,_100,9,>100
7076,texans,180,26646611,98.5135028171,_100,6,>100
7077,steam,180,26646791,98.5141682837,_100,5,>100
7078,fe,180,26646971,98.5148337504,_100,2,>100
7079,oc,180,26647151,98.515499217,_100,2,>100
7080,semi,180,26647331,98.5161646836,_100,4,>100
7081,terrified,180,26647511,98.5168301503,_100,9,>100
7082,agencies,180,26647691,98.5174956169,_100,8,>100
7083,liars,180,26647871,98.5181610835,_100,5,>100
7084,superstar,180,26648051,98.5188265502,_100,9,>100
7085,advocate,180,26648231,98.5194920168,_100,8,>100
7086,tad,180,26648411,98.5201574834,_100,3,>100
7087,punching,179,26648590,98.520819253,_100,8,>100
7088,established,179,26648769,98.5214810226,_100,11,>100
7089,avg,179,26648948,98.5221427922,_100,3,>100
7090,philip,179,26649127,98.5228045618,_100,6,>100
7091,crowds,179,26649306,98.5234663314,_100,6,>100
7092,calvin,179,26649485,98.524128101,_100,6,>100
7093,shady,179,26649664,98.5247898706,_100,5,>100
7094,honda,179,26649843,98.5254516402,_100,5,>100
7095,celeb,179,26650022,98.5261134098,_100,5,>100
7096,delivers,179,26650201,98.5267751794,_100,8,>100
7097,mitch,179,26650380,98.527436949,_100,5,>100
7098,montreal,179,26650559,98.5280987186,_100,8,>100
7099,pies,179,26650738,98.5287604882,_100,4,>100
7100,poison,179,26650917,98.5294222578,_100,6,>100
7101,lynch,179,26651096,98.5300840274,_100,5,>100
7102,upgraded,179,26651275,98.530745797,_100,8,>100
7103,groceries,179,26651454,98.5314075666,_100,9,>100
7104,bleed,179,26651633,98.5320693362,_100,5,>100
7105,swallow,179,26651812,98.5327311057,_100,7,>100
7106,entrance,179,26651991,98.5333928753,_100,8,>100
7107,physics,179,26652170,98.5340546449,_100,7,>100
7108,clicking,179,26652349,98.5347164145,_100,8,>100
7109,hoot,178,26652527,98.5353744871,_100,4,>100
7110,quoting,178,26652705,98.5360325597,_100,7,>100
7111,sighting,178,26652883,98.5366906322,_100,8,>100
7112,irritated,178,26653061,98.5373487048,_100,9,>100
7113,stalk,178,26653239,98.5380067773,_100,5,>100
7114,flavored,178,26653417,98.5386648499,_100,8,>100
7115,trippin,178,26653595,98.5393229225,_100,7,>100
7116,surrounding,178,26653773,98.539980995,_100,11,>100
7117,processing,178,26653951,98.5406390676,_100,10,>100
7118,lp,178,26654129,98.5412971401,_100,2,>100
7119,wifey,178,26654307,98.5419552127,_100,5,>100
7120,grabbed,178,26654485,98.5426132853,_100,7,>100
7121,potentially,178,26654663,98.5432713578,_100,11,>100
7122,horn,178,26654841,98.5439294304,_100,4,>100
7123,intriguing,178,26655019,98.5445875029,_100,10,>100
7124,leaning,178,26655197,98.5452455755,_100,7,>100
7125,workplace,178,26655375,98.545903648,_100,9,>100
7126,openings,178,26655553,98.5465617206,_100,8,>100
7127,handful,178,26655731,98.5472197932,_100,7,>100
7128,chronicle,178,26655909,98.5478778657,_100,9,>100
7129,paula,178,26656087,98.5485359383,_100,5,>100
7130,quest,178,26656265,98.5491940108,_100,5,>100
7131,typed,178,26656443,98.5498520834,_100,5,>100
7132,species,178,26656621,98.550510156,_100,7,>100
7133,sweets,177,26656798,98.5511645315,_100,6,>100
7134,pun,177,26656975,98.551818907,_100,3,>100
7135,cocaine,177,26657152,98.5524732825,_100,7,>100
7136,backpack,177,26657329,98.5531276581,_100,8,>100
7137,tulsa,177,26657506,98.5537820336,_100,5,>100
7138,skipped,177,26657683,98.5544364091,_100,7,>100
7139,sweaty,177,26657860,98.5550907846,_100,6,>100
7140,consequences,177,26658037,98.5557451601,_100,12,>100
7141,counted,177,26658214,98.5563995357,_100,7,>100
7142,youll,177,26658391,98.5570539112,_100,5,>100
7143,freezer,177,26658568,98.5577082867,_100,7,>100
7144,metadata,177,26658745,98.5583626622,_100,8,>100
7145,bothered,177,26658922,98.5590170378,_100,8,>100
7146,minority,177,26659099,98.5596714133,_100,8,>100
7147,highschool,177,26659276,98.5603257888,_100,10,>100
7148,tat,177,26659453,98.5609801643,_100,3,>100
7149,roman,177,26659630,98.5616345398,_100,5,>100
7150,notch,177,26659807,98.5622889154,_100,5,>100
7151,provider,177,26659984,98.5629432909,_100,8,>100
7152,attracted,177,26660161,98.5635976664,_100,9,>100
7153,poorly,177,26660338,98.5642520419,_100,6,>100
7154,angela,177,26660515,98.5649064175,_100,6,>100
7155,eliminate,177,26660692,98.565560793,_100,9,>100
7156,recycling,177,26660869,98.5662151685,_100,9,>100
7157,cst,177,26661046,98.566869544,_100,3,>100
7158,deer,177,26661223,98.5675239196,_100,4,>100
7159,investing,177,26661400,98.5681782951,_100,9,>100
7160,jews,177,26661577,98.5688326706,_100,4,>100
7161,patrons,177,26661754,98.5694870461,_100,7,>100
7162,attempts,177,26661931,98.5701414216,_100,8,>100
7163,glove,177,26662108,98.5707957972,_100,5,>100
7164,royals,176,26662284,98.5714464756,_100,6,>100
7165,blogspot,176,26662460,98.5720971541,_100,8,>100
7166,scheduling,176,26662636,98.5727478326,_100,10,>100
7167,hehehe,176,26662812,98.5733985111,_100,6,>100
7168,overload,176,26662988,98.5740491896,_100,8,>100
7169,chapters,176,26663164,98.5746998681,_100,8,>100
7170,mel,176,26663340,98.5753505466,_100,3,>100
7171,bets,176,26663516,98.5760012251,_100,4,>100
7172,atcha,176,26663692,98.5766519035,_100,5,>100
7173,determination,176,26663868,98.577302582,_100,13,>100
7174,theaters,176,26664044,98.5779532605,_100,8,>100
7175,taller,176,26664220,98.578603939,_100,6,>100
7176,hobby,176,26664396,98.5792546175,_100,5,>100
7177,rico,176,26664572,98.579905296,_100,4,>100
7178,shakes,176,26664748,98.5805559745,_100,6,>100
7179,bullied,176,26664924,98.5812066529,_100,7,>100
7180,shaping,176,26665100,98.5818573314,_100,7,>100
7181,filing,176,26665276,98.5825080099,_100,6,>100
7182,animated,176,26665452,98.5831586884,_100,8,>100
7183,acquire,176,26665628,98.5838093669,_100,7,>100
7184,architecture,175,26665803,98.5844563483,_100,12,>100
7185,nfc,175,26665978,98.5851033298,_100,3,>100
7186,glen,175,26666153,98.5857503112,_100,4,>100
7187,condo,175,26666328,98.5863972927,_100,5,>100
7188,outdoors,175,26666503,98.5870442741,_100,8,>100
7189,robbed,175,26666678,98.5876912556,_100,6,>100
7190,wakes,175,26666853,98.588338237,_100,5,>100
7191,amaze,175,26667028,98.5889852185,_100,5,>100
7192,publisher,175,26667203,98.5896321999,_100,9,>100
7193,quinn,175,26667378,98.5902791814,_100,5,>100
7194,protecting,175,26667553,98.5909261628,_100,10,>100
7195,chant,175,26667728,98.5915731443,_100,5,>100
7196,editors,175,26667903,98.5922201257,_100,7,>100
7197,mild,175,26668078,98.5928671072,_100,4,>100
7198,ratio,175,26668253,98.5935140886,_100,5,>100
7199,mills,175,26668428,98.5941610701,_100,5,>100
7200,kirk,175,26668603,98.5948080515,_100,4,>100
7201,spark,175,26668778,98.595455033,_100,5,>100
7202,formula,175,26668953,98.5961020144,_100,7,>100
7203,paperwork,175,26669128,98.5967489959,_100,9,>100
7204,bliss,175,26669303,98.5973959773,_100,5,>100
7205,laser,175,26669478,98.5980429588,_100,5,>100
7206,illness,175,26669653,98.5986899402,_100,7,>100
7207,acknowledge,174,26669827,98.5993332246,_100,11,>100
7208,scarf,174,26670001,98.599976509,_100,5,>100
7209,gin,174,26670175,98.6006197934,_100,3,>100
7210,entrepreneur,174,26670349,98.6012630779,_100,12,>100
7211,resolved,174,26670523,98.6019063623,_100,8,>100
7212,dental,174,26670697,98.6025496467,_100,6,>100
7213,decades,174,26670871,98.6031929311,_100,7,>100
7214,aa,174,26671045,98.6038362155,_100,2,>100
7215,quicker,174,26671219,98.6044794999,_100,7,>100
7216,alliance,174,26671393,98.6051227843,_100,8,>100
7217,sneeze,174,26671567,98.6057660687,_100,6,>100
7218,consumed,174,26671741,98.6064093531,_100,8,>100
7219,transit,174,26671915,98.6070526376,_100,7,>100
7220,seuss,174,26672089,98.607695922,_100,5,>100
7221,btwn,174,26672263,98.6083392064,_100,4,>100
7222,girly,174,26672437,98.6089824908,_100,5,>100
7223,palmer,174,26672611,98.6096257752,_100,6,>100
7224,mixes,174,26672785,98.6102690596,_100,5,>100
7225,judy,174,26672959,98.610912344,_100,4,>100
7226,airline,174,26673133,98.6115556284,_100,7,>100
7227,profiles,173,26673306,98.6121952158,_100,8,>100
7228,diane,173,26673479,98.6128348032,_100,5,>100
7229,compelling,173,26673652,98.6134743906,_100,10,>100
7230,mf,173,26673825,98.6141139779,_100,2,>100
7231,journalist,173,26673998,98.6147535653,_100,10,>100
7232,absurd,173,26674171,98.6153931527,_100,6,>100
7233,resolutions,173,26674344,98.6160327401,_100,11,>100
7234,manny,173,26674517,98.6166723274,_100,5,>100
7235,socal,173,26674690,98.6173119148,_100,5,>100
7236,comedian,173,26674863,98.6179515022,_100,8,>100
7237,neal,173,26675036,98.6185910896,_100,4,>100
7238,kong,173,26675209,98.6192306769,_100,4,>100
7239,resumes,173,26675382,98.6198702643,_100,7,>100
7240,apocalypse,173,26675555,98.6205098517,_100,10,>100
7241,vomit,173,26675728,98.6211494391,_100,5,>100
7242,willie,173,26675901,98.6217890264,_100,6,>100
7243,newton,173,26676074,98.6224286138,_100,6,>100
7244,dumbest,173,26676247,98.6230682012,_100,7,>100
7245,boarding,173,26676420,98.6237077886,_100,8,>100
7246,diana,173,26676593,98.6243473759,_100,5,>100
7247,betting,173,26676766,98.6249869633,_100,7,>100
7248,publication,173,26676939,98.6256265507,_100,11,>100
7249,recap,173,26677112,98.6262661381,_100,5,>100
7250,kerry,173,26677285,98.6269057254,_100,5,>100
7251,lynn,172,26677457,98.6275416158,_100,4,>100
7252,iraq,172,26677629,98.6281775061,_100,4,>100
7253,complimentary,172,26677801,98.6288133965,_100,13,>100
7254,disabled,172,26677973,98.6294492868,_100,8,>100
7255,goofy,172,26678145,98.6300851771,_100,5,>100
7256,mesa,172,26678317,98.6307210675,_100,4,>100
7257,curriculum,172,26678489,98.6313569578,_100,10,>100
7258,rss,172,26678661,98.6319928482,_100,3,>100
7259,floating,172,26678833,98.6326287385,_100,8,>100
7260,carroll,172,26679005,98.6332646288,_100,7,>100
7261,consume,172,26679177,98.6339005192,_100,7,>100
7262,joyce,172,26679349,98.6345364095,_100,5,>100
7263,mba,172,26679521,98.6351722998,_100,3,>100
7264,phd,172,26679693,98.6358081902,_100,3,>100
7265,dubstep,172,26679865,98.6364440805,_100,7,>100
7266,sydney,172,26680037,98.6370799709,_100,6,>100
7267,chorus,172,26680209,98.6377158612,_100,6,>100
7268,greece,172,26680381,98.6383517515,_100,6,>100
7269,serial,172,26680553,98.6389876419,_100,6,>100
7270,dame,172,26680725,98.6396235322,_100,4,>100
7271,sickness,172,26680897,98.6402594226,_100,8,>100
7272,steals,171,26681068,98.6408916159,_100,6,>100
7273,cha,171,26681239,98.6415238092,_100,3,>100
7274,immigration,171,26681410,98.6421560025,_100,11,>100
7275,aged,171,26681581,98.6427881958,_100,4,>100
7276,contribution,171,26681752,98.6434203891,_100,12,>100
7277,permit,171,26681923,98.6440525824,_100,6,>100
7278,stamp,171,26682094,98.6446847757,_100,5,>100
7279,hopeful,171,26682265,98.645316969,_100,7,>100
7280,coulda,171,26682436,98.6459491623,_100,6,>100
7281,techniques,171,26682607,98.6465813556,_100,10,>100
7282,warriors,171,26682778,98.6472135489,_100,8,>100
7283,ketchup,171,26682949,98.6478457422,_100,7,>100
7284,towel,171,26683120,98.6484779355,_100,5,>100
7285,instrument,171,26683291,98.6491101288,_100,10,>100
7286,encounter,171,26683462,98.6497423221,_100,9,>100
7287,ballroom,171,26683633,98.6503745154,_100,8,>100
7288,heavily,171,26683804,98.6510067087,_100,7,>100
7289,cave,170,26683974,98.6516352049,_100,4,>100
7290,chic,170,26684144,98.6522637012,_100,4,>100
7291,noted,170,26684314,98.6528921975,_100,5,>100
7292,digits,170,26684484,98.6535206937,_100,6,>100
7293,smiley,170,26684654,98.65414919,_100,6,>100
7294,cheek,170,26684824,98.6547776863,_100,5,>100
7295,nerdy,170,26684994,98.6554061825,_100,5,>100
7296,flaws,170,26685164,98.6560346788,_100,5,>100
7297,carson,170,26685334,98.6566631751,_100,6,>100
7298,dirk,170,26685504,98.6572916713,_100,4,>100
7299,determines,170,26685674,98.6579201676,_100,10,>100
7300,overseas,170,26685844,98.6585486639,_100,8,>100
7301,scottsdale,170,26686014,98.6591771601,_100,10,>100
7302,proposals,169,26686183,98.6598019593,_100,9,>100
7303,earrings,169,26686352,98.6604267586,_100,8,>100
7304,makers,169,26686521,98.6610515578,_100,6,>100
7305,issued,169,26686690,98.661676357,_100,6,>100
7306,confirms,169,26686859,98.6623011563,_100,8,>100
7307,shirtless,169,26687028,98.6629259555,_100,9,>100
7308,inform,169,26687197,98.6635507547,_100,6,>100
7309,purchases,169,26687366,98.6641755539,_100,9,>100
7310,pronounce,169,26687535,98.6648003532,_100,9,>100
7311,declared,169,26687704,98.6654251524,_100,8,>100
7312,duo,169,26687873,98.6660499516,_100,3,>100
7313,keeper,169,26688042,98.6666747509,_100,6,>100
7314,ballet,169,26688211,98.6672995501,_100,6,>100
7315,ethics,169,26688380,98.6679243493,_100,6,>100
7316,element,169,26688549,98.6685491485,_100,7,>100
7317,catering,169,26688718,98.6691739478,_100,8,>100
7318,bias,169,26688887,98.669798747,_100,4,>100
7319,sticky,169,26689056,98.6704235462,_100,6,>100
7320,wig,169,26689225,98.6710483454,_100,3,>100
7321,payments,169,26689394,98.6716731447,_100,8,>100
7322,gonzalez,169,26689563,98.6722979439,_100,8,>100
7323,piercing,169,26689732,98.6729227431,_100,8,>100
7324,appeared,169,26689901,98.6735475424,_100,8,>100
7325,sally,168,26690069,98.6741686446,_100,5,>100
7326,harvey,168,26690237,98.6747897467,_100,6,>100
7327,lemons,168,26690405,98.6754108489,_100,6,>100
7328,planes,168,26690573,98.6760319511,_100,6,>100
7329,curl,168,26690741,98.6766530533,_100,4,>100
7330,cohen,168,26690909,98.6772741555,_100,5,>100
7331,wagon,168,26691077,98.6778952577,_100,5,>100
7332,hasnt,168,26691245,98.6785163599,_100,5,>100
7333,debates,168,26691413,98.6791374621,_100,7,>100
7334,instruction,168,26691581,98.6797585643,_100,11,>100
7335,kickin,168,26691749,98.6803796665,_100,6,>100
7336,invent,168,26691917,98.6810007687,_100,6,>100
7337,dash,168,26692085,98.6816218708,_100,4,>100
7338,pitched,168,26692253,98.682242973,_100,7,>100
7339,cincy,168,26692421,98.6828640752,_100,5,>100
7340,rewarding,168,26692589,98.6834851774,_100,9,>100
7341,huntsman,168,26692757,98.6841062796,_100,8,>100
7342,swinging,168,26692925,98.6847273818,_100,8,>100
7343,boredom,168,26693093,98.685348484,_100,7,>100
7344,marine,168,26693261,98.6859695862,_100,6,>100
7345,properties,168,26693429,98.6865906884,_100,10,>100
7346,threatening,168,26693597,98.6872117906,_100,11,>100
7347,conditioning,168,26693765,98.6878328928,_100,12,>100
7348,gallon,168,26693933,98.6884539949,_100,6,>100
7349,tricky,168,26694101,98.6890750971,_100,6,>100
7350,sheen,168,26694269,98.6896961993,_100,5,>100
7351,dork,168,26694437,98.6903173015,_100,4,>100
7352,quoted,168,26694605,98.6909384037,_100,6,>100
7353,firing,167,26694772,98.6915558089,_100,6,>100
7354,cotton,167,26694939,98.692173214,_100,6,>100
7355,teresa,167,26695106,98.6927906192,_100,6,>100
7356,demands,167,26695273,98.6934080243,_100,7,>100
7357,smashed,167,26695440,98.6940254295,_100,7,>100
7358,hawaiian,167,26695607,98.6946428346,_100,8,>100
7359,lotus,167,26695774,98.6952602398,_100,5,>100
7360,hugo,167,26695941,98.6958776449,_100,4,>100
7361,rode,167,26696108,98.6964950501,_100,4,>100
7362,purposes,167,26696275,98.6971124552,_100,8,>100
7363,marty,167,26696442,98.6977298604,_100,5,>100
7364,flynn,167,26696609,98.6983472656,_100,5,>100
7365,translation,167,26696776,98.6989646707,_100,11,>100
7366,interact,167,26696943,98.6995820759,_100,8,>100
7367,startups,167,26697110,98.700199481,_100,8,>100
7368,principal,167,26697277,98.7008168862,_100,9,>100
7369,gene,167,26697444,98.7014342913,_100,4,>100
7370,addictive,167,26697611,98.7020516965,_100,9,>100
7371,peach,167,26697778,98.7026691016,_100,5,>100
7372,milkshake,167,26697945,98.7032865068,_100,9,>100
7373,requirements,167,26698112,98.7039039119,_100,12,>100
7374,peer,167,26698279,98.7045213171,_100,4,>100
7375,tyson,167,26698446,98.7051387223,_100,5,>100
7376,reverbnation,167,26698613,98.7057561274,_100,12,>100
7377,homepage,167,26698780,98.7063735326,_100,8,>100
7378,yanks,167,26698947,98.7069909377,_100,5,>100
7379,suns,167,26699114,98.7076083429,_100,4,>100
7380,employers,167,26699281,98.708225748,_100,9,>100
7381,attacking,166,26699447,98.7088394561,_100,9,>100
7382,replacing,166,26699613,98.7094531643,_100,9,>100
7383,tribune,166,26699779,98.7100668724,_100,7,>100
7384,ahah,166,26699945,98.7106805805,_100,4,>100
7385,cries,166,26700111,98.7112942886,_100,5,>100
7386,occasionally,166,26700277,98.7119079967,_100,12,>100
7387,curve,166,26700443,98.7125217048,_100,5,>100
7388,vista,166,26700609,98.713135413,_100,5,>100
7389,studied,166,26700775,98.7137491211,_100,7,>100
7390,spree,166,26700941,98.7143628292,_100,5,>100
7391,emerging,166,26701107,98.7149765373,_100,8,>100
7392,purchasing,166,26701273,98.7155902454,_100,10,>100
7393,quarters,166,26701439,98.7162039535,_100,8,>100
7394,dissertation,166,26701605,98.7168176617,_100,12,>100
7395,fountain,166,26701771,98.7174313698,_100,8,>100
7396,applies,166,26701937,98.7180450779,_100,7,>100
7397,trump,166,26702103,98.718658786,_100,5,>100
7398,glue,166,26702269,98.7192724941,_100,4,>100
7399,rudy,165,26702434,98.7198825052,_100,4,>100
7400,poke,165,26702599,98.7204925163,_100,4,>100
7401,brah,165,26702764,98.7211025274,_100,4,>100
7402,sopa,165,26702929,98.7217125385,_100,4,>100
7403,audiences,165,26703094,98.7223225495,_100,9,>100
7404,meditation,165,26703259,98.7229325606,_100,10,>100
7405,statue,165,26703424,98.7235425717,_100,6,>100
7406,pineapple,165,26703589,98.7241525828,_100,9,>100
7407,monkeys,165,26703754,98.7247625939,_100,7,>100
7408,awarded,165,26703919,98.7253726049,_100,7,>100
7409,gona,165,26704084,98.725982616,_100,4,>100
7410,headlines,165,26704249,98.7265926271,_100,9,>100
7411,lily,165,26704414,98.7272026382,_100,4,>100
7412,ongoing,165,26704579,98.7278126493,_100,7,>100
7413,curiosity,165,26704744,98.7284226603,_100,9,>100
7414,tore,165,26704909,98.7290326714,_100,4,>100
7415,lend,165,26705074,98.7296426825,_100,4,>100
7416,essays,165,26705239,98.7302526936,_100,6,>100
7417,fouls,165,26705404,98.7308627047,_100,5,>100
7418,sock,165,26705569,98.7314727157,_100,4,>100
7419,thunderstorm,165,26705734,98.7320827268,_100,12,>100
7420,kool,165,26705899,98.7326927379,_100,4,>100
7421,combine,165,26706064,98.733302749,_100,7,>100
7422,annoys,164,26706228,98.733909063,_100,6,>100
7423,ache,164,26706392,98.7345153771,_100,4,>100
7424,cells,164,26706556,98.7351216911,_100,5,>100
7425,juss,164,26706720,98.7357280052,_100,4,>100
7426,infrastructure,164,26706884,98.7363343192,_100,14,>100
7427,christine,164,26707048,98.7369406332,_100,9,>100
7428,bail,164,26707212,98.7375469473,_100,4,>100
7429,desires,164,26707376,98.7381532613,_100,7,>100
7430,sane,164,26707540,98.7387595754,_100,4,>100
7431,territory,164,26707704,98.7393658894,_100,9,>100
7432,mattress,164,26707868,98.7399722035,_100,8,>100
7433,crisp,164,26708032,98.7405785175,_100,5,>100
7434,handled,164,26708196,98.7411848315,_100,7,>100
7435,lacking,164,26708360,98.7417911456,_100,7,>100
7436,nuclear,164,26708524,98.7423974596,_100,7,>100
7437,exposed,164,26708688,98.7430037737,_100,7,>100
7438,republic,164,26708852,98.7436100877,_100,8,>100
7439,reset,164,26709016,98.7442164018,_100,5,>100
7440,pursuit,164,26709180,98.7448227158,_100,7,>100
7441,gentle,164,26709344,98.7454290299,_100,6,>100
7442,thor,164,26709508,98.7460353439,_100,4,>100
7443,condom,164,26709672,98.7466416579,_100,6,>100
7444,mindless,164,26709836,98.747247972,_100,8,>100
7445,hee,164,26710000,98.747854286,_100,3,>100
7446,hayes,164,26710164,98.7484606001,_100,5,>100
7447,moron,164,26710328,98.7490669141,_100,5,>100
7448,symphony,164,26710492,98.7496732282,_100,8,>100
7449,dna,164,26710656,98.7502795422,_100,3,>100
7450,eligible,164,26710820,98.7508858562,_100,8,>100
7451,thingy,164,26710984,98.7514921703,_100,6,>100
7452,spy,164,26711148,98.7520984843,_100,3,>100
7453,bronx,164,26711312,98.7527047984,_100,5,>100
7454,cb,163,26711475,98.7533074154,_100,2,>100
7455,affects,163,26711638,98.7539100324,_100,7,>100
7456,technique,163,26711801,98.7545126494,_100,9,>100
7457,jo,163,26711964,98.7551152664,_100,2,>100
7458,grants,163,26712127,98.7557178834,_100,6,>100
7459,dayton,163,26712290,98.7563205004,_100,6,>100
7460,contagious,163,26712453,98.7569231174,_100,10,>100
7461,groove,163,26712616,98.7575257344,_100,6,>100
7462,mistaken,163,26712779,98.7581283514,_100,8,>100
7463,automatic,163,26712942,98.7587309684,_100,9,>100
7464,environmental,163,26713105,98.7593335854,_100,13,>100
7465,yelp,163,26713268,98.7599362025,_100,4,>100
7466,smokin,163,26713431,98.7605388195,_100,6,>100
7467,coyotes,163,26713594,98.7611414365,_100,7,>100
7468,flyer,163,26713757,98.7617440535,_100,5,>100
7469,sneaky,163,26713920,98.7623466705,_100,6,>100
7470,fierce,163,26714083,98.7629492875,_100,6,>100
7471,dolls,163,26714246,98.7635519045,_100,5,>100
7472,costa,163,26714409,98.7641545215,_100,5,>100
7473,ba,163,26714572,98.7647571385,_100,2,>100
7474,keller,163,26714735,98.7653597555,_100,6,>100
7475,describing,163,26714898,98.7659623725,_100,10,>100
7476,submission,163,26715061,98.7665649895,_100,10,>100
7477,humid,163,26715224,98.7671676065,_100,5,>100
7478,limbaugh,163,26715387,98.7677702235,_100,8,>100
7479,desperately,163,26715550,98.7683728405,_100,11,>100
7480,challenged,163,26715713,98.7689754576,_100,10,>100
7481,topped,163,26715876,98.7695780746,_100,6,>100
7482,phew,163,26716039,98.7701806916,_100,4,>100
7483,lifted,163,26716202,98.7707833086,_100,6,>100
7484,gaining,163,26716365,98.7713859256,_100,7,>100
7485,bothering,163,26716528,98.7719885426,_100,9,>100
7486,insist,163,26716691,98.7725911596,_100,6,>100
7487,downloads,163,26716854,98.7731937766,_100,9,>100
7488,outcomes,163,26717017,98.7737963936,_100,8,>100
7489,leverage,163,26717180,98.7743990106,_100,8,>100
7490,journalists,163,26717343,98.7750016276,_100,11,>100
7491,performs,163,26717506,98.7756042446,_100,8,>100
7492,generations,163,26717669,98.7762068616,_100,11,>100
7493,danced,163,26717832,98.7768094786,_100,6,>100
7494,diss,163,26717995,98.7774120956,_100,4,>100
7495,deff,163,26718158,98.7780147127,_100,4,>100
7496,runnin,163,26718321,98.7786173297,_100,6,>100
7497,dunn,162,26718483,98.7792162496,_100,4,>100
7498,heating,162,26718645,98.7798151696,_100,7,>100
7499,accounting,162,26718807,98.7804140896,_100,10,>100
7500,idaho,162,26718969,98.7810130095,_100,5,>100
7501,blush,162,26719131,98.7816119295,_100,5,>100
7502,sanders,162,26719293,98.7822108495,_100,7,>100
7503,performers,162,26719455,98.7828097694,_100,10,>100
7504,unemployed,162,26719617,98.7834086894,_100,10,>100
7505,rope,162,26719779,98.7840076094,_100,4,>100
7506,cheeks,162,26719941,98.7846065294,_100,6,>100
7507,stan,162,26720103,98.7852054493,_100,4,>100
7508,ruby,162,26720265,98.7858043693,_100,4,>100
7509,cozy,162,26720427,98.7864032893,_100,4,>100
7510,ctfu,162,26720589,98.7870022092,_100,4,>100
7511,guitars,162,26720751,98.7876011292,_100,7,>100
7512,meantime,162,26720913,98.7882000492,_100,8,>100
7513,osama,162,26721075,98.7887989691,_100,5,>100
7514,acc,162,26721237,98.7893978891,_100,3,>100
7515,verified,162,26721399,98.7899968091,_100,8,>100
7516,handing,162,26721561,98.7905957291,_100,7,>100
7517,chevy,162,26721723,98.791194649,_100,5,>100
7518,poems,162,26721885,98.791793569,_100,5,>100
7519,pirate,162,26722047,98.792392489,_100,6,>100
7520,concrete,162,26722209,98.7929914089,_100,8,>100
7521,battles,162,26722371,98.7935903289,_100,7,>100
7522,distraction,162,26722533,98.7941892489,_100,11,>100
7523,bueno,162,26722695,98.7947881688,_100,5,>100
7524,relations,162,26722857,98.7953870888,_100,9,>100
7525,roi,162,26723019,98.7959860088,_100,3,>100
7526,affair,162,26723181,98.7965849288,_100,6,>100
7527,coma,162,26723343,98.7971838487,_100,4,>100
7528,lipstick,162,26723505,98.7977827687,_100,8,>100
7529,speechless,162,26723667,98.7983816887,_100,10,>100
7530,intention,162,26723829,98.7989806086,_100,9,>100
7531,lettuce,162,26723991,98.7995795286,_100,7,>100
7532,grief,162,26724153,98.8001784486,_100,5,>100
7533,thunderstorms,161,26724314,98.8007736715,_100,13,>100
7534,trader,161,26724475,98.8013688944,_100,6,>100
7535,ivy,161,26724636,98.8019641174,_100,3,>100
7536,waitin,161,26724797,98.8025593403,_100,6,>100
7537,boulder,161,26724958,98.8031545632,_100,7,>100
7538,gah,161,26725119,98.8037497862,_100,3,>100
7539,ruth,161,26725280,98.8043450091,_100,4,>100
7540,nl,161,26725441,98.804940232,_100,2,>100
7541,anchor,161,26725602,98.805535455,_100,6,>100
7542,referral,161,26725763,98.8061306779,_100,8,>100
7543,accomplishments,161,26725924,98.8067259008,_100,15,>100
7544,lucy,161,26726085,98.8073211238,_100,4,>100
7545,algebra,161,26726246,98.8079163467,_100,7,>100
7546,scotch,161,26726407,98.8085115696,_100,6,>100
7547,jenna,161,26726568,98.8091067926,_100,5,>100
7548,redesign,161,26726729,98.8097020155,_100,8,>100
7549,jfk,161,26726890,98.8102972384,_100,3,>100
7550,apr,161,26727051,98.8108924614,_100,3,>100
7551,landscape,161,26727212,98.8114876843,_100,9,>100
7552,rejected,161,26727373,98.8120829072,_100,8,>100
7553,hush,161,26727534,98.8126781302,_100,4,>100
7554,eager,161,26727695,98.8132733531,_100,5,>100
7555,sr,161,26727856,98.813868576,_100,2,>100
7556,pickles,161,26728017,98.814463799,_100,7,>100
7557,scientists,161,26728178,98.8150590219,_100,10,>100
7558,condolences,161,26728339,98.8156542448,_100,11,>100
7559,relaxed,161,26728500,98.8162494678,_100,7,>100
7560,notebook,161,26728661,98.8168446907,_100,8,>100
7561,cone,161,26728822,98.8174399136,_100,4,>100
7562,dt,161,26728983,98.8180351366,_100,2,>100
7563,rhythm,161,26729144,98.8186303595,_100,6,>100
7564,barbie,161,26729305,98.8192255824,_100,6,>100
7565,metaphor,161,26729466,98.8198208054,_100,8,>100
7566,costco,161,26729627,98.8204160283,_100,6,>100
7567,wkend,161,26729788,98.8210112512,_100,5,>100
7568,dumped,161,26729949,98.8216064742,_100,6,>100
7569,nats,161,26730110,98.8222016971,_100,4,>100
7570,thoreau,160,26730270,98.822793223,_100,7,>100
7571,edison,160,26730430,98.8233847489,_100,6,>100
7572,payne,160,26730590,98.8239762748,_100,5,>100
7573,judgment,160,26730750,98.8245678007,_100,8,>100
7574,pennsylvania,160,26730910,98.8251593266,_100,12,>100
7575,efficiency,160,26731070,98.8257508525,_100,10,>100
7576,shifts,160,26731230,98.8263423784,_100,6,>100
7577,160,160,26731390,98.8269339043,_100,3,>100
7578,caribbean,160,26731550,98.8275254302,_100,9,>100
7579,lmaooo,160,26731710,98.8281169561,_100,6,>100
7580,alternate,160,26731870,98.828708482,_100,9,>100
7581,paycheck,160,26732030,98.8293000078,_100,8,>100
7582,donors,160,26732190,98.8298915337,_100,6,>100
7583,cindy,160,26732350,98.8304830596,_100,5,>100
7584,daniels,160,26732510,98.8310745855,_100,7,>100
7585,shelby,160,26732670,98.8316661114,_100,6,>100
7586,pup,160,26732830,98.8322576373,_100,3,>100
7587,installation,160,26732990,98.8328491632,_100,12,>100
7588,nom,160,26733150,98.8334406891,_100,3,>100
7589,hipsters,160,26733310,98.834032215,_100,8,>100
7590,lombardi,160,26733470,98.8346237409,_100,8,>100
7591,hittin,160,26733630,98.8352152668,_100,6,>100
7592,tale,160,26733790,98.8358067927,_100,4,>100
7593,mindset,160,26733950,98.8363983186,_100,7,>100
7594,harlem,160,26734110,98.8369898445,_100,6,>100
7595,genuinely,159,26734269,98.8375776734,_100,9,>100
7596,judged,159,26734428,98.8381655022,_100,6,>100
7597,walt,159,26734587,98.8387533311,_100,4,>100
7598,storytelling,159,26734746,98.8393411599,_100,12,>100
7599,alter,159,26734905,98.8399289888,_100,5,>100
7600,difficulty,159,26735064,98.8405168177,_100,10,>100
7601,legally,159,26735223,98.8411046465,_100,7,>100
7602,swedish,159,26735382,98.8416924754,_100,7,>100
7603,straw,159,26735541,98.8422803042,_100,5,>100
7604,petty,159,26735700,98.8428681331,_100,5,>100
7605,dignity,159,26735859,98.843455962,_100,7,>100
7606,sittin,159,26736018,98.8440437908,_100,6,>100
7607,beaten,159,26736177,98.8446316197,_100,6,>100
7608,offseason,159,26736336,98.8452194485,_100,9,>100
7609,condoms,159,26736495,98.8458072774,_100,7,>100
7610,gandhi,159,26736654,98.8463951062,_100,6,>100
7611,notre,159,26736813,98.8469829351,_100,5,>100
7612,pbr,159,26736972,98.847570764,_100,3,>100
7613,crave,159,26737131,98.8481585928,_100,5,>100
7614,divide,159,26737290,98.8487464217,_100,6,>100
7615,lori,159,26737449,98.8493342505,_100,4,>100
7616,engineering,158,26737607,98.8499183824,_100,11,>100
7617,beautifully,158,26737765,98.8505025142,_100,11,>100
7618,eff,158,26737923,98.851086646,_100,3,>100
7619,puzzle,158,26738081,98.8516707778,_100,6,>100
7620,caroline,158,26738239,98.8522549097,_100,8,>100
7621,bristol,158,26738397,98.8528390415,_100,7,>100
7622,reynolds,158,26738555,98.8534231733,_100,8,>100
7623,symptoms,158,26738713,98.8540073051,_100,8,>100
7624,biology,158,26738871,98.8545914369,_100,7,>100
7625,layer,158,26739029,98.8551755688,_100,5,>100
7626,conduct,158,26739187,98.8557597006,_100,7,>100
7627,harold,158,26739345,98.8563438324,_100,6,>100
7628,struggles,158,26739503,98.8569279642,_100,9,>100
7629,banquet,158,26739661,98.8575120961,_100,7,>100
7630,ministry,158,26739819,98.8580962279,_100,8,>100
7631,russia,158,26739977,98.8586803597,_100,6,>100
7632,folder,158,26740135,98.8592644915,_100,6,>100
7633,frequent,158,26740293,98.8598486233,_100,8,>100
7634,parenting,158,26740451,98.8604327552,_100,9,>100
7635,chopped,158,26740609,98.861016887,_100,7,>100
7636,pains,158,26740767,98.8616010188,_100,5,>100
7637,homo,158,26740925,98.8621851506,_100,4,>100
7638,anaheim,158,26741083,98.8627692825,_100,7,>100
7639,peas,158,26741241,98.8633534143,_100,4,>100
7640,sesh,158,26741399,98.8639375461,_100,4,>100
7641,hyped,158,26741557,98.8645216779,_100,5,>100
7642,biting,157,26741714,98.8651021127,_100,6,>100
7643,bruno,157,26741871,98.8656825475,_100,5,>100
7644,grabs,157,26742028,98.8662629823,_100,5,>100
7645,gt,157,26742185,98.8668434171,_100,2,>100
7646,recruit,157,26742342,98.8674238519,_100,7,>100
7647,breed,157,26742499,98.8680042866,_100,5,>100
7648,cox,157,26742656,98.8685847214,_100,3,>100
7649,dorm,157,26742813,98.8691651562,_100,4,>100
7650,canyon,157,26742970,98.869745591,_100,6,>100
7651,muffin,157,26743127,98.8703260258,_100,6,>100
7652,simultaneously,157,26743284,98.8709064606,_100,14,>100
7653,breakdown,157,26743441,98.8714868954,_100,9,>100
7654,wud,157,26743598,98.8720673301,_100,3,>100
7655,remarks,157,26743755,98.8726477649,_100,7,>100
7656,troubles,157,26743912,98.8732281997,_100,8,>100
7657,commerce,157,26744069,98.8738086345,_100,8,>100
7658,waving,157,26744226,98.8743890693,_100,6,>100
7659,rod,157,26744383,98.8749695041,_100,3,>100
7660,charleston,157,26744540,98.8755499389,_100,10,>100
7661,ships,157,26744697,98.8761303736,_100,5,>100
7662,lining,157,26744854,98.8767108084,_100,6,>100
7663,chains,156,26745010,98.8772875462,_100,6,>100
7664,slices,156,26745166,98.8778642839,_100,6,>100
7665,overly,156,26745322,98.8784410217,_100,6,>100
7666,ziglar,156,26745478,98.8790177594,_100,6,>100
7667,irritating,156,26745634,98.8795944972,_100,10,>100
7668,tshirt,156,26745790,98.8801712349,_100,6,>100
7669,raven,156,26745946,98.8807479727,_100,5,>100
7670,driveway,156,26746102,98.8813247104,_100,8,>100
7671,fare,156,26746258,98.8819014482,_100,4,>100
7672,pony,156,26746414,98.8824781859,_100,4,>100
7673,fond,156,26746570,98.8830549237,_100,4,>100
7674,sleeves,156,26746726,98.8836316614,_100,7,>100
7675,adrian,156,26746882,98.8842083992,_100,6,>100
7676,carries,156,26747038,98.8847851369,_100,7,>100
7677,obstacles,156,26747194,98.8853618747,_100,9,>100
7678,crashes,156,26747350,98.8859386124,_100,7,>100
7679,kiddos,156,26747506,98.8865153502,_100,6,>100
7680,olivia,156,26747662,98.8870920879,_100,6,>100
7681,shaq,156,26747818,98.8876688256,_100,4,>100
7682,azz,156,26747974,98.8882455634,_100,3,>100
7683,believer,156,26748130,98.8888223011,_100,8,>100
7684,troll,156,26748286,98.8893990389,_100,5,>100
7685,flipped,156,26748442,98.8899757766,_100,7,>100
7686,crawford,156,26748598,98.8905525144,_100,8,>100
7687,jealousy,156,26748754,98.8911292521,_100,8,>100
7688,zip,156,26748910,98.8917059899,_100,3,>100
7689,perkins,156,26749066,98.8922827276,_100,7,>100
7690,tsa,156,26749222,98.8928594654,_100,3,>100
7691,coo,156,26749378,98.8934362031,_100,3,>100
7692,deficit,156,26749534,98.8940129409,_100,7,>100
7693,undergrad,156,26749690,98.8945896786,_100,9,>100
7694,danielle,156,26749846,98.8951664164,_100,8,>100
7695,dial,155,26750001,98.8957394571,_100,4,>100
7696,contemporary,155,26750156,98.8963124978,_100,12,>100
7697,pam,155,26750311,98.8968855385,_100,3,>100
7698,mustard,155,26750466,98.8974585792,_100,7,>100
7699,diablo,155,26750621,98.8980316199,_100,6,>100
7700,cuddling,155,26750776,98.8986046607,_100,8,>100
7701,safer,155,26750931,98.8991777014,_100,5,>100
7702,muffins,155,26751086,98.8997507421,_100,7,>100
7703,guru,155,26751241,98.9003237828,_100,4,>100
7704,claimed,155,26751396,98.9008968235,_100,7,>100
7705,consideration,155,26751551,98.9014698642,_100,13,>100
7706,advertise,155,26751706,98.9020429049,_100,9,>100
7707,fills,155,26751861,98.9026159456,_100,5,>100
7708,editorial,155,26752016,98.9031889863,_100,9,>100
7709,notices,155,26752171,98.9037620271,_100,7,>100
7710,statistics,155,26752326,98.9043350678,_100,10,>100
7711,hectic,155,26752481,98.9049081085,_100,6,>100
7712,veteran,155,26752636,98.9054811492,_100,7,>100
7713,buddha,155,26752791,98.9060541899,_100,6,>100
7714,cheddar,155,26752946,98.9066272306,_100,7,>100
7715,hott,155,26753101,98.9072002713,_100,4,>100
7716,hughes,155,26753256,98.907773312,_100,6,>100
7717,andrea,155,26753411,98.9083463528,_100,6,>100
7718,vacuum,155,26753566,98.9089193935,_100,6,>100
7719,djs,155,26753721,98.9094924342,_100,3,>100
7720,freelance,155,26753876,98.9100654749,_100,9,>100
7721,estimate,155,26754031,98.9106385156,_100,8,>100
7722,prospects,155,26754186,98.9112115563,_100,9,>100
7723,contributions,155,26754341,98.911784597,_100,13,>100
7724,matthews,154,26754495,98.9123539407,_100,8,>100
7725,indoors,154,26754649,98.9129232844,_100,7,>100
7726,alcoholic,154,26754803,98.9134926281,_100,9,>100
7727,haunted,154,26754957,98.9140619717,_100,7,>100
7728,zumba,154,26755111,98.9146313154,_100,5,>100
7729,patterns,154,26755265,98.9152006591,_100,8,>100
7730,cranky,154,26755419,98.9157700028,_100,6,>100
7731,pigs,154,26755573,98.9163393464,_100,4,>100
7732,preservation,154,26755727,98.9169086901,_100,12,>100
7733,maggie,154,26755881,98.9174780338,_100,6,>100
7734,nina,154,26756035,98.9180473775,_100,4,>100
7735,tj,154,26756189,98.9186167211,_100,2,>100
7736,technologies,154,26756343,98.9191860648,_100,12,>100
7737,satisfaction,154,26756497,98.9197554085,_100,12,>100
7738,autocorrect,154,26756651,98.9203247522,_100,11,>100
7739,dexter,154,26756805,98.9208940958,_100,6,>100
7740,suggesting,154,26756959,98.9214634395,_100,10,>100
7741,icing,154,26757113,98.9220327832,_100,5,>100
7742,malcolm,154,26757267,98.9226021269,_100,7,>100
7743,flesh,154,26757421,98.9231714705,_100,5,>100
7744,shouting,154,26757575,98.9237408142,_100,8,>100
7745,dakota,154,26757729,98.9243101579,_100,6,>100
7746,helicopter,154,26757883,98.9248795016,_100,10,>100
7747,seafood,154,26758037,98.9254488452,_100,7,>100
7748,ant,154,26758191,98.9260181889,_100,3,>100
7749,handles,154,26758345,98.9265875326,_100,7,>100
7750,grader,154,26758499,98.9271568763,_100,6,>100
7751,buzzing,154,26758653,98.9277262199,_100,7,>100
7752,forbes,154,26758807,98.9282955636,_100,6,>100
7753,earning,154,26758961,98.9288649073,_100,7,>100
7754,photograph,154,26759115,98.929434251,_100,10,>100
7755,biscuits,154,26759269,98.9300035946,_100,8,>100
7756,slavery,154,26759423,98.9305729383,_100,7,>100
7757,pins,154,26759577,98.931142282,_100,4,>100
7758,deaf,154,26759731,98.9317116257,_100,4,>100
7759,shaved,154,26759885,98.9322809693,_100,6,>100
7760,stressing,154,26760039,98.932850313,_100,9,>100
7761,expansion,154,26760193,98.9334196567,_100,9,>100
7762,amusing,154,26760347,98.9339890004,_100,7,>100
7763,jamaica,154,26760501,98.934558344,_100,7,>100
7764,clocks,153,26760654,98.9351239907,_100,6,>100
7765,coughing,153,26760807,98.9356896373,_100,8,>100
7766,scheme,153,26760960,98.9362552839,_100,6,>100
7767,unicorn,153,26761113,98.9368209306,_100,7,>100
7768,hahaa,153,26761266,98.9373865772,_100,5,>100
7769,aisle,153,26761419,98.9379522239,_100,5,>100
7770,tweetin,153,26761572,98.9385178705,_100,7,>100
7771,conrad,153,26761725,98.9390835171,_100,6,>100
7772,locals,153,26761878,98.9396491638,_100,6,>100
7773,sentences,153,26762031,98.9402148104,_100,9,>100
7774,radical,153,26762184,98.940780457,_100,7,>100
7775,sista,153,26762337,98.9413461037,_100,5,>100
7776,bangs,153,26762490,98.9419117503,_100,5,>100
7777,mysterious,153,26762643,98.942477397,_100,10,>100
7778,soak,153,26762796,98.9430430436,_100,4,>100
7779,draws,153,26762949,98.9436086902,_100,5,>100
7780,postponed,153,26763102,98.9441743369,_100,9,>100
7781,tossed,153,26763255,98.9447399835,_100,6,>100
7782,gladly,153,26763408,98.9453056302,_100,6,>100
7783,zig,153,26763561,98.9458712768,_100,3,>100
7784,tbh,153,26763714,98.9464369234,_100,3,>100
7785,loosing,153,26763867,98.9470025701,_100,7,>100
7786,disrespectful,153,26764020,98.9475682167,_100,13,>100
7787,irving,153,26764173,98.9481338633,_100,6,>100
7788,spite,153,26764326,98.94869951,_100,5,>100
7789,sandals,153,26764479,98.9492651566,_100,7,>100
7790,owl,153,26764632,98.9498308033,_100,3,>100
7791,pond,153,26764785,98.9503964499,_100,4,>100
7792,predicted,153,26764938,98.9509620965,_100,9,>100
7793,usher,153,26765091,98.9515277432,_100,5,>100
7794,unite,153,26765244,98.9520933898,_100,5,>100
7795,tatted,153,26765397,98.9526590365,_100,6,>100
7796,nationals,153,26765550,98.9532246831,_100,9,>100
7797,finishes,153,26765703,98.9537903297,_100,8,>100
7798,scandal,153,26765856,98.9543559764,_100,7,>100
7799,favourite,153,26766009,98.954921623,_100,9,>100
7800,nyu,152,26766161,98.9554835726,_100,3,>100
7801,convos,152,26766313,98.9560455222,_100,6,>100
7802,rehearsals,152,26766465,98.9566074718,_100,10,>100
7803,jc,152,26766617,98.9571694214,_100,2,>100
7804,prospect,152,26766769,98.957731371,_100,8,>100
7805,declare,152,26766921,98.9582933206,_100,7,>100
7806,fur,152,26767073,98.9588552702,_100,3,>100
7807,controls,152,26767225,98.9594172198,_100,8,>100
7808,weddings,152,26767377,98.9599791694,_100,8,>100
7809,leagues,152,26767529,98.960541119,_100,7,>100
7810,martha,152,26767681,98.9611030686,_100,6,>100
7811,inconvenience,152,26767833,98.9616650182,_100,13,>100
7812,poo,152,26767985,98.9622269678,_100,3,>100
7813,sanity,152,26768137,98.9627889174,_100,6,>100
7814,symbol,152,26768289,98.963350867,_100,6,>100
7815,invention,152,26768441,98.9639128166,_100,9,>100
7816,doo,152,26768593,98.9644747662,_100,3,>100
7817,quarterback,152,26768745,98.9650367158,_100,11,>100
7818,threats,152,26768897,98.9655986654,_100,7,>100
7819,slogan,152,26769049,98.966160615,_100,6,>100
7820,nationwide,152,26769201,98.9667225646,_100,10,>100
7821,craziness,152,26769353,98.9672845142,_100,9,>100
7822,jog,152,26769505,98.9678464638,_100,3,>100
7823,manual,152,26769657,98.9684084134,_100,6,>100
7824,paranoid,152,26769809,98.968970363,_100,8,>100
7825,listings,152,26769961,98.9695323126,_100,8,>100
7826,engineers,152,26770113,98.9700942622,_100,9,>100
7827,explained,152,26770265,98.9706562118,_100,9,>100
7828,swiss,152,26770417,98.9712181614,_100,5,>100
7829,nachos,152,26770569,98.971780111,_100,6,>100
7830,marketers,152,26770721,98.9723420606,_100,9,>100
7831,abortion,152,26770873,98.9729040102,_100,8,>100
7832,marvin,152,26771025,98.9734659598,_100,6,>100
7833,surfing,152,26771177,98.9740279094,_100,7,>100
7834,salads,152,26771329,98.9745898591,_100,6,>100
7835,resting,152,26771481,98.9751518087,_100,7,>100
7836,pale,152,26771633,98.9757137583,_100,4,>100
7837,testimony,152,26771785,98.9762757079,_100,9,>100
7838,scent,152,26771937,98.9768376575,_100,5,>100
7839,intentions,152,26772089,98.9773996071,_100,10,>100
7840,honoring,152,26772241,98.9779615567,_100,8,>100
7841,nod,152,26772393,98.9785235063,_100,3,>100
7842,rear,152,26772545,98.9790854559,_100,4,>100
7843,nonetheless,152,26772697,98.9796474055,_100,11,>100
7844,wii,152,26772849,98.9802093551,_100,3,>100
7845,sized,152,26773001,98.9807713047,_100,5,>100
7846,outlets,152,26773153,98.9813332543,_100,7,>100
7847,broadcasting,152,26773305,98.9818952039,_100,12,>100
7848,irs,151,26773456,98.9824534564,_100,3,>100
7849,rained,151,26773607,98.983011709,_100,6,>100
7850,spotlight,151,26773758,98.9835699616,_100,9,>100
7851,maxwell,151,26773909,98.9841282141,_100,7,>100
7852,hv,151,26774060,98.9846864667,_100,2,>100
7853,acid,151,26774211,98.9852447193,_100,4,>100
7854,numb,151,26774362,98.9858029718,_100,4,>100
7855,madrid,151,26774513,98.9863612244,_100,6,>100
7856,polite,151,26774664,98.9869194769,_100,6,>100
7857,rank,151,26774815,98.9874777295,_100,4,>100
7858,intensity,151,26774966,98.9880359821,_100,9,>100
7859,shutting,151,26775117,98.9885942346,_100,8,>100
7860,kickstarter,151,26775268,98.9891524872,_100,11,>100
7861,compromise,151,26775419,98.9897107398,_100,10,>100
7862,creatures,151,26775570,98.9902689923,_100,9,>100
7863,jeffrey,151,26775721,98.9908272449,_100,7,>100
7864,interior,151,26775872,98.9913854975,_100,8,>100
7865,westbrook,151,26776023,98.99194375,_100,9,>100
7866,tapes,151,26776174,98.9925020026,_100,5,>100
7867,stab,151,26776325,98.9930602552,_100,4,>100
7868,livin,151,26776476,98.9936185077,_100,5,>100
7869,ins,151,26776627,98.9941767603,_100,3,>100
7870,sword,151,26776778,98.9947350129,_100,5,>100
7871,accountability,151,26776929,98.9952932654,_100,14,>100
7872,scotland,151,26777080,98.995851518,_100,8,>100
7873,neon,151,26777231,98.9964097705,_100,4,>100
7874,whipped,151,26777382,98.9969680231,_100,7,>100
7875,beds,151,26777533,98.9975262757,_100,4,>100
7876,neva,151,26777684,98.9980845282,_100,4,>100
7877,bothers,151,26777835,98.9986427808,_100,7,>100
7878,oomf,151,26777986,98.9992010334,_100,4,>100
7879,totes,151,26778137,98.9997592859,_100,5,>100
7880,seating,151,26778288,99.0003175385,_100,7,>100
7881,represents,151,26778439,99.0008757911,_100,10,>100
7882,catchy,151,26778590,99.0014340436,_100,6,>100
7883,fabric,151,26778741,99.0019922962,_100,6,>100
7884,schedules,150,26778891,99.0025468517,_100,9,>100
7885,appreciates,150,26779041,99.0031014072,_100,11,>100
7886,henderson,150,26779191,99.0036559628,_100,9,>100
7887,backstage,150,26779341,99.0042105183,_100,9,>100
7888,combat,150,26779491,99.0047650738,_100,6,>100
7889,progressive,150,26779641,99.0053196294,_100,11,>100
7890,150,150,26779791,99.0058741849,_100,3,>100
7891,pickupline,150,26779941,99.0064287404,_100,10,>100
7892,decline,150,26780091,99.0069832959,_100,7,>100
7893,spamming,150,26780241,99.0075378515,_100,8,>100
7894,pinch,150,26780391,99.008092407,_100,5,>100
7895,rooftop,150,26780541,99.0086469625,_100,7,>100
7896,crushing,150,26780691,99.009201518,_100,8,>100
7897,stages,150,26780841,99.0097560736,_100,6,>100
7898,founded,150,26780991,99.0103106291,_100,7,>100
7899,arsenal,150,26781141,99.0108651846,_100,7,>100
7900,contests,150,26781291,99.0114197402,_100,8,>100
7901,functional,150,26781441,99.0119742957,_100,10,>100
7902,bach,150,26781591,99.0125288512,_100,4,>100
7903,hers,150,26781741,99.0130834067,_100,4,>100
7904,diamonds,150,26781891,99.0136379623,_100,8,>100
7905,oj,150,26782041,99.0141925178,_100,2,>100
7906,critics,150,26782191,99.0147470733,_100,7,>100
7907,og,150,26782341,99.0153016289,_100,2,>100
7908,mah,150,26782491,99.0158561844,_100,3,>100
7909,diy,149,26782640,99.0164070429,_100,3,>100
7910,completion,149,26782789,99.0169579014,_100,10,>100
7911,venice,149,26782938,99.0175087599,_100,6,>100
7912,craziest,149,26783087,99.0180596183,_100,8,>100
7913,outreach,149,26783236,99.0186104768,_100,8,>100
7914,dee,149,26783385,99.0191613353,_100,3,>100
7915,tokyo,149,26783534,99.0197121938,_100,5,>100
7916,dances,149,26783683,99.0202630523,_100,6,>100
7917,drupal,149,26783832,99.0208139108,_100,6,>100
7918,consumption,149,26783981,99.0213647693,_100,11,>100
7919,realization,149,26784130,99.0219156278,_100,11,>100
7920,stl,149,26784279,99.0224664863,_100,3,>100
7921,kiddo,149,26784428,99.0230173448,_100,5,>100
7922,miranda,149,26784577,99.0235682033,_100,7,>100
7923,kane,149,26784726,99.0241190617,_100,4,>100
7924,tagged,149,26784875,99.0246699202,_100,6,>100
7925,hispanic,149,26785024,99.0252207787,_100,8,>100
7926,manner,149,26785173,99.0257716372,_100,6,>100
7927,superhero,149,26785322,99.0263224957,_100,9,>100
7928,gangsta,149,26785471,99.0268733542,_100,7,>100
7929,reveals,149,26785620,99.0274242127,_100,7,>100
7930,collapse,149,26785769,99.0279750712,_100,8,>100
7931,underneath,149,26785918,99.0285259297,_100,10,>100
7932,unhealthy,149,26786067,99.0290767882,_100,9,>100
7933,sunscreen,149,26786216,99.0296276466,_100,9,>100
7934,clowns,149,26786365,99.0301785051,_100,6,>100
7935,napoleon,149,26786514,99.0307293636,_100,8,>100
7936,shld,149,26786663,99.0312802221,_100,4,>100
7937,ion,149,26786812,99.0318310806,_100,3,>100
7938,julian,148,26786960,99.0323782421,_100,6,>100
7939,refuses,148,26787108,99.0329254035,_100,7,>100
7940,disappeared,148,26787256,99.033472565,_100,11,>100
7941,lasting,148,26787404,99.0340197264,_100,7,>100
7942,powell,148,26787552,99.0345668879,_100,6,>100
7943,administration,148,26787700,99.0351140493,_100,14,>100
7944,socially,148,26787848,99.0356612108,_100,8,>100
7945,aging,148,26787996,99.0362083722,_100,5,>100
7946,addressed,148,26788144,99.0367555337,_100,9,>100
7947,listeners,148,26788292,99.0373026952,_100,9,>100
7948,specialty,148,26788440,99.0378498566,_100,9,>100
7949,nikki,148,26788588,99.0383970181,_100,5,>100
7950,hyper,148,26788736,99.0389441795,_100,5,>100
7951,freddie,148,26788884,99.039491341,_100,7,>100
7952,ringtone,148,26789032,99.0400385024,_100,8,>100
7953,complaint,148,26789180,99.0405856639,_100,9,>100
7954,guidance,148,26789328,99.0411328253,_100,8,>100
7955,mere,148,26789476,99.0416799868,_100,4,>100
7956,bishop,148,26789624,99.0422271482,_100,6,>100
7957,puff,148,26789772,99.0427743097,_100,4,>100
7958,kendall,148,26789920,99.0433214711,_100,7,>100
7959,dome,148,26790068,99.0438686326,_100,4,>100
7960,despise,148,26790216,99.0444157941,_100,7,>100
7961,artistic,148,26790364,99.0449629555,_100,8,>100
7962,scam,148,26790512,99.045510117,_100,4,>100
7963,nook,148,26790660,99.0460572784,_100,4,>100
7964,substance,148,26790808,99.0466044399,_100,9,>100
7965,scientific,148,26790956,99.0471516013,_100,10,>100
7966,metrics,148,26791104,99.0476987628,_100,7,>100
7967,tempting,148,26791252,99.0482459242,_100,8,>100
7968,zac,148,26791400,99.0487930857,_100,3,>100
7969,democratic,148,26791548,99.0493402471,_100,10,>100
7970,turnovers,148,26791696,99.0498874086,_100,9,>100
7971,packet,147,26791843,99.050430873,_100,6,>100
7972,sincere,147,26791990,99.0509743374,_100,7,>100
7973,delaware,147,26792137,99.0515178018,_100,8,>100
7974,essence,147,26792284,99.0520612663,_100,7,>100
7975,canon,147,26792431,99.0526047307,_100,5,>100
7976,crimes,147,26792578,99.0531481951,_100,6,>100
7977,peep,147,26792725,99.0536916595,_100,4,>100
7978,restroom,147,26792872,99.0542351239,_100,8,>100
7979,installing,147,26793019,99.0547785883,_100,10,>100
7980,grammys,147,26793166,99.0553220528,_100,7,>100
7981,wink,147,26793313,99.0558655172,_100,4,>100
7982,waits,147,26793460,99.0564089816,_100,5,>100
7983,weds,147,26793607,99.056952446,_100,4,>100
7984,mandatory,147,26793754,99.0574959104,_100,9,>100
7985,smallest,147,26793901,99.0580393748,_100,8,>100
7986,mixer,147,26794048,99.0585828393,_100,5,>100
7987,cleaner,147,26794195,99.0591263037,_100,7,>100
7988,vent,147,26794342,99.0596697681,_100,4,>100
7989,burton,147,26794489,99.0602132325,_100,6,>100
7990,guinness,147,26794636,99.0607566969,_100,8,>100
7991,abandoned,147,26794783,99.0613001613,_100,9,>100
7992,alicia,147,26794930,99.0618436258,_100,6,>100
7993,excessive,147,26795077,99.0623870902,_100,9,>100
7994,unions,147,26795224,99.0629305546,_100,6,>100
7995,oy,147,26795371,99.063474019,_100,2,>100
7996,deets,147,26795518,99.0640174834,_100,5,>100
7997,nh,147,26795665,99.0645609479,_100,2,>100
7998,operating,147,26795812,99.0651044123,_100,9,>100
7999,vernon,146,26795958,99.0656441796,_100,6,>100
8000,doritos,146,26796104,99.066183947,_100,7,>100
8001,colorful,146,26796250,99.0667237144,_100,8,>100
8002,gots,146,26796396,99.0672634818,_100,4,>100
8003,economics,146,26796542,99.0678032492,_100,9,>100
8004,balcony,146,26796688,99.0683430166,_100,7,>100
8005,hangin,146,26796834,99.0688827839,_100,6,>100
8006,courts,146,26796980,99.0694225513,_100,6,>100
8007,gras,146,26797126,99.0699623187,_100,4,>100
8008,coaster,146,26797272,99.0705020861,_100,7,>100
8009,resistance,146,26797418,99.0710418535,_100,10,>100
8010,smartest,146,26797564,99.0715816208,_100,8,>100
8011,honors,146,26797710,99.0721213882,_100,6,>100
8012,ladder,146,26797856,99.0726611556,_100,6,>100
8013,centers,146,26798002,99.073200923,_100,7,>100
8014,factors,146,26798148,99.0737406904,_100,7,>100
8015,brent,146,26798294,99.0742804577,_100,5,>100
8016,judgement,146,26798440,99.0748202251,_100,9,>100
8017,aloha,146,26798586,99.0753599925,_100,5,>100
8018,jenkins,146,26798732,99.0758997599,_100,7,>100
8019,js,146,26798878,99.0764395273,_100,2,>100
8020,pumping,146,26799024,99.0769792946,_100,7,>100
8021,boundaries,146,26799170,99.077519062,_100,10,>100
8022,chickens,146,26799316,99.0780588294,_100,8,>100
8023,reactions,146,26799462,99.0785985968,_100,9,>100
8024,blackout,145,26799607,99.0791346671,_100,8,>100
8025,recession,145,26799752,99.0796707375,_100,9,>100
8026,playground,145,26799897,99.0802068078,_100,10,>100
8027,restore,145,26800042,99.0807428781,_100,7,>100
8028,engineer,145,26800187,99.0812789485,_100,8,>100
8029,leak,145,26800332,99.0818150188,_100,4,>100
8030,frog,145,26800477,99.0823510892,_100,4,>100
8031,prescription,145,26800622,99.0828871595,_100,12,>100
8032,grandfather,145,26800767,99.0834232299,_100,11,>100
8033,performer,145,26800912,99.0839593002,_100,9,>100
8034,sherlock,145,26801057,99.0844953706,_100,8,>100
8035,mouths,145,26801202,99.0850314409,_100,6,>100
8036,ai,145,26801347,99.0855675112,_100,2,>100
8037,reserved,145,26801492,99.0861035816,_100,8,>100
8038,achieving,145,26801637,99.0866396519,_100,9,>100
8039,chats,145,26801782,99.0871757223,_100,5,>100
8040,wizards,145,26801927,99.0877117926,_100,7,>100
8041,tales,145,26802072,99.088247863,_100,5,>100
8042,verdict,145,26802217,99.0887839333,_100,7,>100
8043,avery,145,26802362,99.0893200036,_100,5,>100
8044,tuition,145,26802507,99.089856074,_100,7,>100
8045,terminal,145,26802652,99.0903921443,_100,8,>100
8046,corny,145,26802797,99.0909282147,_100,5,>100
8047,myers,145,26802942,99.091464285,_100,5,>100
8048,extensions,145,26803087,99.0920003554,_100,10,>100
8049,erica,145,26803232,99.0925364257,_100,5,>100
8050,mann,145,26803377,99.093072496,_100,4,>100
8051,misery,145,26803522,99.0936085664,_100,6,>100
8052,cease,145,26803667,99.0941446367,_100,5,>100
8053,mariners,145,26803812,99.0946807071,_100,8,>100
8054,robots,145,26803957,99.0952167774,_100,6,>100
8055,denial,145,26804102,99.0957528478,_100,6,>100
8056,michele,145,26804247,99.0962889181,_100,7,>100
8057,bastards,145,26804392,99.0968249884,_100,8,>100
8058,carrot,145,26804537,99.0973610588,_100,6,>100
8059,transformation,145,26804682,99.0978971291,_100,14,>100
8060,becuz,145,26804827,99.0984331995,_100,5,>100
8061,criticize,145,26804972,99.0989692698,_100,9,>100
8062,rebel,145,26805117,99.0995053402,_100,5,>100
8063,reel,144,26805261,99.1000377135,_100,4,>100
8064,noo,144,26805405,99.1005700868,_100,3,>100
8065,iv,144,26805549,99.1011024601,_100,2,>100
8066,commencement,144,26805693,99.1016348334,_100,12,>100
8067,employer,144,26805837,99.1021672067,_100,8,>100
8068,detailed,144,26805981,99.10269958,_100,8,>100
8069,cows,144,26806125,99.1032319533,_100,4,>100
8070,execution,144,26806269,99.1037643266,_100,9,>100
8071,daytona,144,26806413,99.1042966999,_100,7,>100
8072,avocado,144,26806557,99.1048290732,_100,7,>100
8073,belieber,144,26806701,99.1053614465,_100,8,>100
8074,bridges,144,26806845,99.1058938198,_100,7,>100
8075,greedy,144,26806989,99.1064261932,_100,6,>100
8076,apartments,144,26807133,99.1069585665,_100,10,>100
8077,formed,144,26807277,99.1074909398,_100,6,>100
8078,stamps,144,26807421,99.1080233131,_100,6,>100
8079,concepts,144,26807565,99.1085556864,_100,8,>100
8080,hysterical,144,26807709,99.1090880597,_100,10,>100
8081,periods,144,26807853,99.109620433,_100,7,>100
8082,announcer,144,26807997,99.1101528063,_100,9,>100
8083,trent,144,26808141,99.1106851796,_100,5,>100
8084,rting,144,26808285,99.1112175529,_100,5,>100
8085,mentality,144,26808429,99.1117499262,_100,9,>100
8086,midterm,144,26808573,99.1122822995,_100,7,>100
8087,hulu,144,26808717,99.1128146728,_100,4,>100
8088,pillows,144,26808861,99.1133470461,_100,7,>100
8089,tutorial,144,26809005,99.1138794194,_100,8,>100
8090,coin,144,26809149,99.1144117927,_100,4,>100
8091,sandy,144,26809293,99.1149441661,_100,5,>100
8092,bp,143,26809436,99.1154728423,_100,2,>100
8093,directing,143,26809579,99.1160015186,_100,9,>100
8094,logical,143,26809722,99.1165301949,_100,7,>100
8095,measures,143,26809865,99.1170588711,_100,8,>100
8096,cavs,143,26810008,99.1175875474,_100,4,>100
8097,firefox,143,26810151,99.1181162237,_100,7,>100
8098,vanessa,143,26810294,99.1186448999,_100,7,>100
8099,generate,143,26810437,99.1191735762,_100,8,>100
8100,protests,143,26810580,99.1197022525,_100,8,>100
8101,respected,143,26810723,99.1202309288,_100,9,>100
8102,bobcats,143,26810866,99.120759605,_100,7,>100
8103,palace,143,26811009,99.1212882813,_100,6,>100
8104,brownie,143,26811152,99.1218169576,_100,7,>100
8105,airs,143,26811295,99.1223456338,_100,4,>100
8106,gloomy,143,26811438,99.1228743101,_100,6,>100
8107,preserve,143,26811581,99.1234029864,_100,8,>100
8108,toll,143,26811724,99.1239316626,_100,4,>100
8109,marching,143,26811867,99.1244603389,_100,8,>100
8110,mute,143,26812010,99.1249890152,_100,4,>100
8111,mgmt,143,26812153,99.1255176914,_100,4,>100
8112,padres,143,26812296,99.1260463677,_100,6,>100
8113,goalie,143,26812439,99.126575044,_100,6,>100
8114,143,143,26812582,99.1271037203,_100,3,>100
8115,rebounds,143,26812725,99.1276323965,_100,8,>100
8116,cleanse,143,26812868,99.1281610728,_100,7,>100
8117,rhetoric,143,26813011,99.1286897491,_100,8,>100
8118,profound,143,26813154,99.1292184253,_100,8,>100
8119,pp,143,26813297,99.1297471016,_100,2,>100
8120,goddamn,143,26813440,99.1302757779,_100,7,>100
8121,relieved,143,26813583,99.1308044541,_100,8,>100
8122,deposit,143,26813726,99.1313331304,_100,7,>100
8123,applause,143,26813869,99.1318618067,_100,8,>100
8124,sneezing,143,26814012,99.132390483,_100,8,>100
8125,pope,143,26814155,99.1329191592,_100,4,>100
8126,represented,143,26814298,99.1334478355,_100,11,>100
8127,submitting,143,26814441,99.1339765118,_100,10,>100
8128,clueless,143,26814584,99.134505188,_100,8,>100
8129,lacrosse,143,26814727,99.1350338643,_100,8,>100
8130,msnbc,142,26814869,99.1355588435,_100,5,>100
8131,xoxoxo,142,26815011,99.1360838228,_100,6,>100
8132,hh,142,26815153,99.136608802,_100,2,>100
8133,princeton,142,26815295,99.1371337812,_100,9,>100
8134,mashed,142,26815437,99.1376587605,_100,6,>100
8135,warehouse,142,26815579,99.1381837397,_100,9,>100
8136,bot,142,26815721,99.1387087189,_100,3,>100
8137,approaches,142,26815863,99.1392336982,_100,10,>100
8138,brews,142,26816005,99.1397586774,_100,5,>100
8139,jennings,142,26816147,99.1402836566,_100,8,>100
8140,ash,142,26816289,99.1408086359,_100,3,>100
8141,oddly,142,26816431,99.1413336151,_100,5,>100
8142,scientist,142,26816573,99.1418585943,_100,9,>100
8143,dvds,142,26816715,99.1423835736,_100,4,>100
8144,nest,142,26816857,99.1429085528,_100,4,>100
8145,martini,142,26816999,99.143433532,_100,7,>100
8146,rivalry,142,26817141,99.1439585113,_100,7,>100
8147,tension,142,26817283,99.1444834905,_100,7,>100
8148,controlled,142,26817425,99.1450084697,_100,10,>100
8149,bestfriends,142,26817567,99.145533449,_100,11,>100
8150,intervention,142,26817709,99.1460584282,_100,12,>100
8151,nonprofit,142,26817851,99.1465834074,_100,9,>100
8152,blink,142,26817993,99.1471083867,_100,5,>100
8153,chile,142,26818135,99.1476333659,_100,5,>100
8154,gown,142,26818277,99.1481583451,_100,4,>100
8155,rhymes,142,26818419,99.1486833244,_100,6,>100
8156,barrel,142,26818561,99.1492083036,_100,6,>100
8157,span,142,26818703,99.1497332828,_100,4,>100
8158,promotions,142,26818845,99.1502582621,_100,10,>100
8159,watermelon,142,26818987,99.1507832413,_100,10,>100
8160,brb,142,26819129,99.1513082205,_100,3,>100
8161,gracious,142,26819271,99.1518331998,_100,8,>100
8162,absent,142,26819413,99.152358179,_100,6,>100
8163,acted,142,26819555,99.1528831582,_100,5,>100
8164,planted,142,26819697,99.1534081375,_100,7,>100
8165,jaw,142,26819839,99.1539331167,_100,3,>100
8166,wrigley,142,26819981,99.1544580959,_100,7,>100
8167,scholars,141,26820122,99.1549793781,_100,8,>100
8168,roughly,141,26820263,99.1555006603,_100,7,>100
8169,migraine,141,26820404,99.1560219425,_100,8,>100
8170,amused,141,26820545,99.1565432247,_100,6,>100
8171,cider,141,26820686,99.1570645069,_100,5,>100
8172,shampoo,141,26820827,99.1575857891,_100,7,>100
8173,montgomery,141,26820968,99.1581070713,_100,10,>100
8174,integrated,141,26821109,99.1586283535,_100,10,>100
8175,bun,141,26821250,99.1591496357,_100,3,>100
8176,phenom,141,26821391,99.1596709179,_100,6,>100
8177,conan,141,26821532,99.1601922001,_100,5,>100
8178,chewing,141,26821673,99.1607134823,_100,7,>100
8179,crews,141,26821814,99.1612347645,_100,5,>100
8180,ultimately,141,26821955,99.1617560467,_100,10,>100
8181,prosperity,141,26822096,99.1622773289,_100,10,>100
8182,kittens,141,26822237,99.1627986111,_100,7,>100
8183,dane,141,26822378,99.1633198932,_100,4,>100
8184,hybrid,141,26822519,99.1638411754,_100,6,>100
8185,lik,141,26822660,99.1643624576,_100,3,>100
8186,joys,141,26822801,99.1648837398,_100,4,>100
8187,anti,141,26822942,99.165405022,_100,4,>100
8188,politician,141,26823083,99.1659263042,_100,10,>100
8189,commons,141,26823224,99.1664475864,_100,7,>100
8190,atx,141,26823365,99.1669688686,_100,3,>100
8191,rebound,141,26823506,99.1674901508,_100,7,>100
8192,professors,141,26823647,99.168011433,_100,10,>100
8193,sirens,141,26823788,99.1685327152,_100,6,>100
8194,sponsorship,141,26823929,99.1690539974,_100,11,>100
8195,falcons,141,26824070,99.1695752796,_100,7,>100
8196,vegetable,141,26824211,99.1700965618,_100,9,>100
8197,stunt,141,26824352,99.170617844,_100,5,>100
8198,bipolar,141,26824493,99.1711391262,_100,7,>100
8199,puttin,141,26824634,99.1716604084,_100,6,>100
8200,textbook,141,26824775,99.1721816906,_100,8,>100
8201,infinite,141,26824916,99.1727029728,_100,8,>100
8202,discounted,141,26825057,99.173224255,_100,10,>100
8203,bathing,141,26825198,99.1737455372,_100,7,>100
8204,enforcement,141,26825339,99.1742668194,_100,11,>100
8205,fuzzy,141,26825480,99.1747881016,_100,5,>100
8206,illusion,140,26825620,99.1753056867,_100,8,>100
8207,trails,140,26825760,99.1758232719,_100,6,>100
8208,enhance,140,26825900,99.176340857,_100,7,>100
8209,screams,140,26826040,99.1768584422,_100,7,>100
8210,dre,140,26826180,99.1773760274,_100,3,>100
8211,140,140,26826320,99.1778936125,_100,3,>100
8212,conspiracy,140,26826460,99.1784111977,_100,10,>100
8213,drain,140,26826600,99.1789287828,_100,5,>100
8214,quietly,140,26826740,99.179446368,_100,7,>100
8215,solely,140,26826880,99.1799639532,_100,6,>100
8216,sins,140,26827020,99.1804815383,_100,4,>100
8217,admitted,140,26827160,99.1809991235,_100,8,>100
8218,deaths,140,26827300,99.1815167086,_100,6,>100
8219,mayer,140,26827440,99.1820342938,_100,5,>100
8220,luggage,140,26827580,99.1825518789,_100,7,>100
8221,shook,140,26827720,99.1830694641,_100,5,>100
8222,cory,140,26827860,99.1835870493,_100,4,>100
8223,transform,140,26828000,99.1841046344,_100,9,>100
8224,rats,140,26828140,99.1846222196,_100,4,>100
8225,gucci,140,26828280,99.1851398047,_100,5,>100
8226,psa,140,26828420,99.1856573899,_100,3,>100
8227,canned,140,26828560,99.1861749751,_100,6,>100
8228,publicity,140,26828700,99.1866925602,_100,9,>100
8229,flooding,140,26828840,99.1872101454,_100,8,>100
8230,supper,140,26828980,99.1877277305,_100,6,>100
8231,stylist,140,26829120,99.1882453157,_100,7,>100
8232,ipo,140,26829260,99.1887629009,_100,3,>100
8233,apparent,140,26829400,99.189280486,_100,8,>100
8234,mascot,140,26829540,99.1897980712,_100,6,>100
8235,addressing,140,26829680,99.1903156563,_100,10,>100
8236,consultant,140,26829820,99.1908332415,_100,10,>100
8237,aspects,140,26829960,99.1913508267,_100,7,>100
8238,bachelor,140,26830100,99.1918684118,_100,8,>100
8239,chocolates,140,26830240,99.192385997,_100,10,>100
8240,temporarily,140,26830380,99.1929035821,_100,11,>100
8241,carbs,140,26830520,99.1934211673,_100,5,>100
8242,baptist,140,26830660,99.1939387524,_100,7,>100
8243,kale,140,26830800,99.1944563376,_100,4,>100
8244,researchers,140,26830940,99.1949739228,_100,11,>100
8245,hiking,140,26831080,99.1954915079,_100,6,>100
8246,relaxation,140,26831220,99.1960090931,_100,10,>100
8247,refresh,140,26831360,99.1965266782,_100,7,>100
8248,spears,140,26831500,99.1970442634,_100,6,>100
8249,hence,140,26831640,99.1975618486,_100,5,>100
8250,bonnie,140,26831780,99.1980794337,_100,6,>100
8251,pdf,140,26831920,99.1985970189,_100,3,>100
8252,charter,139,26832059,99.199110907,_100,7,>100
8253,repairs,139,26832198,99.1996247951,_100,7,>100
8254,destruction,139,26832337,99.2001386832,_100,11,>100
8255,previously,139,26832476,99.2006525714,_100,10,>100
8256,shoutouts,139,26832615,99.2011664595,_100,9,>100
8257,dutch,139,26832754,99.2016803476,_100,5,>100
8258,mos,139,26832893,99.2021942357,_100,3,>100
8259,merchandise,139,26833032,99.2027081239,_100,11,>100
8260,deepest,139,26833171,99.203222012,_100,7,>100
8261,miguel,139,26833310,99.2037359001,_100,6,>100
8262,hank,139,26833449,99.2042497882,_100,4,>100
8263,inventory,139,26833588,99.2047636763,_100,9,>100
8264,attempted,139,26833727,99.2052775645,_100,9,>100
8265,representation,139,26833866,99.2057914526,_100,14,>100
8266,sherman,139,26834005,99.2063053407,_100,7,>100
8267,brittany,139,26834144,99.2068192288,_100,8,>100
8268,siblings,139,26834283,99.207333117,_100,8,>100
8269,miracles,139,26834422,99.2078470051,_100,8,>100
8270,streams,139,26834561,99.2083608932,_100,7,>100
8271,bricks,139,26834700,99.2088747813,_100,6,>100
8272,dfw,139,26834839,99.2093886694,_100,3,>100
8273,shelves,139,26834978,99.2099025576,_100,7,>100
8274,pity,139,26835117,99.2104164457,_100,4,>100
8275,duet,139,26835256,99.2109303338,_100,4,>100
8276,intend,139,26835395,99.2114442219,_100,6,>100
8277,intent,139,26835534,99.2119581101,_100,6,>100
8278,grub,139,26835673,99.2124719982,_100,4,>100
8279,limo,139,26835812,99.2129858863,_100,4,>100
8280,clearing,139,26835951,99.2134997744,_100,8,>100
8281,emailing,139,26836090,99.2140136625,_100,8,>100
8282,appealing,139,26836229,99.2145275507,_100,9,>100
8283,engines,139,26836368,99.2150414388,_100,7,>100
8284,cont,139,26836507,99.2155553269,_100,4,>100
8285,elderly,139,26836646,99.216069215,_100,7,>100
8286,roommates,139,26836785,99.2165831032,_100,9,>100
8287,carey,139,26836924,99.2170969913,_100,5,>100
8288,recs,139,26837063,99.2176108794,_100,4,>100
8289,pickle,138,26837201,99.2181210705,_100,6,>100
8290,baldwin,138,26837339,99.2186312616,_100,7,>100
8291,dice,138,26837477,99.2191414527,_100,4,>100
8292,seal,138,26837615,99.2196516437,_100,4,>100
8293,accountable,138,26837753,99.2201618348,_100,11,>100
8294,astros,138,26837891,99.2206720259,_100,6,>100
8295,retiring,138,26838029,99.221182217,_100,8,>100
8296,narrow,138,26838167,99.2216924081,_100,6,>100
8297,supposedly,138,26838305,99.2222025992,_100,10,>100
8298,remarkable,138,26838443,99.2227127903,_100,10,>100
8299,previews,138,26838581,99.2232229813,_100,8,>100
8300,unlock,138,26838719,99.2237331724,_100,6,>100
8301,repeating,138,26838857,99.2242433635,_100,9,>100
8302,qt,138,26838995,99.2247535546,_100,2,>100
8303,processes,138,26839133,99.2252637457,_100,9,>100
8304,geeks,138,26839271,99.2257739368,_100,5,>100
8305,beckett,138,26839409,99.2262841279,_100,7,>100
8306,giddy,138,26839547,99.2267943189,_100,5,>100
8307,calorie,138,26839685,99.22730451,_100,7,>100
8308,christians,138,26839823,99.2278147011,_100,10,>100
8309,corporations,138,26839961,99.2283248922,_100,12,>100
8310,plzz,138,26840099,99.2288350833,_100,4,>100
8311,cynthia,138,26840237,99.2293452744,_100,7,>100
8312,vick,138,26840375,99.2298554655,_100,4,>100
8313,queue,138,26840513,99.2303656565,_100,5,>100
8314,scholarships,138,26840651,99.2308758476,_100,12,>100
8315,sans,138,26840789,99.2313860387,_100,4,>100
8316,slipped,138,26840927,99.2318962298,_100,7,>100
8317,interactions,138,26841065,99.2324064209,_100,12,>100
8318,lmfaoo,138,26841203,99.232916612,_100,6,>100
8319,gifted,138,26841341,99.2334268031,_100,6,>100
8320,nasa,138,26841479,99.2339369941,_100,4,>100
8321,gains,138,26841617,99.2344471852,_100,5,>100
8322,traveled,138,26841755,99.2349573763,_100,8,>100
8323,speeding,138,26841893,99.2354675674,_100,8,>100
8324,broccoli,138,26842031,99.2359777585,_100,8,>100
8325,maximum,138,26842169,99.2364879496,_100,7,>100
8326,marked,138,26842307,99.2369981406,_100,6,>100
8327,sixth,138,26842445,99.2375083317,_100,5,>100
8328,subtle,138,26842583,99.2380185228,_100,6,>100
8329,ment,137,26842720,99.2385250169,_100,4,>100
8330,corps,137,26842857,99.2390315109,_100,5,>100
8331,yuh,137,26842994,99.239538005,_100,3,>100
8332,seeks,137,26843131,99.240044499,_100,5,>100
8333,hopkins,137,26843268,99.2405509931,_100,7,>100
8334,myth,137,26843405,99.2410574871,_100,4,>100
8335,fashioned,137,26843542,99.2415639812,_100,9,>100
8336,surrender,137,26843679,99.2420704752,_100,9,>100
8337,jacked,137,26843816,99.2425769693,_100,6,>100
8338,stereo,137,26843953,99.2430834633,_100,6,>100
8339,americas,137,26844090,99.2435899574,_100,8,>100
8340,peanuts,137,26844227,99.2440964514,_100,7,>100
8341,explosion,137,26844364,99.2446029455,_100,9,>100
8342,vampires,137,26844501,99.2451094395,_100,8,>100
8343,renew,137,26844638,99.2456159335,_100,5,>100
8344,staples,137,26844775,99.2461224276,_100,7,>100
8345,spends,137,26844912,99.2466289216,_100,6,>100
8346,fuk,137,26845049,99.2471354157,_100,3,>100
8347,chanting,137,26845186,99.2476419097,_100,8,>100
8348,biggie,137,26845323,99.2481484038,_100,6,>100
8349,sweatshirt,137,26845460,99.2486548978,_100,10,>100
8350,commenting,137,26845597,99.2491613919,_100,10,>100
8351,sophomore,137,26845734,99.2496678859,_100,9,>100
8352,mates,137,26845871,99.25017438,_100,5,>100
8353,cambridge,137,26846008,99.250680874,_100,9,>100
8354,sympathy,137,26846145,99.2511873681,_100,8,>100
8355,collar,137,26846282,99.2516938621,_100,6,>100
8356,recordings,137,26846419,99.2522003562,_100,10,>100
8357,bmore,136,26846555,99.2527031532,_100,5,>100
8358,bistro,136,26846691,99.2532059502,_100,6,>100
8359,undefeated,136,26846827,99.2537087472,_100,10,>100
8360,johns,136,26846963,99.2542115442,_100,5,>100
8361,shawty,136,26847099,99.2547143412,_100,6,>100
8362,leon,136,26847235,99.2552171383,_100,4,>100
8363,prettiest,136,26847371,99.2557199353,_100,9,>100
8364,ballpark,136,26847507,99.2562227323,_100,8,>100
8365,bride,136,26847643,99.2567255293,_100,5,>100
8366,baron,136,26847779,99.2572283263,_100,5,>100
8367,masterpiece,136,26847915,99.2577311233,_100,11,>100
8368,dinosaur,136,26848051,99.2582339203,_100,8,>100
8369,satan,136,26848187,99.2587367173,_100,5,>100
8370,platinum,136,26848323,99.2592395143,_100,8,>100
8371,providers,136,26848459,99.2597423114,_100,9,>100
8372,pressing,136,26848595,99.2602451084,_100,8,>100
8373,implement,136,26848731,99.2607479054,_100,9,>100
8374,eyed,136,26848867,99.2612507024,_100,4,>100
8375,notification,136,26849003,99.2617534994,_100,12,>100
8376,sag,136,26849139,99.2622562964,_100,3,>100
8377,satisfy,136,26849275,99.2627590934,_100,7,>100
8378,consciousness,136,26849411,99.2632618904,_100,13,>100
8379,lectures,136,26849547,99.2637646874,_100,8,>100
8380,sneakers,136,26849683,99.2642674845,_100,8,>100
8381,sweeter,136,26849819,99.2647702815,_100,7,>100
8382,caution,136,26849955,99.2652730785,_100,7,>100
8383,cuss,136,26850091,99.2657758755,_100,4,>100
8384,newsroom,136,26850227,99.2662786725,_100,8,>100
8385,addict,136,26850363,99.2667814695,_100,6,>100
8386,prettier,136,26850499,99.2672842665,_100,8,>100
8387,locks,136,26850635,99.2677870635,_100,5,>100
8388,monitoring,136,26850771,99.2682898606,_100,10,>100
8389,drunken,136,26850907,99.2687926576,_100,7,>100
8390,armstrong,136,26851043,99.2692954546,_100,9,>100
8391,reid,136,26851179,99.2697982516,_100,4,>100
8392,maui,136,26851315,99.2703010486,_100,4,>100
8393,jackets,136,26851451,99.2708038456,_100,7,>100
8394,scenario,135,26851586,99.2713029456,_100,8,>100
8395,rethink,135,26851721,99.2718020456,_100,7,>100
8396,superman,135,26851856,99.2723011455,_100,8,>100
8397,kimberly,135,26851991,99.2728002455,_100,8,>100
8398,dublin,135,26852126,99.2732993455,_100,6,>100
8399,romeo,135,26852261,99.2737984455,_100,5,>100
8400,shaving,135,26852396,99.2742975454,_100,7,>100
8401,wes,135,26852531,99.2747966454,_100,3,>100
8402,snakes,135,26852666,99.2752957454,_100,6,>100
8403,edgar,135,26852801,99.2757948454,_100,5,>100
8404,obese,135,26852936,99.2762939453,_100,5,>100
8405,unacceptable,135,26853071,99.2767930453,_100,12,>100
8406,fearless,135,26853206,99.2772921453,_100,8,>100
8407,dragging,135,26853341,99.2777912453,_100,8,>100
8408,polo,135,26853476,99.2782903452,_100,4,>100
8409,getaway,135,26853611,99.2787894452,_100,7,>100
8410,obesity,135,26853746,99.2792885452,_100,7,>100
8411,slim,135,26853881,99.2797876452,_100,4,>100
8412,destroying,135,26854016,99.2802867451,_100,10,>100
8413,swell,135,26854151,99.2807858451,_100,5,>100
8414,racial,135,26854286,99.2812849451,_100,6,>100
8415,cycling,135,26854421,99.2817840451,_100,7,>100
8416,amc,135,26854556,99.282283145,_100,3,>100
8417,collected,135,26854691,99.282782245,_100,9,>100
8418,stiff,135,26854826,99.283281345,_100,5,>100
8419,robbins,135,26854961,99.283780445,_100,7,>100
8420,announcers,135,26855096,99.2842795449,_100,10,>100
8421,balloons,135,26855231,99.2847786449,_100,8,>100
8422,appetizers,135,26855366,99.2852777449,_100,10,>100
8423,grid,135,26855501,99.2857768449,_100,4,>100
8424,par,135,26855636,99.2862759448,_100,3,>100
8425,industrial,135,26855771,99.2867750448,_100,10,>100
8426,jumps,135,26855906,99.2872741448,_100,5,>100
8427,vocabulary,135,26856041,99.2877732448,_100,10,>100
8428,whisper,135,26856176,99.2882723447,_100,7,>100
8429,behave,134,26856310,99.2887677477,_100,6,>100
8430,poisoning,134,26856444,99.2892631506,_100,9,>100
8431,headaches,134,26856578,99.2897585535,_100,9,>100
8432,rejection,134,26856712,99.2902539565,_100,9,>100
8433,speeches,134,26856846,99.2907493594,_100,8,>100
8434,expense,134,26856980,99.2912447624,_100,7,>100
8435,discovering,134,26857114,99.2917401653,_100,11,>100
8436,advisory,134,26857248,99.2922355682,_100,8,>100
8437,grabbing,134,26857382,99.2927309712,_100,8,>100
8438,marvel,134,26857516,99.2932263741,_100,6,>100
8439,pb,134,26857650,99.2937217771,_100,2,>100
8440,mardi,134,26857784,99.29421718,_100,5,>100
8441,stable,134,26857918,99.2947125829,_100,6,>100
8442,settling,134,26858052,99.2952079859,_100,8,>100
8443,crawling,134,26858186,99.2957033888,_100,8,>100
8444,grain,134,26858320,99.2961987917,_100,5,>100
8445,flame,134,26858454,99.2966941947,_100,5,>100
8446,thirty,134,26858588,99.2971895976,_100,6,>100
8447,suspense,134,26858722,99.2976850006,_100,8,>100
8448,addresses,134,26858856,99.2981804035,_100,9,>100
8449,downton,134,26858990,99.2986758064,_100,7,>100
8450,index,134,26859124,99.2991712094,_100,5,>100
8451,forgiven,134,26859258,99.2996666123,_100,8,>100
8452,owning,134,26859392,99.3001620152,_100,6,>100
8453,frost,134,26859526,99.3006574182,_100,5,>100
8454,nicholas,134,26859660,99.3011528211,_100,8,>100
8455,shooter,134,26859794,99.3016482241,_100,7,>100
8456,stout,134,26859928,99.302143627,_100,5,>100
8457,choked,134,26860062,99.3026390299,_100,6,>100
8458,midtown,134,26860196,99.3031344329,_100,7,>100
8459,bumping,134,26860330,99.3036298358,_100,7,>100
8460,strain,134,26860464,99.3041252388,_100,6,>100
8461,unto,134,26860598,99.3046206417,_100,4,>100
8462,promoted,133,26860731,99.3051123476,_100,8,>100
8463,curb,133,26860864,99.3056040535,_100,4,>100
8464,functionality,133,26860997,99.3060957594,_100,13,>100
8465,lamp,133,26861130,99.3065874653,_100,4,>100
8466,sweden,133,26861263,99.3070791712,_100,6,>100
8467,unlikely,133,26861396,99.3075708771,_100,8,>100
8468,senses,133,26861529,99.308062583,_100,6,>100
8469,universities,133,26861662,99.3085542889,_100,12,>100
8470,surreal,133,26861795,99.3090459948,_100,7,>100
8471,accidents,133,26861928,99.3095377007,_100,9,>100
8472,meyer,133,26862061,99.3100294066,_100,5,>100
8473,llc,133,26862194,99.3105211125,_100,3,>100
8474,msu,133,26862327,99.3110128184,_100,3,>100
8475,grande,133,26862460,99.3115045243,_100,6,>100
8476,fiber,133,26862593,99.3119962302,_100,5,>100
8477,lunchtime,133,26862726,99.3124879361,_100,9,>100
8478,eleanor,133,26862859,99.312979642,_100,7,>100
8479,males,133,26862992,99.3134713479,_100,5,>100
8480,mcgee,133,26863125,99.3139630538,_100,5,>100
8481,suitcase,133,26863258,99.3144547597,_100,8,>100
8482,spiders,133,26863391,99.3149464656,_100,7,>100
8483,corners,133,26863524,99.3154381715,_100,7,>100
8484,readings,133,26863657,99.3159298774,_100,8,>100
8485,throwback,133,26863790,99.3164215833,_100,9,>100
8486,negativity,133,26863923,99.3169132892,_100,10,>100
8487,partial,133,26864056,99.3174049951,_100,7,>100
8488,smelled,133,26864189,99.317896701,_100,7,>100
8489,camps,133,26864322,99.3183884069,_100,5,>100
8490,melanie,133,26864455,99.3188801128,_100,7,>100
8491,perks,133,26864588,99.3193718187,_100,5,>100
8492,rockstar,133,26864721,99.3198635246,_100,8,>100
8493,harmony,133,26864854,99.3203552305,_100,7,>100
8494,lyric,133,26864987,99.3208469364,_100,5,>100
8495,cuter,133,26865120,99.3213386423,_100,5,>100
8496,moderate,133,26865253,99.3218303482,_100,8,>100
8497,peers,132,26865385,99.3223183571,_100,5,>100
8498,debbie,132,26865517,99.322806366,_100,6,>100
8499,chased,132,26865649,99.3232943748,_100,6,>100
8500,abundance,132,26865781,99.3237823837,_100,9,>100
8501,depp,132,26865913,99.3242703926,_100,4,>100
8502,zack,132,26866045,99.3247584014,_100,4,>100
8503,hwy,132,26866177,99.3252464103,_100,3,>100
8504,quitting,132,26866309,99.3257344191,_100,8,>100
8505,briefly,132,26866441,99.326222428,_100,7,>100
8506,brackets,132,26866573,99.3267104369,_100,8,>100
8507,stocks,132,26866705,99.3271984457,_100,6,>100
8508,milestone,132,26866837,99.3276864546,_100,9,>100
8509,refused,132,26866969,99.3281744635,_100,7,>100
8510,summertime,132,26867101,99.3286624723,_100,10,>100
8511,filthy,132,26867233,99.3291504812,_100,6,>100
8512,wil,132,26867365,99.3296384901,_100,3,>100
8513,becky,132,26867497,99.3301264989,_100,5,>100
8514,portrait,132,26867629,99.3306145078,_100,8,>100
8515,barber,132,26867761,99.3311025167,_100,6,>100
8516,gilbert,132,26867893,99.3315905255,_100,7,>100
8517,dummy,132,26868025,99.3320785344,_100,5,>100
8518,lgbt,132,26868157,99.3325665432,_100,4,>100
8519,conversion,132,26868289,99.3330545521,_100,10,>100
8520,rushing,132,26868421,99.333542561,_100,7,>100
8521,swollen,132,26868553,99.3340305698,_100,7,>100
8522,productions,132,26868685,99.3345185787,_100,11,>100
8523,responsive,132,26868817,99.3350065876,_100,10,>100
8524,objective,132,26868949,99.3354945964,_100,9,>100
8525,toyota,132,26869081,99.3359826053,_100,6,>100
8526,burden,132,26869213,99.3364706142,_100,6,>100
8527,searches,132,26869345,99.336958623,_100,8,>100
8528,vast,132,26869477,99.3374466319,_100,4,>100
8529,operate,132,26869609,99.3379346408,_100,7,>100
8530,gambling,132,26869741,99.3384226496,_100,8,>100
8531,newport,132,26869873,99.3389106585,_100,7,>100
8532,pasadena,131,26870004,99.3393949703,_100,8,>100
8533,bing,131,26870135,99.3398792821,_100,4,>100
8534,ripping,131,26870266,99.340363594,_100,7,>100
8535,trynna,131,26870397,99.3408479058,_100,6,>100
8536,manly,131,26870528,99.3413322176,_100,5,>100
8537,coors,131,26870659,99.3418165294,_100,5,>100
8538,ambition,131,26870790,99.3423008413,_100,8,>100
8539,exploded,131,26870921,99.3427851531,_100,8,>100
8540,sampling,131,26871052,99.3432694649,_100,8,>100
8541,viva,131,26871183,99.3437537768,_100,4,>100
8542,soups,131,26871314,99.3442380886,_100,5,>100
8543,eugene,131,26871445,99.3447224004,_100,6,>100
8544,expects,131,26871576,99.3452067122,_100,7,>100
8545,peeve,131,26871707,99.3456910241,_100,5,>100
8546,holder,131,26871838,99.3461753359,_100,6,>100
8547,itch,131,26871969,99.3466596477,_100,4,>100
8548,iphones,131,26872100,99.3471439595,_100,7,>100
8549,consuming,131,26872231,99.3476282714,_100,9,>100
8550,btr,131,26872362,99.3481125832,_100,3,>100
8551,extent,131,26872493,99.348596895,_100,6,>100
8552,critique,131,26872624,99.3490812069,_100,8,>100
8553,burritos,131,26872755,99.3495655187,_100,8,>100
8554,external,131,26872886,99.3500498305,_100,8,>100
8555,tabs,131,26873017,99.3505341423,_100,4,>100
8556,sipping,131,26873148,99.3510184542,_100,7,>100
8557,kony,131,26873279,99.351502766,_100,4,>100
8558,guards,131,26873410,99.3519870778,_100,6,>100
8559,midst,130,26873540,99.3524676926,_100,5,>100
8560,themes,130,26873670,99.3529483074,_100,6,>100
8561,recovered,130,26873800,99.3534289222,_100,9,>100
8562,hips,130,26873930,99.353909537,_100,4,>100
8563,ronald,130,26874060,99.3543901518,_100,6,>100
8564,violation,130,26874190,99.3548707666,_100,9,>100
8565,flattered,130,26874320,99.3553513814,_100,9,>100
8566,opp,130,26874450,99.3558319961,_100,3,>100
8567,presenters,130,26874580,99.3563126109,_100,10,>100
8568,diaper,130,26874710,99.3567932257,_100,6,>100
8569,alerts,130,26874840,99.3572738405,_100,6,>100
8570,snoring,130,26874970,99.3577544553,_100,7,>100
8571,doubts,130,26875100,99.3582350701,_100,6,>100
8572,tinyurl,130,26875230,99.3587156849,_100,7,>100
8573,timeout,130,26875360,99.3591962997,_100,7,>100
8574,peed,130,26875490,99.3596769145,_100,4,>100
8575,imaginary,130,26875620,99.3601575293,_100,9,>100
8576,viewed,130,26875750,99.3606381441,_100,6,>100
8577,dominated,130,26875880,99.3611187588,_100,9,>100
8578,instruments,130,26876010,99.3615993736,_100,11,>100
8579,ozzie,130,26876140,99.3620799884,_100,5,>100
8580,russ,130,26876270,99.3625606032,_100,4,>100
8581,tropical,130,26876400,99.363041218,_100,8,>100
8582,grilling,130,26876530,99.3635218328,_100,8,>100
8583,fro,130,26876660,99.3640024476,_100,3,>100
8584,irl,130,26876790,99.3644830624,_100,3,>100
8585,nations,130,26876920,99.3649636772,_100,7,>100
8586,payton,130,26877050,99.365444292,_100,6,>100
8587,callin,130,26877180,99.3659249067,_100,6,>100
8588,harvest,130,26877310,99.3664055215,_100,7,>100
8589,favors,130,26877440,99.3668861363,_100,6,>100
8590,knocks,130,26877570,99.3673667511,_100,6,>100
8591,130,130,26877700,99.3678473659,_100,3,>100
8592,dustin,130,26877830,99.3683279807,_100,6,>100
8593,tourist,130,26877960,99.3688085955,_100,7,>100
8594,linking,130,26878090,99.3692892103,_100,7,>100
8595,bachmann,130,26878220,99.3697698251,_100,8,>100
8596,distant,129,26878349,99.3702467428,_100,7,>100
8597,jinx,129,26878478,99.3707236606,_100,4,>100
8598,convenience,129,26878607,99.3712005783,_100,11,>100
8599,wage,129,26878736,99.3716774961,_100,4,>100
8600,iz,129,26878865,99.3721544138,_100,2,>100
8601,defeated,129,26878994,99.3726313316,_100,8,>100
8602,majors,129,26879123,99.3731082493,_100,6,>100
8603,exotic,129,26879252,99.3735851671,_100,6,>100
8604,bmw,129,26879381,99.3740620849,_100,3,>100
8605,erase,129,26879510,99.3745390026,_100,5,>100
8606,marriott,129,26879639,99.3750159204,_100,8,>100
8607,ovation,129,26879768,99.3754928381,_100,7,>100
8608,lbj,129,26879897,99.3759697559,_100,3,>100
8609,hitler,129,26880026,99.3764466736,_100,6,>100
8610,rubbing,129,26880155,99.3769235914,_100,7,>100
8611,contemplating,129,26880284,99.3774005091,_100,13,>100
8612,havnt,129,26880413,99.3778774269,_100,5,>100
8613,mister,129,26880542,99.3783543446,_100,6,>100
8614,regard,129,26880671,99.3788312624,_100,6,>100
8615,luis,129,26880800,99.3793081801,_100,4,>100
8616,relation,129,26880929,99.3797850979,_100,8,>100
8617,purdue,129,26881058,99.3802620157,_100,6,>100
8618,pike,129,26881187,99.3807389334,_100,4,>100
8619,limitations,129,26881316,99.3812158512,_100,11,>100
8620,stance,129,26881445,99.3816927689,_100,6,>100
8621,journals,129,26881574,99.3821696867,_100,8,>100
8622,autographed,129,26881703,99.3826466044,_100,11,>100
8623,predictable,129,26881832,99.3831235222,_100,11,>100
8624,sac,129,26881961,99.3836004399,_100,3,>100
8625,interrupt,129,26882090,99.3840773577,_100,9,>100
8626,hve,129,26882219,99.3845542754,_100,3,>100
8627,sums,129,26882348,99.3850311932,_100,4,>100
8628,abused,129,26882477,99.3855081109,_100,6,>100
8629,diapers,129,26882606,99.3859850287,_100,7,>100
8630,targeted,129,26882735,99.3864619465,_100,8,>100
8631,virtually,129,26882864,99.3869388642,_100,9,>100
8632,vinegar,129,26882993,99.387415782,_100,7,>100
8633,notion,129,26883122,99.3878926997,_100,6,>100
8634,smiled,129,26883251,99.3883696175,_100,6,>100
8635,scripts,129,26883380,99.3888465352,_100,7,>100
8636,layers,129,26883509,99.389323453,_100,6,>100
8637,colt,129,26883638,99.3898003707,_100,4,>100
8638,hospitals,129,26883767,99.3902772885,_100,9,>100
8639,auburn,129,26883896,99.3907542062,_100,6,>100
8640,dominating,129,26884025,99.391231124,_100,10,>100
8641,popularity,129,26884154,99.3917080417,_100,10,>100
8642,meanwhile,129,26884283,99.3921849595,_100,9,>100
8643,jammin,129,26884412,99.3926618773,_100,6,>100
8644,blair,129,26884541,99.393138795,_100,5,>100
8645,lakes,129,26884670,99.3936157128,_100,5,>100
8646,playa,129,26884799,99.3940926305,_100,5,>100
8647,aloud,128,26884927,99.3945658512,_100,5,>100
8648,cube,128,26885055,99.3950390719,_100,4,>100
8649,pending,128,26885183,99.3955122927,_100,7,>100
8650,moss,128,26885311,99.3959855134,_100,4,>100
8651,springfield,128,26885439,99.3964587341,_100,11,>100
8652,hairs,128,26885567,99.3969319548,_100,5,>100
8653,optional,128,26885695,99.3974051755,_100,8,>100
8654,nt,128,26885823,99.3978783963,_100,2,>100
8655,surround,128,26885951,99.398351617,_100,8,>100
8656,proudly,128,26886079,99.3988248377,_100,7,>100
8657,interpretation,128,26886207,99.3992980584,_100,14,>100
8658,squash,128,26886335,99.3997712791,_100,6,>100
8659,patent,128,26886463,99.4002444998,_100,6,>100
8660,sfo,128,26886591,99.4007177206,_100,3,>100
8661,martinez,128,26886719,99.4011909413,_100,8,>100
8662,rosie,128,26886847,99.401664162,_100,5,>100
8663,doubles,128,26886975,99.4021373827,_100,7,>100
8664,rickie,128,26887103,99.4026106034,_100,6,>100
8665,evaluation,128,26887231,99.4030838241,_100,10,>100
8666,jungle,128,26887359,99.4035570449,_100,6,>100
8667,reviewed,128,26887487,99.4040302656,_100,8,>100
8668,lands,128,26887615,99.4045034863,_100,5,>100
8669,pairing,128,26887743,99.404976707,_100,7,>100
8670,sandra,128,26887871,99.4054499277,_100,6,>100
8671,fooled,128,26887999,99.4059231484,_100,6,>100
8672,leno,128,26888127,99.4063963692,_100,4,>100
8673,mapping,128,26888255,99.4068695899,_100,7,>100
8674,timely,128,26888383,99.4073428106,_100,6,>100
8675,firms,128,26888511,99.4078160313,_100,5,>100
8676,consultation,128,26888639,99.408289252,_100,12,>100
8677,runway,128,26888767,99.4087624727,_100,6,>100
8678,err,128,26888895,99.4092356935,_100,3,>100
8679,berkeley,128,26889023,99.4097089142,_100,8,>100
8680,wal,128,26889151,99.4101821349,_100,3,>100
8681,thighs,128,26889279,99.4106553556,_100,6,>100
8682,hears,128,26889407,99.4111285763,_100,5,>100
8683,willis,128,26889535,99.411601797,_100,6,>100
8684,exercising,128,26889663,99.4120750178,_100,10,>100
8685,css,128,26889791,99.4125482385,_100,3,>100
8686,catherine,127,26889918,99.4130177622,_100,9,>100
8687,psycho,127,26890045,99.4134872858,_100,6,>100
8688,jogging,127,26890172,99.4139568095,_100,7,>100
8689,sacred,127,26890299,99.4144263332,_100,6,>100
8690,secondary,127,26890426,99.4148958569,_100,9,>100
8691,bengals,127,26890553,99.4153653806,_100,7,>100
8692,kat,127,26890680,99.4158349042,_100,3,>100
8693,hubbard,127,26890807,99.4163044279,_100,7,>100
8694,soldier,127,26890934,99.4167739516,_100,7,>100
8695,involvement,127,26891061,99.4172434753,_100,11,>100
8696,invested,127,26891188,99.417712999,_100,8,>100
8697,nonstop,127,26891315,99.4181825226,_100,7,>100
8698,riders,127,26891442,99.4186520463,_100,6,>100
8699,fbi,127,26891569,99.41912157,_100,3,>100
8700,neighborhoods,127,26891696,99.4195910937,_100,13,>100
8701,diaries,127,26891823,99.4200606174,_100,7,>100
8702,ch,127,26891950,99.420530141,_100,2,>100
8703,restrictions,127,26892077,99.4209996647,_100,12,>100
8704,lovee,127,26892204,99.4214691884,_100,5,>100
8705,norm,127,26892331,99.4219387121,_100,4,>100
8706,te,127,26892458,99.4224082358,_100,2,>100
8707,recommends,127,26892585,99.4228777594,_100,10,>100
8708,grumpy,127,26892712,99.4233472831,_100,6,>100
8709,ronnie,127,26892839,99.4238168068,_100,6,>100
8710,hopeless,127,26892966,99.4242863305,_100,8,>100
8711,melted,127,26893093,99.4247558542,_100,6,>100
8712,regulation,127,26893220,99.4252253778,_100,10,>100
8713,nominate,127,26893347,99.4256949015,_100,8,>100
8714,satellite,127,26893474,99.4261644252,_100,9,>100
8715,melting,127,26893601,99.4266339489,_100,7,>100
8716,teaser,127,26893728,99.4271034726,_100,6,>100
8717,stall,127,26893855,99.4275729962,_100,5,>100
8718,abilities,127,26893982,99.4280425199,_100,9,>100
8719,flour,127,26894109,99.4285120436,_100,5,>100
8720,silk,127,26894236,99.4289815673,_100,4,>100
8721,amare,127,26894363,99.429451091,_100,5,>100
8722,questioning,126,26894489,99.4299169176,_100,11,>100
8723,bam,126,26894615,99.4303827442,_100,3,>100
8724,smokes,126,26894741,99.4308485709,_100,6,>100
8725,subs,126,26894867,99.4313143975,_100,4,>100
8726,hillary,126,26894993,99.4317802242,_100,7,>100
8727,zoe,126,26895119,99.4322460508,_100,3,>100
8728,investigate,126,26895245,99.4327118775,_100,11,>100
8729,norfolk,126,26895371,99.4331777041,_100,7,>100
8730,fallon,126,26895497,99.4336435307,_100,6,>100
8731,almond,126,26895623,99.4341093574,_100,6,>100
8732,contractors,126,26895749,99.434575184,_100,11,>100
8733,kk,126,26895875,99.4350410107,_100,2,>100
8734,xavier,126,26896001,99.4355068373,_100,6,>100
8735,endorse,126,26896127,99.435972664,_100,7,>100
8736,preseason,126,26896253,99.4364384906,_100,9,>100
8737,promotional,126,26896379,99.4369043172,_100,11,>100
8738,trials,126,26896505,99.4373701439,_100,6,>100
8739,enormous,126,26896631,99.4378359705,_100,8,>100
8740,skiing,126,26896757,99.4383017972,_100,6,>100
8741,belmont,126,26896883,99.4387676238,_100,7,>100
8742,remedy,126,26897009,99.4392334505,_100,6,>100
8743,bcs,126,26897135,99.4396992771,_100,3,>100
8744,tlk,126,26897261,99.4401651038,_100,3,>100
8745,planting,126,26897387,99.4406309304,_100,8,>100
8746,deadly,126,26897513,99.441096757,_100,6,>100
8747,damaged,126,26897639,99.4415625837,_100,7,>100
8748,brees,126,26897765,99.4420284103,_100,5,>100
8749,greeting,126,26897891,99.442494237,_100,8,>100
8750,partnerships,126,26898017,99.4429600636,_100,12,>100
8751,vaca,125,26898142,99.4434221932,_100,4,>100
8752,twitpic,125,26898267,99.4438843228,_100,7,>100
8753,beneath,125,26898392,99.4443464524,_100,7,>100
8754,friggin,125,26898517,99.444808582,_100,7,>100
8755,rbi,125,26898642,99.4452707116,_100,3,>100
8756,clooney,125,26898767,99.4457328412,_100,7,>100
8757,transparency,125,26898892,99.4461949709,_100,12,>100
8758,festivals,125,26899017,99.4466571005,_100,9,>100
8759,trashy,125,26899142,99.4471192301,_100,6,>100
8760,canvas,125,26899267,99.4475813597,_100,6,>100
8761,clarity,125,26899392,99.4480434893,_100,7,>100
8762,kfc,125,26899517,99.4485056189,_100,3,>100
8763,cigar,125,26899642,99.4489677485,_100,5,>100
8764,adapt,125,26899767,99.4494298781,_100,5,>100
8765,welcomed,125,26899892,99.4498920077,_100,8,>100
8766,makeover,125,26900017,99.4503541373,_100,8,>100
8767,waitress,125,26900142,99.4508162669,_100,8,>100
8768,nets,125,26900267,99.4512783965,_100,4,>100
8769,xp,125,26900392,99.4517405261,_100,2,>100
8770,thirst,125,26900517,99.4522026557,_100,6,>100
8771,liverpool,125,26900642,99.4526647853,_100,9,>100
8772,hesitate,125,26900767,99.4531269149,_100,8,>100
8773,freeman,125,26900892,99.4535890446,_100,7,>100
8774,shove,125,26901017,99.4540511742,_100,5,>100
8775,outrageous,125,26901142,99.4545133038,_100,10,>100
8776,douchebag,125,26901267,99.4549754334,_100,9,>100
8777,packaging,125,26901392,99.455437563,_100,9,>100
8778,definite,125,26901517,99.4558996926,_100,8,>100
8779,concur,125,26901642,99.4563618222,_100,6,>100
8780,125,125,26901767,99.4568239518,_100,3,>100
8781,seasonal,125,26901892,99.4572860814,_100,8,>100
8782,desserts,125,26902017,99.457748211,_100,8,>100
8783,buffett,125,26902142,99.4582103406,_100,7,>100
8784,chica,125,26902267,99.4586724702,_100,5,>100
8785,contacted,125,26902392,99.4591345998,_100,9,>100
8786,distracting,125,26902517,99.4595967294,_100,11,>100
8787,sterling,125,26902642,99.460058859,_100,8,>100
8788,stir,125,26902767,99.4605209887,_100,4,>100
8789,deadlines,125,26902892,99.4609831183,_100,9,>100
8790,investigating,125,26903017,99.4614452479,_100,13,>100
8791,hbu,125,26903142,99.4619073775,_100,3,>100
8792,mccarthy,125,26903267,99.4623695071,_100,8,>100
8793,nato,125,26903392,99.4628316367,_100,4,>100
8794,culinary,125,26903517,99.4632937663,_100,8,>100
8795,colton,125,26903642,99.4637558959,_100,6,>100
8796,patiently,125,26903767,99.4642180255,_100,9,>100
8797,paste,125,26903892,99.4646801551,_100,5,>100
8798,chefs,125,26904017,99.4651422847,_100,5,>100
8799,conscience,125,26904142,99.4656044143,_100,10,>100
8800,dealt,125,26904267,99.4660665439,_100,5,>100
8801,virtue,124,26904391,99.4665249765,_100,6,>100
8802,armed,124,26904515,99.4669834091,_100,5,>100
8803,bounty,124,26904639,99.4674418416,_100,6,>100
8804,affairs,124,26904763,99.4679002742,_100,7,>100
8805,promos,124,26904887,99.4683587068,_100,6,>100
8806,northwest,124,26905011,99.4688171393,_100,9,>100
8807,sole,124,26905135,99.4692755719,_100,4,>100
8808,battling,124,26905259,99.4697340045,_100,8,>100
8809,chops,124,26905383,99.4701924371,_100,5,>100
8810,diva,124,26905507,99.4706508696,_100,4,>100
8811,ibm,124,26905631,99.4711093022,_100,3,>100
8812,dp,124,26905755,99.4715677348,_100,2,>100
8813,receipt,124,26905879,99.4720261673,_100,7,>100
8814,oppose,124,26906003,99.4724845999,_100,6,>100
8815,mankind,124,26906127,99.4729430325,_100,7,>100
8816,tick,124,26906251,99.473401465,_100,4,>100
8817,richards,124,26906375,99.4738598976,_100,8,>100
8818,trusting,124,26906499,99.4743183302,_100,8,>100
8819,defines,124,26906623,99.4747767627,_100,7,>100
8820,owen,124,26906747,99.4752351953,_100,4,>100
8821,pressed,124,26906871,99.4756936279,_100,7,>100
8822,sammy,124,26906995,99.4761520605,_100,5,>100
8823,fag,124,26907119,99.476610493,_100,3,>100
8824,rejoice,124,26907243,99.4770689256,_100,7,>100
8825,poe,124,26907367,99.4775273582,_100,3,>100
8826,barn,124,26907491,99.4779857907,_100,4,>100
8827,vitamins,124,26907615,99.4784442233,_100,8,>100
8828,incl,124,26907739,99.4789026559,_100,4,>100
8829,marrying,124,26907863,99.4793610884,_100,8,>100
8830,impatient,124,26907987,99.479819521,_100,9,>100
8831,bankruptcy,124,26908111,99.4802779536,_100,10,>100
8832,numerous,124,26908235,99.4807363862,_100,8,>100
8833,romans,124,26908359,99.4811948187,_100,6,>100
8834,shallow,124,26908483,99.4816532513,_100,7,>100
8835,plugin,124,26908607,99.4821116839,_100,6,>100
8836,sufficient,124,26908731,99.4825701164,_100,10,>100
8837,mount,124,26908855,99.483028549,_100,5,>100
8838,doggie,123,26908978,99.4834832845,_100,6,>100
8839,teasing,123,26909101,99.4839380201,_100,7,>100
8840,adversity,123,26909224,99.4843927556,_100,9,>100
8841,watering,123,26909347,99.4848474911,_100,8,>100
8842,strap,123,26909470,99.4853022267,_100,5,>100
8843,fudge,123,26909593,99.4857569622,_100,5,>100
8844,hatin,123,26909716,99.4862116977,_100,5,>100
8845,lotta,123,26909839,99.4866664333,_100,5,>100
8846,opposing,123,26909962,99.4871211688,_100,8,>100
8847,exercises,123,26910085,99.4875759043,_100,9,>100
8848,afc,123,26910208,99.4880306399,_100,3,>100
8849,beck,123,26910331,99.4884853754,_100,4,>100
8850,drafting,123,26910454,99.4889401109,_100,8,>100
8851,katherine,123,26910577,99.4893948465,_100,9,>100
8852,lls,123,26910700,99.489849582,_100,3,>100
8853,hairy,123,26910823,99.4903043175,_100,5,>100
8854,cashier,123,26910946,99.4907590531,_100,7,>100
8855,ou,123,26911069,99.4912137886,_100,2,>100
8856,removal,123,26911192,99.4916685241,_100,7,>100
8857,sux,123,26911315,99.4921232597,_100,3,>100
8858,bosses,123,26911438,99.4925779952,_100,6,>100
8859,123,123,26911561,99.4930327307,_100,3,>100
8860,aired,123,26911684,99.4934874663,_100,5,>100
8861,paso,123,26911807,99.4939422018,_100,4,>100
8862,shenanigans,123,26911930,99.4943969373,_100,11,>100
8863,holocaust,123,26912053,99.4948516728,_100,9,>100
8864,owes,123,26912176,99.4953064084,_100,4,>100
8865,pooped,123,26912299,99.4957611439,_100,6,>100
8866,cardboard,123,26912422,99.4962158794,_100,9,>100
8867,reruns,123,26912545,99.496670615,_100,6,>100
8868,sierra,123,26912668,99.4971253505,_100,6,>100
8869,immune,123,26912791,99.497580086,_100,6,>100
8870,bagels,123,26912914,99.4980348216,_100,6,>100
8871,bumped,123,26913037,99.4984895571,_100,6,>100
8872,superb,123,26913160,99.4989442926,_100,6,>100
8873,peeing,123,26913283,99.4993990282,_100,6,>100
8874,endure,123,26913406,99.4998537637,_100,6,>100
8875,fulfill,123,26913529,99.5003084992,_100,7,>100
8876,lastnight,123,26913652,99.5007632348,_100,9,>100
8877,pulitzer,123,26913775,99.5012179703,_100,8,>100
8878,christie,123,26913898,99.5016727058,_100,8,>100
8879,tissue,123,26914021,99.5021274414,_100,6,>100
8880,cherish,123,26914144,99.5025821769,_100,7,>100
8881,convincing,123,26914267,99.5030369124,_100,10,>100
8882,polar,123,26914390,99.503491648,_100,5,>100
8883,kent,122,26914512,99.5039426865,_100,4,>100
8884,bubbles,122,26914634,99.504393725,_100,7,>100
8885,cena,122,26914756,99.5048447635,_100,4,>100
8886,ranking,122,26914878,99.505295802,_100,7,>100
8887,consistency,122,26915000,99.5057468404,_100,11,>100
8888,equity,122,26915122,99.5061978789,_100,6,>100
8889,legitimate,122,26915244,99.5066489174,_100,10,>100
8890,lockout,122,26915366,99.5070999559,_100,7,>100
8891,diaz,122,26915488,99.5075509944,_100,4,>100
8892,dunkin,122,26915610,99.5080020329,_100,6,>100
8893,amsterdam,122,26915732,99.5084530714,_100,9,>100
8894,pageant,122,26915854,99.5089041099,_100,7,>100
8895,personalized,122,26915976,99.5093551484,_100,12,>100
8896,jerks,122,26916098,99.5098061869,_100,5,>100
8897,hahha,122,26916220,99.5102572254,_100,5,>100
8898,upgrades,122,26916342,99.5107082639,_100,8,>100
8899,bulk,122,26916464,99.5111593024,_100,4,>100
8900,ridge,122,26916586,99.5116103409,_100,5,>100
8901,connecticut,122,26916708,99.5120613794,_100,11,>100
8902,displays,122,26916830,99.5125124179,_100,8,>100
8903,alarms,122,26916952,99.5129634564,_100,6,>100
8904,amateur,122,26917074,99.5134144949,_100,7,>100
8905,stubborn,122,26917196,99.5138655334,_100,8,>100
8906,rollin,122,26917318,99.5143165719,_100,6,>100
8907,header,122,26917440,99.5147676104,_100,6,>100
8908,alongside,122,26917562,99.5152186489,_100,9,>100
8909,smoothly,122,26917684,99.5156696874,_100,8,>100
8910,requirement,122,26917806,99.5161207259,_100,11,>100
8911,photographers,122,26917928,99.5165717643,_100,13,>100
8912,billboard,122,26918050,99.5170228028,_100,9,>100
8913,gangster,122,26918172,99.5174738413,_100,8,>100
8914,checkin,122,26918294,99.5179248798,_100,7,>100
8915,vow,122,26918416,99.5183759183,_100,3,>100
8916,picky,122,26918538,99.5188269568,_100,5,>100
8917,gently,122,26918660,99.5192779953,_100,6,>100
8918,jacobs,122,26918782,99.5197290338,_100,6,>100
8919,dine,122,26918904,99.5201800723,_100,4,>100
8920,herald,122,26919026,99.5206311108,_100,6,>100
8921,hiv,122,26919148,99.5210821493,_100,3,>100
8922,lauderdale,122,26919270,99.5215331878,_100,10,>100
8923,hottie,122,26919392,99.5219842263,_100,6,>100
8924,winehouse,122,26919514,99.5224352648,_100,9,>100
8925,farts,122,26919636,99.5228863033,_100,5,>100
8926,consulting,122,26919758,99.5233373418,_100,10,>100
8927,optimism,122,26919880,99.5237883803,_100,8,>100
8928,oracle,121,26920001,99.5242357217,_100,6,>100
8929,basics,121,26920122,99.5246830632,_100,6,>100
8930,necessity,121,26920243,99.5251304047,_100,9,>100
8931,steroids,121,26920364,99.5255777461,_100,8,>100
8932,mound,121,26920485,99.5260250876,_100,5,>100
8933,crosby,121,26920606,99.526472429,_100,6,>100
8934,qualities,121,26920727,99.5269197705,_100,9,>100
8935,auditioning,121,26920848,99.527367112,_100,11,>100
8936,actively,121,26920969,99.5278144534,_100,8,>100
8937,hoosiers,121,26921090,99.5282617949,_100,8,>100
8938,prayed,121,26921211,99.5287091363,_100,6,>100
8939,brake,121,26921332,99.5291564778,_100,5,>100
8940,warmth,121,26921453,99.5296038192,_100,6,>100
8941,acquisition,121,26921574,99.5300511607,_100,11,>100
8942,enable,121,26921695,99.5304985022,_100,6,>100
8943,romo,121,26921816,99.5309458436,_100,4,>100
8944,whatcha,121,26921937,99.5313931851,_100,7,>100
8945,exhibits,121,26922058,99.5318405265,_100,8,>100
8946,incentive,121,26922179,99.532287868,_100,9,>100
8947,holler,121,26922300,99.5327352095,_100,6,>100
8948,understatement,121,26922421,99.5331825509,_100,14,>100
8949,prop,121,26922542,99.5336298924,_100,4,>100
8950,stating,121,26922663,99.5340772338,_100,7,>100
8951,rib,121,26922784,99.5345245753,_100,3,>100
8952,seahawks,121,26922905,99.5349719168,_100,8,>100
8953,marion,121,26923026,99.5354192582,_100,6,>100
8954,availability,121,26923147,99.5358665997,_100,12,>100
8955,meek,121,26923268,99.5363139411,_100,4,>100
8956,bathrooms,121,26923389,99.5367612826,_100,9,>100
8957,ck,121,26923510,99.537208624,_100,2,>100
8958,freestyle,121,26923631,99.5376559655,_100,9,>100
8959,suffered,121,26923752,99.538103307,_100,8,>100
8960,fsu,121,26923873,99.5385506484,_100,3,>100
8961,browsing,121,26923994,99.5389979899,_100,8,>100
8962,relatively,121,26924115,99.5394453313,_100,10,>100
8963,tagging,121,26924236,99.5398926728,_100,7,>100
8964,void,121,26924357,99.5403400143,_100,4,>100
8965,celebrations,121,26924478,99.5407873557,_100,12,>100
8966,brighten,121,26924599,99.5412346972,_100,8,>100
8967,outer,121,26924720,99.5416820386,_100,5,>100
8968,marco,121,26924841,99.5421293801,_100,5,>100
8969,cheeseburger,121,26924962,99.5425767216,_100,12,>100
8970,approximately,120,26925082,99.543020366,_100,13,>100
8971,rhyme,120,26925202,99.5434640104,_100,5,>100
8972,gardening,120,26925322,99.5439076548,_100,9,>100
8973,brooke,120,26925442,99.5443512992,_100,6,>100
8974,splash,120,26925562,99.5447949437,_100,6,>100
8975,ramen,120,26925682,99.5452385881,_100,5,>100
8976,hopping,120,26925802,99.5456822325,_100,7,>100
8977,allison,120,26925922,99.5461258769,_100,7,>100
8978,mercury,120,26926042,99.5465695214,_100,7,>100
8979,humility,120,26926162,99.5470131658,_100,8,>100
8980,keg,120,26926282,99.5474568102,_100,3,>100
8981,freeway,120,26926402,99.5479004546,_100,7,>100
8982,attn,120,26926522,99.548344099,_100,4,>100
8983,clint,120,26926642,99.5487877435,_100,5,>100
8984,awfully,120,26926762,99.5492313879,_100,7,>100
8985,120,120,26926882,99.5496750323,_100,3,>100
8986,chalk,120,26927002,99.5501186767,_100,5,>100
8987,lag,120,26927122,99.5505623212,_100,3,>100
8988,ari,120,26927242,99.5510059656,_100,3,>100
8989,opposition,120,26927362,99.55144961,_100,10,>100
8990,rim,120,26927482,99.5518932544,_100,3,>100
8991,wwii,120,26927602,99.5523368988,_100,4,>100
8992,psychology,120,26927722,99.5527805433,_100,10,>100
8993,jeter,120,26927842,99.5532241877,_100,5,>100
8994,mariano,120,26927962,99.5536678321,_100,7,>100
8995,psych,120,26928082,99.5541114765,_100,5,>100
8996,torres,120,26928202,99.554555121,_100,6,>100
8997,blackhawks,120,26928322,99.5549987654,_100,10,>100
8998,mentors,120,26928442,99.5554424098,_100,7,>100
8999,tami,120,26928562,99.5558860542,_100,4,>100
9000,isaac,120,26928682,99.5563296986,_100,5,>100
9001,sweats,120,26928802,99.5567733431,_100,6,>100
9002,panelists,120,26928922,99.5572169875,_100,9,>100
9003,scars,120,26929042,99.5576606319,_100,5,>100
9004,abby,120,26929162,99.5581042763,_100,4,>100
9005,nominees,120,26929282,99.5585479208,_100,8,>100
9006,tlc,120,26929402,99.5589915652,_100,3,>100
9007,lama,120,26929522,99.5594352096,_100,4,>100
9008,noel,120,26929642,99.559878854,_100,4,>100
9009,removing,120,26929762,99.5603224984,_100,8,>100
9010,gravity,120,26929882,99.5607661429,_100,7,>100
9011,asparagus,120,26930002,99.5612097873,_100,9,>100
9012,slacking,120,26930122,99.5616534317,_100,8,>100
9013,credibility,120,26930242,99.5620970761,_100,11,>100
9014,pounding,120,26930362,99.5625407206,_100,8,>100
9015,sry,120,26930482,99.562984365,_100,3,>100
9016,ruled,120,26930602,99.5634280094,_100,5,>100
9017,slaves,120,26930722,99.5638716538,_100,6,>100
9018,disgusted,120,26930842,99.5643152982,_100,9,>100
9019,congratulate,120,26930962,99.5647589427,_100,12,>100
9020,nolan,119,26931081,99.56519889,_100,5,>100
9021,refers,119,26931200,99.5656388374,_100,6,>100
9022,granola,119,26931319,99.5660787848,_100,7,>100
9023,razor,119,26931438,99.5665187322,_100,5,>100
9024,theft,119,26931557,99.5669586796,_100,5,>100
9025,forthcoming,119,26931676,99.567398627,_100,11,>100
9026,eww,119,26931795,99.5678385744,_100,3,>100
9027,arrange,119,26931914,99.5682785217,_100,7,>100
9028,summers,119,26932033,99.5687184691,_100,7,>100
9029,heavenly,119,26932152,99.5691584165,_100,8,>100
9030,meter,119,26932271,99.5695983639,_100,5,>100
9031,laps,119,26932390,99.5700383113,_100,4,>100
9032,grandmas,119,26932509,99.5704782587,_100,8,>100
9033,bunt,119,26932628,99.5709182061,_100,4,>100
9034,omw,119,26932747,99.5713581534,_100,3,>100
9035,tis,119,26932866,99.5717981008,_100,3,>100
9036,vest,119,26932985,99.5722380482,_100,4,>100
9037,applaud,119,26933104,99.5726779956,_100,7,>100
9038,beaches,119,26933223,99.573117943,_100,7,>100
9039,syndrome,119,26933342,99.5735578904,_100,8,>100
9040,somethings,119,26933461,99.5739978378,_100,10,>100
9041,drowning,119,26933580,99.5744377851,_100,8,>100
9042,tolerance,119,26933699,99.5748777325,_100,9,>100
9043,thankyou,119,26933818,99.5753176799,_100,8,>100
9044,rewarded,119,26933937,99.5757576273,_100,8,>100
9045,pregame,119,26934056,99.5761975747,_100,7,>100
9046,libs,119,26934175,99.5766375221,_100,4,>100
9047,welfare,119,26934294,99.5770774694,_100,7,>100
9048,creature,119,26934413,99.5775174168,_100,8,>100
9049,aspiring,119,26934532,99.5779573642,_100,8,>100
9050,shud,119,26934651,99.5783973116,_100,4,>100
9051,solidarity,119,26934770,99.578837259,_100,10,>100
9052,jackpot,119,26934889,99.5792772064,_100,7,>100
9053,thier,119,26935008,99.5797171538,_100,5,>100
9054,stake,119,26935127,99.5801571011,_100,5,>100
9055,fargo,119,26935246,99.5805970485,_100,5,>100
9056,remotely,119,26935365,99.5810369959,_100,8,>100
9057,twelve,119,26935484,99.5814769433,_100,6,>100
9058,rested,119,26935603,99.5819168907,_100,6,>100
9059,advisor,119,26935722,99.5823568381,_100,7,>100
9060,bestest,119,26935841,99.5827967855,_100,7,>100
9061,mamas,119,26935960,99.5832367328,_100,5,>100
9062,pedro,119,26936079,99.5836766802,_100,5,>100
9063,reckless,119,26936198,99.5841166276,_100,8,>100
9064,lmbo,119,26936317,99.584556575,_100,4,>100
9065,cyrus,118,26936435,99.5849928253,_100,5,>100
9066,ow,118,26936553,99.5854290757,_100,2,>100
9067,bucky,118,26936671,99.585865326,_100,5,>100
9068,relatives,118,26936789,99.5863015764,_100,9,>100
9069,pancake,118,26936907,99.5867378267,_100,7,>100
9070,restored,118,26937025,99.5871740771,_100,8,>100
9071,dwn,118,26937143,99.5876103274,_100,3,>100
9072,rouge,118,26937261,99.5880465778,_100,5,>100
9073,idgaf,118,26937379,99.5884828281,_100,5,>100
9074,hummus,118,26937497,99.5889190785,_100,6,>100
9075,wb,118,26937615,99.5893553288,_100,2,>100
9076,propose,118,26937733,99.5897915792,_100,7,>100
9077,shaun,118,26937851,99.5902278295,_100,5,>100
9078,followin,118,26937969,99.5906640799,_100,8,>100
9079,bowls,118,26938087,99.5911003302,_100,5,>100
9080,magically,118,26938205,99.5915365806,_100,9,>100
9081,dried,118,26938323,99.5919728309,_100,5,>100
9082,etsy,118,26938441,99.5924090813,_100,4,>100
9083,slots,118,26938559,99.5928453316,_100,5,>100
9084,noodle,118,26938677,99.593281582,_100,6,>100
9085,homecoming,118,26938795,99.5937178323,_100,10,>100
9086,generic,118,26938913,99.5941540827,_100,7,>100
9087,paterno,118,26939031,99.594590333,_100,7,>100
9088,extras,118,26939149,99.5950265834,_100,6,>100
9089,pep,118,26939267,99.5954628337,_100,3,>100
9090,trillion,118,26939385,99.5958990841,_100,8,>100
9091,tanks,118,26939503,99.5963353344,_100,5,>100
9092,cord,118,26939621,99.5967715848,_100,4,>100
9093,farther,118,26939739,99.5972078351,_100,7,>100
9094,darren,118,26939857,99.5976440854,_100,6,>100
9095,cabinet,118,26939975,99.5980803358,_100,7,>100
9096,fringe,118,26940093,99.5985165861,_100,6,>100
9097,springsteen,118,26940211,99.5989528365,_100,11,>100
9098,subjects,118,26940329,99.5993890868,_100,8,>100
9099,warn,118,26940447,99.5998253372,_100,4,>100
9100,preference,118,26940565,99.6002615875,_100,10,>100
9101,batter,118,26940683,99.6006978379,_100,6,>100
9102,ballin,118,26940801,99.6011340882,_100,6,>100
9103,vending,118,26940919,99.6015703386,_100,7,>100
9104,summary,118,26941037,99.6020065889,_100,7,>100
9105,builds,118,26941155,99.6024428393,_100,6,>100
9106,srry,118,26941273,99.6028790896,_100,4,>100
9107,churches,118,26941391,99.60331534,_100,8,>100
9108,mccoy,118,26941509,99.6037515903,_100,5,>100
9109,animation,118,26941627,99.6041878407,_100,9,>100
9110,freely,117,26941744,99.604620394,_100,6,>100
9111,creeps,117,26941861,99.6050529473,_100,6,>100
9112,overhead,117,26941978,99.6054855006,_100,8,>100
9113,differ,117,26942095,99.6059180539,_100,6,>100
9114,greinke,117,26942212,99.6063506072,_100,7,>100
9115,savvy,117,26942329,99.6067831605,_100,5,>100
9116,digs,117,26942446,99.6072157139,_100,4,>100
9117,peterson,117,26942563,99.6076482672,_100,8,>100
9118,personalities,117,26942680,99.6080808205,_100,13,>100
9119,jt,117,26942797,99.6085133738,_100,2,>100
9120,alma,117,26942914,99.6089459271,_100,4,>100
9121,csi,117,26943031,99.6093784804,_100,3,>100
9122,pau,117,26943148,99.6098110337,_100,3,>100
9123,oxford,117,26943265,99.610243587,_100,6,>100
9124,prevention,117,26943382,99.6106761403,_100,10,>100
9125,doggy,117,26943499,99.6111086937,_100,5,>100
9126,lv,117,26943616,99.611541247,_100,2,>100
9127,airports,117,26943733,99.6119738003,_100,8,>100
9128,thrill,117,26943850,99.6124063536,_100,6,>100
9129,autographs,117,26943967,99.6128389069,_100,10,>100
9130,celebrates,117,26944084,99.6132714602,_100,10,>100
9131,barking,117,26944201,99.6137040135,_100,7,>100
9132,pedicure,117,26944318,99.6141365668,_100,8,>100
9133,signatures,117,26944435,99.6145691202,_100,10,>100
9134,niche,117,26944552,99.6150016735,_100,5,>100
9135,bldg,117,26944669,99.6154342268,_100,4,>100
9136,rodriguez,117,26944786,99.6158667801,_100,9,>100
9137,funday,117,26944903,99.6162993334,_100,6,>100
9138,introduction,117,26945020,99.6167318867,_100,12,>100
9139,improves,117,26945137,99.61716444,_100,8,>100
9140,soaked,117,26945254,99.6175969933,_100,6,>100
9141,gregory,117,26945371,99.6180295466,_100,7,>100
9142,textbooks,117,26945488,99.6184621,_100,9,>100
9143,meth,117,26945605,99.6188946533,_100,4,>100
9144,await,117,26945722,99.6193272066,_100,5,>100
9145,racks,117,26945839,99.6197597599,_100,5,>100
9146,skittles,117,26945956,99.6201923132,_100,8,>100
9147,davy,117,26946073,99.6206248665,_100,4,>100
9148,searched,117,26946190,99.6210574198,_100,8,>100
9149,occurs,117,26946307,99.6214899731,_100,6,>100
9150,sunburn,117,26946424,99.6219225264,_100,7,>100
9151,parallel,117,26946541,99.6223550798,_100,8,>100
9152,afterward,117,26946658,99.6227876331,_100,9,>100
9153,procrastination,117,26946775,99.6232201864,_100,15,>100
9154,grasp,117,26946892,99.6236527397,_100,5,>100
9155,weighs,117,26947009,99.624085293,_100,6,>100
9156,corruption,117,26947126,99.6245178463,_100,10,>100
9157,rave,117,26947243,99.6249503996,_100,4,>100
9158,carrier,117,26947360,99.6253829529,_100,7,>100
9159,ramirez,117,26947477,99.6258155063,_100,7,>100
9160,oranges,116,26947593,99.6262443625,_100,7,>100
9161,tourists,116,26947709,99.6266732188,_100,8,>100
9162,angelou,116,26947825,99.6271020751,_100,7,>100
9163,ghosts,116,26947941,99.6275309314,_100,6,>100
9164,demanding,116,26948057,99.6279597876,_100,9,>100
9165,grip,116,26948173,99.6283886439,_100,4,>100
9166,happend,116,26948289,99.6288175002,_100,7,>100
9167,chiefs,116,26948405,99.6292463565,_100,6,>100
9168,des,116,26948521,99.6296752127,_100,3,>100
9169,pleasee,116,26948637,99.630104069,_100,7,>100
9170,amazes,116,26948753,99.6305329253,_100,6,>100
9171,colder,116,26948869,99.6309617815,_100,6,>100
9172,computing,116,26948985,99.6313906378,_100,9,>100
9173,kickball,116,26949101,99.6318194941,_100,8,>100
9174,drained,116,26949217,99.6322483504,_100,7,>100
9175,mater,116,26949333,99.6326772066,_100,5,>100
9176,sweaters,116,26949449,99.6331060629,_100,8,>100
9177,chores,116,26949565,99.6335349192,_100,6,>100
9178,influenced,116,26949681,99.6339637755,_100,10,>100
9179,turnover,116,26949797,99.6343926317,_100,8,>100
9180,tougher,116,26949913,99.634821488,_100,7,>100
9181,bark,116,26950029,99.6352503443,_100,4,>100
9182,witch,116,26950145,99.6356792006,_100,5,>100
9183,tender,116,26950261,99.6361080568,_100,6,>100
9184,imagining,116,26950377,99.6365369131,_100,9,>100
9185,napa,116,26950493,99.6369657694,_100,4,>100
9186,estimated,116,26950609,99.6373946257,_100,9,>100
9187,advocacy,116,26950725,99.6378234819,_100,8,>100
9188,receives,116,26950841,99.6382523382,_100,8,>100
9189,attraction,116,26950957,99.6386811945,_100,10,>100
9190,stroll,116,26951073,99.6391100508,_100,6,>100
9191,savage,116,26951189,99.639538907,_100,6,>100
9192,damnit,116,26951305,99.6399677633,_100,6,>100
9193,flashing,116,26951421,99.6403966196,_100,8,>100
9194,imho,116,26951537,99.6408254759,_100,4,>100
9195,cs,116,26951653,99.6412543321,_100,2,>100
9196,cu,116,26951769,99.6416831884,_100,2,>100
9197,spouse,116,26951885,99.6421120447,_100,6,>100
9198,cms,116,26952001,99.642540901,_100,3,>100
9199,alexis,116,26952117,99.6429697572,_100,6,>100
9200,slammed,116,26952233,99.6433986135,_100,7,>100
9201,exceptional,116,26952349,99.6438274698,_100,11,>100
9202,stoned,116,26952465,99.6442563261,_100,6,>100
9203,exited,116,26952581,99.6446851823,_100,6,>100
9204,tattooed,116,26952697,99.6451140386,_100,8,>100
9205,prosperous,116,26952813,99.6455428949,_100,10,>100
9206,cocoa,116,26952929,99.6459717512,_100,5,>100
9207,dodge,116,26953045,99.6464006074,_100,5,>100
9208,ia,116,26953161,99.6468294637,_100,2,>100
9209,flush,116,26953277,99.64725832,_100,5,>100
9210,frankie,116,26953393,99.6476871763,_100,7,>100
9211,stranded,116,26953509,99.6481160325,_100,8,>100
9212,partly,115,26953624,99.6485411918,_100,6,>100
9213,transparent,115,26953739,99.648966351,_100,11,>100
9214,employed,115,26953854,99.6493915103,_100,8,>100
9215,solving,115,26953969,99.6498166695,_100,7,>100
9216,lindsey,115,26954084,99.6502418287,_100,7,>100
9217,envelope,115,26954199,99.650666988,_100,8,>100
9218,bury,115,26954314,99.6510921472,_100,4,>100
9219,concerning,115,26954429,99.6515173064,_100,10,>100
9220,bloomberg,115,26954544,99.6519424657,_100,9,>100
9221,oxygen,115,26954659,99.6523676249,_100,6,>100
9222,reaches,115,26954774,99.6527927842,_100,7,>100
9223,pints,115,26954889,99.6532179434,_100,5,>100
9224,movin,115,26955004,99.6536431026,_100,5,>100
9225,farted,115,26955119,99.6540682619,_100,6,>100
9226,blankets,115,26955234,99.6544934211,_100,8,>100
9227,raging,115,26955349,99.6549185803,_100,6,>100
9228,windshield,115,26955464,99.6553437396,_100,10,>100
9229,rematch,115,26955579,99.6557688988,_100,7,>100
9230,tights,115,26955694,99.6561940581,_100,6,>100
9231,cooling,115,26955809,99.6566192173,_100,7,>100
9232,hof,115,26955924,99.6570443765,_100,3,>100
9233,parody,115,26956039,99.6574695358,_100,6,>100
9234,laptops,115,26956154,99.657894695,_100,7,>100
9235,trades,115,26956269,99.6583198542,_100,6,>100
9236,visitor,115,26956384,99.6587450135,_100,7,>100
9237,coco,115,26956499,99.6591701727,_100,4,>100
9238,nv,115,26956614,99.659595332,_100,2,>100
9239,outline,115,26956729,99.6600204912,_100,7,>100
9240,caller,115,26956844,99.6604456504,_100,6,>100
9241,sections,115,26956959,99.6608708097,_100,8,>100
9242,pollen,115,26957074,99.6612959689,_100,6,>100
9243,screenings,115,26957189,99.6617211281,_100,10,>100
9244,shipment,115,26957304,99.6621462874,_100,8,>100
9245,simpsons,115,26957419,99.6625714466,_100,8,>100
9246,alternatives,115,26957534,99.6629966059,_100,12,>100
9247,mormon,115,26957649,99.6634217651,_100,6,>100
9248,districts,115,26957764,99.6638469243,_100,9,>100
9249,rodney,115,26957879,99.6642720836,_100,6,>100
9250,questionable,115,26957994,99.6646972428,_100,12,>100
9251,continually,115,26958109,99.6651224021,_100,11,>100
9252,screenplay,115,26958224,99.6655475613,_100,10,>100
9253,cosby,115,26958339,99.6659727205,_100,5,>100
9254,rey,115,26958454,99.6663978798,_100,3,>100
9255,recital,115,26958569,99.666823039,_100,7,>100
9256,discourse,115,26958684,99.6672481982,_100,9,>100
9257,oovoo,115,26958799,99.6676733575,_100,5,>100
9258,mailbox,115,26958914,99.6680985167,_100,7,>100
9259,goodie,115,26959029,99.668523676,_100,6,>100
9260,elway,114,26959143,99.6689451382,_100,5,>100
9261,learners,114,26959257,99.6693666004,_100,8,>100
9262,jp,114,26959371,99.6697880626,_100,2,>100
9263,babysitting,114,26959485,99.6702095248,_100,11,>100
9264,dominant,114,26959599,99.670630987,_100,8,>100
9265,concussion,114,26959713,99.6710524492,_100,10,>100
9266,expired,114,26959827,99.6714739114,_100,7,>100
9267,mercedes,114,26959941,99.6718953736,_100,8,>100
9268,tue,114,26960055,99.6723168358,_100,3,>100
9269,improvements,114,26960169,99.672738298,_100,12,>100
9270,neglected,114,26960283,99.6731597602,_100,9,>100
9271,awaits,114,26960397,99.6735812224,_100,6,>100
9272,glued,114,26960511,99.6740026846,_100,5,>100
9273,brewed,114,26960625,99.6744241468,_100,6,>100
9274,boats,114,26960739,99.674845609,_100,5,>100
9275,hong,114,26960853,99.6752670712,_100,4,>100
9276,strict,114,26960967,99.6756885334,_100,6,>100
9277,mastered,114,26961081,99.6761099956,_100,8,>100
9278,donor,114,26961195,99.6765314578,_100,5,>100
9279,holland,114,26961309,99.67695292,_100,7,>100
9280,poured,114,26961423,99.6773743822,_100,6,>100
9281,procrastinating,114,26961537,99.6777958444,_100,15,>100
9282,doubled,114,26961651,99.6782173066,_100,7,>100
9283,macy,114,26961765,99.6786387688,_100,4,>100
9284,mosquito,114,26961879,99.679060231,_100,8,>100
9285,spontaneous,114,26961993,99.6794816932,_100,11,>100
9286,opponents,114,26962107,99.6799031554,_100,9,>100
9287,survivors,114,26962221,99.6803246176,_100,9,>100
9288,dedicate,114,26962335,99.6807460798,_100,8,>100
9289,vain,114,26962449,99.681167542,_100,4,>100
9290,castro,114,26962563,99.6815890042,_100,6,>100
9291,jeopardy,114,26962677,99.6820104664,_100,8,>100
9292,freshly,114,26962791,99.6824319286,_100,7,>100
9293,stylish,114,26962905,99.6828533908,_100,7,>100
9294,occasional,114,26963019,99.683274853,_100,10,>100
9295,endorsed,114,26963133,99.6836963152,_100,8,>100
9296,eatin,114,26963247,99.6841177774,_100,5,>100
9297,offend,114,26963361,99.6845392396,_100,6,>100
9298,icons,114,26963475,99.6849607018,_100,5,>100
9299,toughest,114,26963589,99.685382164,_100,8,>100
9300,breezy,114,26963703,99.6858036262,_100,6,>100
9301,wounds,114,26963817,99.6862250884,_100,6,>100
9302,lite,114,26963931,99.6866465506,_100,4,>100
9303,duties,114,26964045,99.6870680128,_100,6,>100
9304,heals,114,26964159,99.687489475,_100,5,>100
9305,guidelines,114,26964273,99.6879109372,_100,10,>100
9306,louie,114,26964387,99.6883323994,_100,5,>100
9307,shapes,113,26964500,99.6887501646,_100,6,>100
9308,electronics,113,26964613,99.6891679297,_100,11,>100
9309,crop,113,26964726,99.6895856949,_100,4,>100
9310,nonprofits,113,26964839,99.6900034601,_100,10,>100
9311,finalists,113,26964952,99.6904212252,_100,9,>100
9312,bumps,113,26965065,99.6908389904,_100,5,>100
9313,fitzgerald,113,26965178,99.6912567555,_100,10,>100
9314,iq,113,26965291,99.6916745207,_100,2,>100
9315,basil,113,26965404,99.6920922859,_100,5,>100
9316,untill,113,26965517,99.692510051,_100,6,>100
9317,workforce,113,26965630,99.6929278162,_100,9,>100
9318,horribly,113,26965743,99.6933455814,_100,8,>100
9319,freshmen,113,26965856,99.6937633465,_100,8,>100
9320,pga,113,26965969,99.6941811117,_100,3,>100
9321,eternity,113,26966082,99.6945988769,_100,8,>100
9322,heel,113,26966195,99.695016642,_100,4,>100
9323,hoffman,113,26966308,99.6954344072,_100,7,>100
9324,tommorrow,113,26966421,99.6958521724,_100,9,>100
9325,loudest,113,26966534,99.6962699375,_100,7,>100
9326,imperial,113,26966647,99.6966877027,_100,8,>100
9327,scroll,113,26966760,99.6971054678,_100,6,>100
9328,retro,113,26966873,99.697523233,_100,5,>100
9329,fone,113,26966986,99.6979409982,_100,4,>100
9330,faint,113,26967099,99.6983587633,_100,5,>100
9331,facilities,113,26967212,99.6987765285,_100,10,>100
9332,devoted,113,26967325,99.6991942937,_100,7,>100
9333,googled,113,26967438,99.6996120588,_100,7,>100
9334,trailers,113,26967551,99.700029824,_100,8,>100
9335,swagger,113,26967664,99.7004475892,_100,7,>100
9336,depot,113,26967777,99.7008653543,_100,5,>100
9337,bouta,113,26967890,99.7012831195,_100,5,>100
9338,malibu,113,26968003,99.7017008847,_100,6,>100
9339,argh,113,26968116,99.7021186498,_100,4,>100
9340,newer,113,26968229,99.702536415,_100,5,>100
9341,essentially,113,26968342,99.7029541801,_100,11,>100
9342,donkey,113,26968455,99.7033719453,_100,6,>100
9343,intake,113,26968568,99.7037897105,_100,6,>100
9344,cuisine,113,26968681,99.7042074756,_100,7,>100
9345,positively,113,26968794,99.7046252408,_100,10,>100
9346,hub,113,26968907,99.705043006,_100,3,>100
9347,piercings,113,26969020,99.7054607711,_100,9,>100
9348,haa,113,26969133,99.7058785363,_100,3,>100
9349,despair,113,26969246,99.7062963015,_100,7,>100
9350,mirrors,113,26969359,99.7067140666,_100,7,>100
9351,mccain,113,26969472,99.7071318318,_100,6,>100
9352,observe,113,26969585,99.707549597,_100,7,>100
9353,napping,113,26969698,99.7079673621,_100,7,>100
9354,lohan,113,26969811,99.7083851273,_100,5,>100
9355,inquiry,113,26969924,99.7088028924,_100,7,>100
9356,nearest,113,26970037,99.7092206576,_100,7,>100
9357,integrate,113,26970150,99.7096384228,_100,9,>100
9358,highs,113,26970263,99.7100561879,_100,5,>100
9359,jax,113,26970376,99.7104739531,_100,3,>100
9360,produces,113,26970489,99.7108917183,_100,8,>100
9361,phi,113,26970602,99.7113094834,_100,3,>100
9362,php,113,26970715,99.7117272486,_100,3,>100
9363,breakout,113,26970828,99.7121450138,_100,8,>100
9364,controversial,113,26970941,99.7125627789,_100,13,>100
9365,tornadoes,113,26971054,99.7129805441,_100,9,>100
9366,dogg,113,26971167,99.7133983092,_100,4,>100
9367,secretary,113,26971280,99.7138160744,_100,9,>100
9368,tablets,113,26971393,99.7142338396,_100,7,>100
9369,crafts,113,26971506,99.7146516047,_100,6,>100
9370,ranger,113,26971619,99.7150693699,_100,6,>100
9371,aristotle,113,26971732,99.7154871351,_100,9,>100
9372,sdsu,113,26971845,99.7159049002,_100,4,>100
9373,granny,112,26971957,99.7163189684,_100,6,>100
9374,buckets,112,26972069,99.7167330365,_100,7,>100
9375,democrat,112,26972181,99.7171471046,_100,8,>100
9376,steaks,112,26972293,99.7175611727,_100,6,>100
9377,scooter,112,26972405,99.7179752409,_100,7,>100
9378,referrals,112,26972517,99.718389309,_100,9,>100
9379,cheryl,112,26972629,99.7188033771,_100,6,>100
9380,pierre,112,26972741,99.7192174453,_100,6,>100
9381,forgets,112,26972853,99.7196315134,_100,7,>100
9382,withdrawal,112,26972965,99.7200455815,_100,10,>100
9383,cellphone,112,26973077,99.7204596496,_100,9,>100
9384,marketplace,112,26973189,99.7208737178,_100,11,>100
9385,striking,112,26973301,99.7212877859,_100,8,>100
9386,omar,112,26973413,99.721701854,_100,4,>100
9387,diagnosed,112,26973525,99.7221159221,_100,9,>100
9388,preaching,112,26973637,99.7225299903,_100,9,>100
9389,lotto,112,26973749,99.7229440584,_100,5,>100
9390,toledo,112,26973861,99.7233581265,_100,6,>100
9391,cue,112,26973973,99.7237721947,_100,3,>100
9392,magnificent,112,26974085,99.7241862628,_100,11,>100
9393,peggy,112,26974197,99.7246003309,_100,5,>100
9394,corrupt,112,26974309,99.725014399,_100,7,>100
9395,rebuild,112,26974421,99.7254284672,_100,7,>100
9396,newspapers,112,26974533,99.7258425353,_100,10,>100
9397,establish,112,26974645,99.7262566034,_100,9,>100
9398,empower,112,26974757,99.7266706715,_100,7,>100
9399,stabbed,112,26974869,99.7270847397,_100,7,>100
9400,listenin,112,26974981,99.7274988078,_100,8,>100
9401,threatened,112,26975093,99.7279128759,_100,10,>100
9402,dots,112,26975205,99.7283269441,_100,4,>100
9403,tzu,112,26975317,99.7287410122,_100,3,>100
9404,kush,112,26975429,99.7291550803,_100,4,>100
9405,container,112,26975541,99.7295691484,_100,9,>100
9406,penalties,112,26975653,99.7299832166,_100,9,>100
9407,healed,112,26975765,99.7303972847,_100,6,>100
9408,realizes,112,26975877,99.7308113528,_100,8,>100
9409,toni,112,26975989,99.7312254209,_100,4,>100
9410,firehook,112,26976101,99.7316394891,_100,8,>100
9411,yells,112,26976213,99.7320535572,_100,5,>100
9412,ramp,112,26976325,99.7324676253,_100,4,>100
9413,powered,112,26976437,99.7328816935,_100,7,>100
9414,planner,112,26976549,99.7332957616,_100,7,>100
9415,oneself,112,26976661,99.7337098297,_100,7,>100
9416,chapel,112,26976773,99.7341238978,_100,6,>100
9417,cher,112,26976885,99.734537966,_100,4,>100
9418,vets,112,26976997,99.7349520341,_100,4,>100
9419,righteous,112,26977109,99.7353661022,_100,9,>100
9420,barriers,112,26977221,99.7357801703,_100,8,>100
9421,git,112,26977333,99.7361942385,_100,3,>100
9422,phrases,112,26977445,99.7366083066,_100,7,>100
9423,barney,112,26977557,99.7370223747,_100,6,>100
9424,saddest,112,26977669,99.7374364429,_100,7,>100
9425,mizzou,112,26977781,99.737850511,_100,6,>100
9426,taxpayers,112,26977893,99.7382645791,_100,9,>100
9427,usb,111,26978004,99.7386749502,_100,3,>100
9428,guesses,111,26978115,99.7390853213,_100,7,>100
9429,heavens,111,26978226,99.7394956924,_100,7,>100
9430,girlie,111,26978337,99.7399060635,_100,6,>100
9431,deserving,111,26978448,99.7403164346,_100,9,>100
9432,sustainability,111,26978559,99.7407268057,_100,14,>100
9433,keepin,111,26978670,99.7411371767,_100,6,>100
9434,intentional,111,26978781,99.7415475478,_100,11,>100
9435,arrogant,111,26978892,99.7419579189,_100,8,>100
9436,crust,111,26979003,99.74236829,_100,5,>100
9437,horns,111,26979114,99.7427786611,_100,5,>100
9438,utterly,111,26979225,99.7431890322,_100,7,>100
9439,dinners,111,26979336,99.7435994033,_100,7,>100
9440,ethan,111,26979447,99.7440097744,_100,5,>100
9441,organ,111,26979558,99.7444201455,_100,5,>100
9442,dwts,111,26979669,99.7448305166,_100,4,>100
9443,sung,111,26979780,99.7452408876,_100,4,>100
9444,finalist,111,26979891,99.7456512587,_100,8,>100
9445,hangs,111,26980002,99.7460616298,_100,5,>100
9446,strengthen,111,26980113,99.7464720009,_100,10,>100
9447,wesley,111,26980224,99.746882372,_100,6,>100
9448,biscuit,111,26980335,99.7472927431,_100,7,>100
9449,doughnuts,111,26980446,99.7477031142,_100,9,>100
9450,squirrels,111,26980557,99.7481134853,_100,9,>100
9451,lacks,111,26980668,99.7485238564,_100,5,>100
9452,snuggle,111,26980779,99.7489342275,_100,7,>100
9453,philippines,111,26980890,99.7493445985,_100,11,>100
9454,ana,111,26981001,99.7497549696,_100,3,>100
9455,jasmine,111,26981112,99.7501653407,_100,7,>100
9456,controversy,111,26981223,99.7505757118,_100,11,>100
9457,contestants,111,26981334,99.7509860829,_100,11,>100
9458,captured,111,26981445,99.751396454,_100,8,>100
9459,understandable,111,26981556,99.7518068251,_100,14,>100
9460,humbled,111,26981667,99.7522171962,_100,7,>100
9461,cooks,111,26981778,99.7526275673,_100,5,>100
9462,shoppers,111,26981889,99.7530379384,_100,8,>100
9463,import,111,26982000,99.7534483095,_100,6,>100
9464,busting,111,26982111,99.7538586805,_100,7,>100
9465,missy,111,26982222,99.7542690516,_100,5,>100
9466,risen,111,26982333,99.7546794227,_100,5,>100
9467,gummy,111,26982444,99.7550897938,_100,5,>100
9468,persistence,111,26982555,99.7555001649,_100,11,>100
9469,phx,111,26982666,99.755910536,_100,3,>100
9470,baggage,111,26982777,99.7563209071,_100,7,>100
9471,muslim,111,26982888,99.7567312782,_100,6,>100
9472,medication,111,26982999,99.7571416493,_100,10,>100
9473,marina,111,26983110,99.7575520204,_100,6,>100
9474,arrow,111,26983221,99.7579623914,_100,5,>100
9475,appearing,111,26983332,99.7583727625,_100,9,>100
9476,conservatives,110,26983442,99.7587794366,_100,13,>100
9477,connects,110,26983552,99.7591861106,_100,8,>100
9478,euro,110,26983662,99.7595927847,_100,4,>100
9479,receiver,110,26983772,99.7599994588,_100,8,>100
9480,intimate,110,26983882,99.7604061328,_100,8,>100
9481,cursing,110,26983992,99.7608128069,_100,7,>100
9482,congressional,110,26984102,99.7612194809,_100,13,>100
9483,wandering,110,26984212,99.761626155,_100,9,>100
9484,coleman,110,26984322,99.762032829,_100,7,>100
9485,verify,110,26984432,99.7624395031,_100,6,>100
9486,screwing,110,26984542,99.7628461771,_100,8,>100
9487,hum,110,26984652,99.7632528512,_100,3,>100
9488,brainstorming,110,26984762,99.7636595252,_100,13,>100
9489,muhammad,110,26984872,99.7640661993,_100,8,>100
9490,expectation,110,26984982,99.7644728733,_100,11,>100
9491,successes,110,26985092,99.7648795474,_100,9,>100
9492,gourmet,110,26985202,99.7652862215,_100,7,>100
9493,crispy,110,26985312,99.7656928955,_100,6,>100
9494,rows,110,26985422,99.7660995696,_100,4,>100
9495,sequence,110,26985532,99.7665062436,_100,8,>100
9496,hardy,110,26985642,99.7669129177,_100,5,>100
9497,motor,110,26985752,99.7673195917,_100,5,>100
9498,110,110,26985862,99.7677262658,_100,3,>100
9499,ak,110,26985972,99.7681329398,_100,2,>100
9500,hawk,110,26986082,99.7685396139,_100,4,>100
9501,lms,110,26986192,99.7689462879,_100,3,>100
9502,sinus,110,26986302,99.769352962,_100,5,>100
9503,linux,110,26986412,99.769759636,_100,5,>100
9504,insulting,110,26986522,99.7701663101,_100,9,>100
9505,decrease,110,26986632,99.7705729841,_100,8,>100
9506,ounce,110,26986742,99.7709796582,_100,5,>100
9507,alexandria,110,26986852,99.7713863323,_100,10,>100
9508,affection,110,26986962,99.7717930063,_100,9,>100
9509,burbank,110,26987072,99.7721996804,_100,7,>100
9510,rug,110,26987182,99.7726063544,_100,3,>100
9511,targets,110,26987292,99.7730130285,_100,7,>100
9512,buyer,110,26987402,99.7734197025,_100,5,>100
9513,confess,110,26987512,99.7738263766,_100,7,>100
9514,functions,110,26987622,99.7742330506,_100,9,>100
9515,communicating,110,26987732,99.7746397247,_100,13,>100
9516,gus,110,26987842,99.7750463987,_100,3,>100
9517,theories,110,26987952,99.7754530728,_100,8,>100
9518,snooze,110,26988062,99.7758597468,_100,6,>100
9519,wh,110,26988172,99.7762664209,_100,2,>100
9520,daytime,110,26988282,99.776673095,_100,7,>100
9521,lifelong,110,26988392,99.777079769,_100,8,>100
9522,scissors,110,26988502,99.7774864431,_100,8,>100
9523,unwanted,110,26988612,99.7778931171,_100,8,>100
9524,fletcher,110,26988722,99.7782997912,_100,8,>100
9525,foam,110,26988832,99.7787064652,_100,4,>100
9526,licking,109,26988941,99.7791094422,_100,7,>100
9527,srsly,109,26989050,99.7795124193,_100,5,>100
9528,timmy,109,26989159,99.7799153963,_100,5,>100
9529,uptown,109,26989268,99.7803183733,_100,6,>100
9530,trilogy,109,26989377,99.7807213503,_100,7,>100
9531,snag,109,26989486,99.7811243273,_100,4,>100
9532,recommending,109,26989595,99.7815273043,_100,12,>100
9533,midget,109,26989704,99.7819302814,_100,6,>100
9534,tomarrow,109,26989813,99.7823332584,_100,8,>100
9535,beverages,109,26989922,99.7827362354,_100,9,>100
9536,sullivan,109,26990031,99.7831392124,_100,8,>100
9537,perez,109,26990140,99.7835421894,_100,5,>100
9538,cuba,109,26990249,99.7839451664,_100,4,>100
9539,processed,109,26990358,99.7843481435,_100,9,>100
9540,iam,109,26990467,99.7847511205,_100,3,>100
9541,inability,109,26990576,99.7851540975,_100,9,>100
9542,strictly,109,26990685,99.7855570745,_100,8,>100
9543,stash,109,26990794,99.7859600515,_100,5,>100
9544,desired,109,26990903,99.7863630285,_100,7,>100
9545,bittersweet,109,26991012,99.7867660056,_100,11,>100
9546,brock,109,26991121,99.7871689826,_100,5,>100
9547,dreamt,109,26991230,99.7875719596,_100,6,>100
9548,frat,109,26991339,99.7879749366,_100,4,>100
9549,balboa,109,26991448,99.7883779136,_100,6,>100
9550,rises,109,26991557,99.7887808906,_100,5,>100
9551,turf,109,26991666,99.7891838677,_100,4,>100
9552,taped,109,26991775,99.7895868447,_100,5,>100
9553,nova,109,26991884,99.7899898217,_100,4,>100
9554,cameo,109,26991993,99.7903927987,_100,5,>100
9555,marvelous,109,26992102,99.7907957757,_100,9,>100
9556,wheelchair,109,26992211,99.7911987527,_100,10,>100
9557,hon,109,26992320,99.7916017298,_100,3,>100
9558,neglect,109,26992429,99.7920047068,_100,7,>100
9559,query,109,26992538,99.7924076838,_100,5,>100
9560,hugh,109,26992647,99.7928106608,_100,4,>100
9561,logos,109,26992756,99.7932136378,_100,5,>100
9562,empowering,109,26992865,99.7936166148,_100,10,>100
9563,stuffing,109,26992974,99.7940195919,_100,8,>100
9564,arab,109,26993083,99.7944225689,_100,4,>100
9565,peel,109,26993192,99.7948255459,_100,4,>100
9566,ahahaha,109,26993301,99.7952285229,_100,7,>100
9567,pablo,109,26993410,99.7956314999,_100,5,>100
9568,chinatown,109,26993519,99.7960344769,_100,9,>100
9569,pizzas,109,26993628,99.796437454,_100,6,>100
9570,instinct,109,26993737,99.796840431,_100,8,>100
9571,spammers,109,26993846,99.797243408,_100,8,>100
9572,victories,108,26993954,99.797642688,_100,9,>100
9573,boehner,108,26994062,99.7980419679,_100,7,>100
9574,gracias,108,26994170,99.7984412479,_100,7,>100
9575,bae,108,26994278,99.7988405279,_100,3,>100
9576,catcher,108,26994386,99.7992398079,_100,7,>100
9577,operations,108,26994494,99.7996390879,_100,10,>100
9578,manners,108,26994602,99.8000383678,_100,7,>100
9579,hippie,108,26994710,99.8004376478,_100,6,>100
9580,movements,108,26994818,99.8008369278,_100,9,>100
9581,bama,108,26994926,99.8012362078,_100,4,>100
9582,robbie,108,26995034,99.8016354878,_100,6,>100
9583,hooking,108,26995142,99.8020347677,_100,7,>100
9584,composer,108,26995250,99.8024340477,_100,8,>100
9585,sermon,108,26995358,99.8028333277,_100,6,>100
9586,sweatpants,108,26995466,99.8032326077,_100,10,>100
9587,mascara,108,26995574,99.8036318877,_100,7,>100
9588,vacations,108,26995682,99.8040311676,_100,9,>100
9589,delighted,108,26995790,99.8044304476,_100,9,>100
9590,temptation,108,26995898,99.8048297276,_100,10,>100
9591,shines,108,26996006,99.8052290076,_100,6,>100
9592,partnering,108,26996114,99.8056282876,_100,10,>100
9593,occurred,108,26996222,99.8060275675,_100,8,>100
9594,givin,108,26996330,99.8064268475,_100,5,>100
9595,renting,108,26996438,99.8068261275,_100,7,>100
9596,rapid,108,26996546,99.8072254075,_100,5,>100
9597,neutral,108,26996654,99.8076246875,_100,7,>100
9598,microphone,108,26996762,99.8080239674,_100,10,>100
9599,whilst,108,26996870,99.8084232474,_100,6,>100
9600,meg,108,26996978,99.8088225274,_100,3,>100
9601,dealers,108,26997086,99.8092218074,_100,7,>100
9602,guides,108,26997194,99.8096210874,_100,6,>100
9603,tipsy,108,26997302,99.8100203673,_100,5,>100
9604,surviving,108,26997410,99.8104196473,_100,9,>100
9605,scholar,108,26997518,99.8108189273,_100,7,>100
9606,meatballs,108,26997626,99.8112182073,_100,9,>100
9607,ambitious,108,26997734,99.8116174873,_100,9,>100
9608,fla,108,26997842,99.8120167672,_100,3,>100
9609,paired,108,26997950,99.8124160472,_100,6,>100
9610,cult,108,26998058,99.8128153272,_100,4,>100
9611,fundamental,108,26998166,99.8132146072,_100,11,>100
9612,tru,108,26998274,99.8136138872,_100,3,>100
9613,pads,108,26998382,99.8140131671,_100,4,>100
9614,evolve,108,26998490,99.8144124471,_100,6,>100
9615,hookah,108,26998598,99.8148117271,_100,6,>100
9616,stove,108,26998706,99.8152110071,_100,5,>100
9617,mushrooms,108,26998814,99.8156102871,_100,9,>100
9618,hendrix,107,26998921,99.81600587,_100,7,>100
9619,penguin,107,26999028,99.816401453,_100,7,>100
9620,gears,107,26999135,99.8167970359,_100,5,>100
9621,woken,107,26999242,99.8171926188,_100,5,>100
9622,reducing,107,26999349,99.8175882018,_100,8,>100
9623,pinot,107,26999456,99.8179837847,_100,5,>100
9624,vandy,107,26999563,99.8183793677,_100,5,>100
9625,advocates,107,26999670,99.8187749506,_100,9,>100
9626,fella,107,26999777,99.8191705336,_100,5,>100
9627,instance,107,26999884,99.8195661165,_100,8,>100
9628,upsets,107,26999991,99.8199616994,_100,6,>100
9629,indicate,107,27000098,99.8203572824,_100,8,>100
9630,107,107,27000205,99.8207528653,_100,3,>100
9631,darker,107,27000312,99.8211484483,_100,6,>100
9632,nominations,107,27000419,99.8215440312,_100,11,>100
9633,wierd,107,27000526,99.8219396142,_100,5,>100
9634,financing,107,27000633,99.8223351971,_100,9,>100
9635,glimpse,107,27000740,99.82273078,_100,7,>100
9636,encourages,107,27000847,99.823126363,_100,10,>100
9637,rendition,107,27000954,99.8235219459,_100,9,>100
9638,chen,107,27001061,99.8239175289,_100,4,>100
9639,hiccups,107,27001168,99.8243131118,_100,7,>100
9640,dilemma,107,27001275,99.8247086948,_100,7,>100
9641,oysters,107,27001382,99.8251042777,_100,7,>100
9642,swings,107,27001489,99.8254998606,_100,6,>100
9643,internships,107,27001596,99.8258954436,_100,11,>100
9644,ingredient,107,27001703,99.8262910265,_100,10,>100
9645,wiped,107,27001810,99.8266866095,_100,5,>100
9646,stretching,107,27001917,99.8270821924,_100,10,>100
9647,killers,107,27002024,99.8274777754,_100,7,>100
9648,snarky,107,27002131,99.8278733583,_100,6,>100
9649,galore,107,27002238,99.8282689412,_100,6,>100
9650,tends,107,27002345,99.8286645242,_100,5,>100
9651,founders,107,27002452,99.8290601071,_100,8,>100
9652,heartbeat,107,27002559,99.8294556901,_100,9,>100
9653,heater,107,27002666,99.829851273,_100,6,>100
9654,emerald,107,27002773,99.830246856,_100,7,>100
9655,dug,107,27002880,99.8306424389,_100,3,>100
9656,bullies,106,27002986,99.8310343248,_100,7,>100
9657,creeper,106,27003092,99.8314262107,_100,7,>100
9658,106,106,27003198,99.8318180966,_100,3,>100
9659,stocking,106,27003304,99.8322099825,_100,8,>100
9660,dashboard,106,27003410,99.8326018684,_100,9,>100
9661,precise,106,27003516,99.8329937543,_100,7,>100
9662,mae,106,27003622,99.8333856402,_100,3,>100
9663,custody,106,27003728,99.8337775261,_100,7,>100
9664,turtles,106,27003834,99.8341694121,_100,7,>100
9665,companion,106,27003940,99.834561298,_100,9,>100
9666,strippers,106,27004046,99.8349531839,_100,9,>100
9667,gore,106,27004152,99.8353450698,_100,4,>100
9668,filters,106,27004258,99.8357369557,_100,7,>100
9669,cookbook,106,27004364,99.8361288416,_100,8,>100
9670,esteem,106,27004470,99.8365207275,_100,6,>100
9671,vietnam,106,27004576,99.8369126134,_100,7,>100
9672,branches,106,27004682,99.8373044993,_100,8,>100
9673,circa,106,27004788,99.8376963852,_100,5,>100
9674,consist,106,27004894,99.8380882711,_100,7,>100
9675,hilltop,106,27005000,99.838480157,_100,7,>100
9676,televised,106,27005106,99.8388720429,_100,9,>100
9677,courageous,106,27005212,99.8392639288,_100,10,>100
9678,maintaining,106,27005318,99.8396558147,_100,11,>100
9679,erik,106,27005424,99.8400477006,_100,4,>100
9680,definately,106,27005530,99.8404395866,_100,10,>100
9681,currency,106,27005636,99.8408314725,_100,8,>100
9682,webster,106,27005742,99.8412233584,_100,7,>100
9683,impressions,106,27005848,99.8416152443,_100,11,>100
9684,askin,106,27005954,99.8420071302,_100,5,>100
9685,toby,106,27006060,99.8423990161,_100,4,>100
9686,huffington,106,27006166,99.842790902,_100,10,>100
9687,disorder,106,27006272,99.8431827879,_100,8,>100
9688,hints,106,27006378,99.8435746738,_100,5,>100
9689,lust,106,27006484,99.8439665597,_100,4,>100
9690,slowing,106,27006590,99.8443584456,_100,7,>100
9691,scholarly,106,27006696,99.8447503315,_100,9,>100
9692,mansion,106,27006802,99.8451422174,_100,7,>100
9693,cologne,106,27006908,99.8455341033,_100,7,>100
9694,wp,106,27007014,99.8459259892,_100,2,>100
9695,redneck,106,27007120,99.8463178751,_100,7,>100
9696,viable,106,27007226,99.8467097611,_100,6,>100
9697,sheer,106,27007332,99.847101647,_100,5,>100
9698,albany,106,27007438,99.8474935329,_100,6,>100
9699,carmel,106,27007544,99.8478854188,_100,6,>100
9700,takeover,106,27007650,99.8482773047,_100,8,>100
9701,athens,105,27007755,99.8486654935,_100,6,>100
9702,jaguars,105,27007860,99.8490536824,_100,7,>100
9703,foreal,105,27007965,99.8494418713,_100,6,>100
9704,fluffy,105,27008070,99.8498300602,_100,6,>100
9705,flames,105,27008175,99.850218249,_100,6,>100
9706,unlocked,105,27008280,99.8506064379,_100,8,>100
9707,rory,105,27008385,99.8509946268,_100,4,>100
9708,reject,105,27008490,99.8513828156,_100,6,>100
9709,stevens,105,27008595,99.8517710045,_100,7,>100
9710,creeped,105,27008700,99.8521591934,_100,7,>100
9711,105,105,27008805,99.8525473822,_100,3,>100
9712,expose,105,27008910,99.8529355711,_100,6,>100
9713,gents,105,27009015,99.85332376,_100,5,>100
9714,dwell,105,27009120,99.8537119488,_100,5,>100
9715,bouncing,105,27009225,99.8541001377,_100,8,>100
9716,meme,105,27009330,99.8544883266,_100,4,>100
9717,dorothy,105,27009435,99.8548765155,_100,7,>100
9718,walgreens,105,27009540,99.8552647043,_100,9,>100
9719,hamburger,105,27009645,99.8556528932,_100,9,>100
9720,ashton,105,27009750,99.8560410821,_100,6,>100
9721,pronounced,105,27009855,99.8564292709,_100,10,>100
9722,ferris,105,27009960,99.8568174598,_100,6,>100
9723,colbert,105,27010065,99.8572056487,_100,7,>100
9724,bundle,105,27010170,99.8575938375,_100,6,>100
9725,buns,105,27010275,99.8579820264,_100,4,>100
9726,sunlight,105,27010380,99.8583702153,_100,8,>100
9727,fremont,105,27010485,99.8587584042,_100,7,>100
9728,angelina,105,27010590,99.859146593,_100,8,>100
9729,contributing,105,27010695,99.8595347819,_100,12,>100
9730,noone,105,27010800,99.8599229708,_100,5,>100
9731,utter,105,27010905,99.8603111596,_100,5,>100
9732,violin,105,27011010,99.8606993485,_100,6,>100
9733,divided,105,27011115,99.8610875374,_100,7,>100
9734,chirping,105,27011220,99.8614757262,_100,8,>100
9735,actin,105,27011325,99.8618639151,_100,5,>100
9736,jst,105,27011430,99.862252104,_100,3,>100
9737,banking,105,27011535,99.8626402928,_100,7,>100
9738,sinatra,105,27011640,99.8630284817,_100,7,>100
9739,scotty,105,27011745,99.8634166706,_100,6,>100
9740,listener,105,27011850,99.8638048595,_100,8,>100
9741,smithsonian,105,27011955,99.8641930483,_100,11,>100
9742,thief,105,27012060,99.8645812372,_100,5,>100
9743,vic,105,27012165,99.8649694261,_100,3,>100
9744,debit,105,27012270,99.8653576149,_100,5,>100
9745,diner,105,27012375,99.8657458038,_100,5,>100
9746,brat,105,27012480,99.8661339927,_100,4,>100
9747,egyptian,104,27012584,99.8665184845,_100,8,>100
9748,weaver,104,27012688,99.8669029763,_100,6,>100
9749,temper,104,27012792,99.8672874682,_100,6,>100
9750,cedar,104,27012896,99.86767196,_100,5,>100
9751,scanning,104,27013000,99.8680564518,_100,8,>100
9752,fielder,104,27013104,99.8684409437,_100,7,>100
9753,hubs,104,27013208,99.8688254355,_100,4,>100
9754,verb,104,27013312,99.8692099273,_100,4,>100
9755,stain,104,27013416,99.8695944192,_100,5,>100
9756,mofo,104,27013520,99.869978911,_100,4,>100
9757,topping,104,27013624,99.8703634028,_100,7,>100
9758,104,104,27013728,99.8707478947,_100,3,>100
9759,permanently,104,27013832,99.8711323865,_100,11,>100
9760,halls,104,27013936,99.8715168783,_100,5,>100
9761,nvm,104,27014040,99.8719013702,_100,3,>100
9762,lawsuit,104,27014144,99.872285862,_100,7,>100
9763,shortage,104,27014248,99.8726703538,_100,8,>100
9764,swagg,104,27014352,99.8730548457,_100,5,>100
9765,dependent,104,27014456,99.8734393375,_100,9,>100
9766,aunts,104,27014560,99.8738238293,_100,5,>100
9767,mla,104,27014664,99.8742083212,_100,3,>100
9768,yogi,104,27014768,99.874592813,_100,4,>100
9769,directioner,104,27014872,99.8749773048,_100,11,>100
9770,routes,104,27014976,99.8753617966,_100,6,>100
9771,fangirl,104,27015080,99.8757462885,_100,7,>100
9772,mantra,104,27015184,99.8761307803,_100,6,>100
9773,gloria,104,27015288,99.8765152721,_100,6,>100
9774,restart,104,27015392,99.876899764,_100,7,>100
9775,heres,104,27015496,99.8772842558,_100,5,>100
9776,effin,104,27015600,99.8776687476,_100,5,>100
9777,chronic,104,27015704,99.8780532395,_100,7,>100
9778,frosting,104,27015808,99.8784377313,_100,8,>100
9779,hopped,104,27015912,99.8788222231,_100,6,>100
9780,flows,104,27016016,99.879206715,_100,5,>100
9781,incorporate,104,27016120,99.8795912068,_100,11,>100
9782,incorrect,104,27016224,99.8799756986,_100,9,>100
9783,blowout,104,27016328,99.8803601905,_100,7,>100
9784,punches,104,27016432,99.8807446823,_100,7,>100
9785,queer,104,27016536,99.8811291741,_100,5,>100
9786,harley,104,27016640,99.881513666,_100,6,>100
9787,toxic,104,27016744,99.8818981578,_100,5,>100
9788,dub,104,27016848,99.8822826496,_100,3,>100
9789,venus,104,27016952,99.8826671415,_100,5,>100
9790,significantly,104,27017056,99.8830516333,_100,13,>100
9791,verge,104,27017160,99.8834361251,_100,5,>100
9792,snapped,104,27017264,99.883820617,_100,7,>100
9793,safari,104,27017368,99.8842051088,_100,6,>100
9794,pastry,104,27017472,99.8845896006,_100,6,>100
9795,attorneys,104,27017576,99.8849740925,_100,9,>100
9796,meltdown,104,27017680,99.8853585843,_100,8,>100
9797,mavericks,104,27017784,99.8857430761,_100,9,>100
9798,fixes,104,27017888,99.886127568,_100,5,>100
9799,jello,104,27017992,99.8865120598,_100,5,>100
9800,golfing,103,27018095,99.8868928546,_100,7,>100
9801,initiatives,103,27018198,99.8872736494,_100,11,>100
9802,paragraph,103,27018301,99.8876544442,_100,9,>100
9803,ks,103,27018404,99.888035239,_100,2,>100
9804,bridal,103,27018507,99.8884160338,_100,6,>100
9805,flex,103,27018610,99.8887968286,_100,4,>100
9806,bruise,103,27018713,99.8891776234,_100,6,>100
9807,cafeteria,103,27018816,99.8895584182,_100,9,>100
9808,meryl,103,27018919,99.889939213,_100,5,>100
9809,andrews,103,27019022,99.8903200077,_100,7,>100
9810,prompt,103,27019125,99.8907008025,_100,6,>100
9811,rooney,103,27019228,99.8910815973,_100,6,>100
9812,shirley,103,27019331,99.8914623921,_100,7,>100
9813,unsure,103,27019434,99.8918431869,_100,6,>100
9814,guacamole,103,27019537,99.8922239817,_100,9,>100
9815,homers,103,27019640,99.8926047765,_100,6,>100
9816,enters,103,27019743,99.8929855713,_100,6,>100
9817,stella,103,27019846,99.8933663661,_100,6,>100
9818,mushroom,103,27019949,99.8937471609,_100,8,>100
9819,abandon,103,27020052,99.8941279557,_100,7,>100
9820,sq,103,27020155,99.8945087505,_100,2,>100
9821,portable,103,27020258,99.8948895453,_100,8,>100
9822,dropbox,103,27020361,99.8952703401,_100,7,>100
9823,kenya,103,27020464,99.8956511349,_100,5,>100
9824,circuit,103,27020567,99.8960319297,_100,7,>100
9825,fx,103,27020670,99.8964127245,_100,2,>100
9826,bashing,103,27020773,99.8967935193,_100,7,>100
9827,hobbit,103,27020876,99.8971743141,_100,6,>100
9828,haley,103,27020979,99.8975551089,_100,5,>100
9829,dearly,103,27021082,99.8979359037,_100,6,>100
9830,moses,103,27021185,99.8983166985,_100,5,>100
9831,perf,103,27021288,99.8986974933,_100,4,>100
9832,charities,103,27021391,99.899078288,_100,9,>100
9833,lube,103,27021494,99.8994590828,_100,4,>100
9834,103,103,27021597,99.8998398776,_100,3,>100
9835,spokane,103,27021700,99.9002206724,_100,7,>100
9836,obstacle,103,27021803,99.9006014672,_100,8,>100
9837,capitalism,103,27021906,99.900982262,_100,10,>100
9838,flexibility,103,27022009,99.9013630568,_100,11,>100
9839,trolling,103,27022112,99.9017438516,_100,8,>100
9840,organizers,103,27022215,99.9021246464,_100,10,>100
9841,rapids,103,27022318,99.9025054412,_100,6,>100
9842,bacteria,103,27022421,99.902886236,_100,8,>100
9843,seldom,103,27022524,99.9032670308,_100,6,>100
9844,smashing,103,27022627,99.9036478256,_100,8,>100
9845,strengths,103,27022730,99.9040286204,_100,9,>100
9846,bragging,103,27022833,99.9044094152,_100,8,>100
9847,burke,103,27022936,99.90479021,_100,5,>100
9848,vin,103,27023039,99.9051710048,_100,3,>100
9849,tots,103,27023142,99.9055517996,_100,4,>100
9850,pinky,103,27023245,99.9059325944,_100,5,>100
9851,presidents,103,27023348,99.9063133892,_100,10,>100
9852,emphasis,103,27023451,99.906694184,_100,8,>100
9853,stacy,103,27023554,99.9070749788,_100,5,>100
9854,rn,103,27023657,99.9074557735,_100,2,>100
9855,dragons,103,27023760,99.9078365683,_100,7,>100
9856,anticipated,103,27023863,99.9082173631,_100,11,>100
9857,bernie,102,27023965,99.9085944609,_100,6,>100
9858,102,102,27024067,99.9089715587,_100,3,>100
9859,ul,102,27024169,99.9093486564,_100,2,>100
9860,bogus,102,27024271,99.9097257542,_100,5,>100
9861,politically,102,27024373,99.9101028519,_100,11,>100
9862,au,102,27024475,99.9104799497,_100,2,>100
9863,breaths,102,27024577,99.9108570475,_100,7,>100
9864,ttyl,102,27024679,99.9112341452,_100,4,>100
9865,psu,102,27024781,99.911611243,_100,3,>100
9866,licensed,102,27024883,99.9119883407,_100,8,>100
9867,cm,102,27024985,99.9123654385,_100,2,>100
9868,headquarters,102,27025087,99.9127425362,_100,12,>100
9869,thriller,102,27025189,99.913119634,_100,8,>100
9870,vcu,102,27025291,99.9134967318,_100,3,>100
9871,cursed,102,27025393,99.9138738295,_100,6,>100
9872,jessie,102,27025495,99.9142509273,_100,6,>100
9873,brendan,102,27025597,99.914628025,_100,7,>100
9874,gel,102,27025699,99.9150051228,_100,3,>100
9875,brit,102,27025801,99.9153822206,_100,4,>100
9876,jameson,102,27025903,99.9157593183,_100,7,>100
9877,greed,102,27026005,99.9161364161,_100,5,>100
9878,excess,102,27026107,99.9165135138,_100,6,>100
9879,pours,102,27026209,99.9168906116,_100,5,>100
9880,skc,102,27026311,99.9172677094,_100,3,>100
9881,lawson,102,27026413,99.9176448071,_100,6,>100
9882,perspectives,102,27026515,99.9180219049,_100,12,>100
9883,triumph,102,27026617,99.9183990026,_100,7,>100
9884,consult,102,27026719,99.9187761004,_100,7,>100
9885,mojo,102,27026821,99.9191531981,_100,4,>100
9886,workday,102,27026923,99.9195302959,_100,7,>100
9887,op,102,27027025,99.9199073937,_100,2,>100
9888,drawer,102,27027127,99.9202844914,_100,6,>100
9889,holders,102,27027229,99.9206615892,_100,7,>100
9890,generated,102,27027331,99.9210386869,_100,9,>100
9891,itching,102,27027433,99.9214157847,_100,7,>100
9892,db,102,27027535,99.9217928825,_100,2,>100
9893,pokemon,102,27027637,99.9221699802,_100,7,>100
9894,detention,102,27027739,99.922547078,_100,9,>100
9895,tile,102,27027841,99.9229241757,_100,4,>100
9896,targeting,102,27027943,99.9233012735,_100,9,>100
9897,shack,102,27028045,99.9236783713,_100,5,>100
9898,singapore,102,27028147,99.924055469,_100,9,>100
9899,kd,102,27028249,99.9244325668,_100,2,>100
9900,copying,102,27028351,99.9248096645,_100,7,>100
9901,mccartney,102,27028453,99.9251867623,_100,9,>100
9902,brushing,102,27028555,99.92556386,_100,8,>100
9903,sorrow,102,27028657,99.9259409578,_100,6,>100
9904,pools,102,27028759,99.9263180556,_100,5,>100
9905,curling,102,27028861,99.9266951533,_100,7,>100
9906,deed,102,27028963,99.9270722511,_100,4,>100
9907,criminals,102,27029065,99.9274493488,_100,9,>100
9908,creators,102,27029167,99.9278264466,_100,8,>100
9909,juices,102,27029269,99.9282035444,_100,6,>100
9910,snowy,102,27029371,99.9285806421,_100,5,>100
9911,strangely,102,27029473,99.9289577399,_100,9,>100
9912,onstage,102,27029575,99.9293348376,_100,7,>100
9913,framework,102,27029677,99.9297119354,_100,9,>100
9914,dread,102,27029779,99.9300890332,_100,5,>100
9915,qotd,102,27029881,99.9304661309,_100,4,>100
9916,argentina,102,27029983,99.9308432287,_100,9,>100
9917,urgent,102,27030085,99.9312203264,_100,6,>100
9918,heath,102,27030187,99.9315974242,_100,5,>100
9919,grrr,102,27030289,99.9319745219,_100,4,>100
9920,salvation,102,27030391,99.9323516197,_100,9,>100
9921,coldplay,102,27030493,99.9327287175,_100,8,>100
9922,werent,102,27030595,99.9331058152,_100,6,>100
9923,fascinated,102,27030697,99.933482913,_100,10,>100
9924,defeats,101,27030798,99.9338563137,_100,7,>100
9925,imax,101,27030899,99.9342297144,_100,4,>100
9926,fellowship,101,27031000,99.9346031151,_100,10,>100
9927,lending,101,27031101,99.9349765159,_100,7,>100
9928,joss,101,27031202,99.9353499166,_100,4,>100
9929,flashback,101,27031303,99.9357233173,_100,9,>100
9930,preds,101,27031404,99.936096718,_100,5,>100
9931,wander,101,27031505,99.9364701188,_100,6,>100
9932,etta,101,27031606,99.9368435195,_100,4,>100
9933,stuart,101,27031707,99.9372169202,_100,6,>100
9934,coloring,101,27031808,99.9375903209,_100,8,>100
9935,deeds,101,27031909,99.9379637216,_100,5,>100
9936,rapidly,101,27032010,99.9383371224,_100,7,>100
9937,joyful,101,27032111,99.9387105231,_100,6,>100
9938,tolerate,101,27032212,99.9390839238,_100,8,>100
9939,cliche,101,27032313,99.9394573245,_100,6,>100
9940,yale,101,27032414,99.9398307253,_100,4,>100
9941,destined,101,27032515,99.940204126,_100,8,>100
9942,disability,101,27032616,99.9405775267,_100,10,>100
9943,accordingly,101,27032717,99.9409509274,_100,11,>100
9944,arrangements,101,27032818,99.9413243281,_100,12,>100
9945,haul,101,27032919,99.9416977289,_100,4,>100
9946,ymca,101,27033020,99.9420711296,_100,4,>100
9947,mite,101,27033121,99.9424445303,_100,4,>100
9948,pretzels,101,27033222,99.942817931,_100,8,>100
9949,sketchy,101,27033323,99.9431913317,_100,7,>100
9950,lasagna,101,27033424,99.9435647325,_100,7,>100
9951,patton,101,27033525,99.9439381332,_100,6,>100
9952,nostalgia,101,27033626,99.9443115339,_100,9,>100
9953,skeptical,101,27033727,99.9446849346,_100,9,>100
9954,slippers,101,27033828,99.9450583354,_100,8,>100
9955,feminist,101,27033929,99.9454317361,_100,8,>100
9956,farewell,101,27034030,99.9458051368,_100,8,>100
9957,trim,101,27034131,99.9461785375,_100,4,>100
9958,iight,101,27034232,99.9465519382,_100,5,>100
9959,roomie,101,27034333,99.946925339,_100,6,>100
9960,centered,101,27034434,99.9472987397,_100,8,>100
9961,howdy,101,27034535,99.9476721404,_100,5,>100
9962,rushed,101,27034636,99.9480455411,_100,6,>100
9963,chooses,101,27034737,99.9484189419,_100,7,>100
9964,itchy,101,27034838,99.9487923426,_100,5,>100
9965,cle,101,27034939,99.9491657433,_100,3,>100
9966,101,101,27035040,99.949539144,_100,3,>100
9967,diggin,101,27035141,99.9499125447,_100,6,>100
9968,intersection,101,27035242,99.9502859455,_100,12,>100
9969,sissy,101,27035343,99.9506593462,_100,5,>100
9970,activist,101,27035444,99.9510327469,_100,8,>100
9971,kidney,101,27035545,99.9514061476,_100,6,>100
9972,vulnerable,101,27035646,99.9517795484,_100,10,>100
9973,budgets,101,27035747,99.9521529491,_100,7,>100
9974,braids,101,27035848,99.9525263498,_100,6,>100
9975,oaks,101,27035949,99.9528997505,_100,4,>100
9976,nintendo,101,27036050,99.9532731512,_100,8,>100
9977,fu,101,27036151,99.953646552,_100,2,>100
9978,liberals,101,27036252,99.9540199527,_100,8,>100
9979,presser,100,27036352,99.9543896564,_100,7,>10
9980,towels,100,27036452,99.9547593601,_100,6,>10
9981,gamel,100,27036552,99.9551290637,_100,5,>10
9982,mu,100,27036652,99.9554987674,_100,2,>10
9983,galleries,100,27036752,99.9558684711,_100,9,>10
9984,lafayette,100,27036852,99.9562381748,_100,9,>10
9985,alec,100,27036952,99.9566078785,_100,4,>10
9986,tux,100,27037052,99.9569775822,_100,3,>10
9987,retard,100,27037152,99.9573472859,_100,6,>10
9988,anita,100,27037252,99.9577169895,_100,5,>10
9989,cutler,100,27037352,99.9580866932,_100,6,>10
9990,directioners,100,27037452,99.9584563969,_100,12,>10
9991,treatments,100,27037552,99.9588261006,_100,10,>10
9992,flats,100,27037652,99.9591958043,_100,5,>10
9993,spoilers,100,27037752,99.959565508,_100,8,>10
9994,paige,100,27037852,99.9599352116,_100,5,>10
9995,pauly,100,27037952,99.9603049153,_100,5,>10
9996,orton,100,27038052,99.960674619,_100,5,>10
9997,simpler,100,27038152,99.9610443227,_100,7,>10
9998,tucker,100,27038252,99.9614140264,_100,6,>10
9999,paramount,100,27038352,99.9617837301,_100,9,>10
10000,confession,100,27038452,99.9621534338,_100,10,>10
10001,commence,100,27038552,99.9625231374,_100,8,>10
10002,obtain,100,27038652,99.9628928411,_100,6,>10
10003,nominee,100,27038752,99.9632625448,_100,7,>10
10004,augusta,100,27038852,99.9636322485,_100,7,>10
10005,secs,100,27038952,99.9640019522,_100,4,>10
10006,callback,100,27039052,99.9643716559,_100,8,>10
10007,headshots,100,27039152,99.9647413596,_100,9,>10
10008,isaiah,100,27039252,99.9651110632,_100,6,>10
10009,rural,100,27039352,99.9654807669,_100,5,>10
10010,brilliance,100,27039452,99.9658504706,_100,10,>10
10011,nurses,100,27039552,99.9662201743,_100,6,>10
10012,cw,100,27039652,99.966589878,_100,2,>10
10013,sail,100,27039752,99.9669595817,_100,4,>10
10014,ctr,100,27039852,99.9673292853,_100,3,>10
10015,categories,100,27039952,99.967698989,_100,10,>10
10016,flooded,100,27040052,99.9680686927,_100,7,>10
10017,gregg,100,27040152,99.9684383964,_100,5,>10
10018,towns,100,27040252,99.9688081001,_100,5,>10
10019,battleship,100,27040352,99.9691778038,_100,10,>10
10020,ar,100,27040452,99.9695475075,_100,2,>10
10021,fina,100,27040552,99.9699172111,_100,4,>10
10022,relay,100,27040652,99.9702869148,_100,5,>10
10023,birmingham,100,27040752,99.9706566185,_100,10,>10
10024,specialist,100,27040852,99.9710263222,_100,10,>10
10025,ds,100,27040952,99.9713960259,_100,2,>10
10026,pension,100,27041052,99.9717657296,_100,7,>10
10027,vibrant,100,27041152,99.9721354333,_100,7,>10
10028,frown,100,27041252,99.9725051369,_100,5,>10
10029,100,100,27041352,99.9728748406,_100,3,>10
10030,vacay,100,27041452,99.9732445443,_100,5,>10
10031,warnings,100,27041552,99.973614248,_100,8,>10
10032,mold,100,27041652,99.9739839517,_100,4,>10
10033,opps,100,27041752,99.9743536554,_100,4,>10
10034,certificates,100,27041852,99.9747233591,_100,12,>10
10035,spike,100,27041952,99.9750930627,_100,5,>10
10036,shouts,100,27042052,99.9754627664,_100,6,>10
10037,handmade,100,27042152,99.9758324701,_100,8,>10
10038,100th,100,27042252,99.9762021738,_100,5,>10
10039,99,99,27042351,99.9765681804,_100,2,>10
10040,98,98,27042449,99.9769304901,_100,2,>10
10041,97,97,27042546,99.9772891026,_100,2,>10
10042,96,96,27042642,99.9776440182,_100,2,>10
10043,95,95,27042737,99.9779952367,_100,2,>10
10044,94,94,27042831,99.9783427581,_100,2,>10
10045,93,93,27042924,99.9786865826,_100,2,>10
10046,92,92,27043016,99.9790267099,_100,2,>10
10047,91,91,27043107,99.9793631403,_100,2,>10
10048,90s,90,27043197,99.9796958736,_100,3,>10
10049,90,90,27043287,99.9800286069,_100,2,>10
10050,89,89,27043376,99.9803576432,_100,2,>10
10051,88,88,27043464,99.9806829825,_100,2,>10
10052,87,87,27043551,99.9810046247,_100,2,>10
10053,86,86,27043637,99.9813225698,_100,2,>10
10054,85,85,27043722,99.981636818,_100,2,>10
10055,84,84,27043806,99.9819473691,_100,2,>10
10056,83,83,27043889,99.9822542231,_100,2,>10
10057,82,82,27043971,99.9825573801,_100,2,>10
10058,81,81,27044052,99.9828568401,_100,2,>10
10059,80,80,27044132,99.9831526031,_100,2,>10
10060,80s,80,27044212,99.983448366,_100,3,>10
10061,79,79,27044291,99.9837404319,_100,2,>10
10062,78,78,27044369,99.9840288008,_100,2,>10
10063,77,77,27044446,99.9843134726,_100,2,>10
10064,76ers,76,27044522,99.9845944474,_100,5,>10
10065,76,76,27044598,99.9848754222,_100,2,>10
10066,75,75,27044673,99.9851527,_100,2,>10
10067,74,74,27044747,99.9854262807,_100,2,>10
10068,73,73,27044820,99.9856961644,_100,2,>10
10069,72,72,27044892,99.9859623511,_100,2,>10
10070,71,71,27044963,99.9862248407,_100,2,>10
10071,70,70,27045033,99.9864836333,_100,2,>10
10072,70s,70,27045103,99.9867424259,_100,3,>10
10073,69,69,27045172,99.9869975214,_100,2,>10
10074,68,68,27045240,99.9872489199,_100,2,>10
10075,67,67,27045307,99.9874966214,_100,2,>10
10076,66,66,27045373,99.9877406258,_100,2,>10
10077,65,65,27045438,99.9879809332,_100,2,>10
10078,64,64,27045502,99.9882175436,_100,2,>10
10079,63,63,27045565,99.9884504569,_100,2,>10
10080,62,62,27045627,99.9886796732,_100,2,>10
10081,61,61,27045688,99.9889051924,_100,2,>10
10082,60,60,27045748,99.9891270146,_100,2,>10
10083,60s,60,27045808,99.9893488368,_100,3,>10
10084,59,59,27045867,99.989566962,_100,2,>10
10085,58,58,27045925,99.9897813901,_100,2,>10
10086,57,57,27045982,99.9899921212,_100,2,>10
10087,56,56,27046038,99.9901991553,_100,2,>10
10088,55,55,27046093,99.9904024923,_100,2,>10
10089,54,54,27046147,99.9906021323,_100,2,>10
10090,53,53,27046200,99.9907980753,_100,2,>10
10091,52,52,27046252,99.9909903212,_100,2,>10
10092,51,51,27046303,99.9911788701,_100,2,>10
10093,50th,50,27046353,99.9913637219,_100,4,>10
10094,50,50,27046403,99.9915485738,_100,2,>10
10095,50s,50,27046453,99.9917334256,_100,3,>10
10096,49ers,49,27046502,99.9919145804,_100,5,>10
10097,49,49,27046551,99.9920957352,_100,2,>10
10098,48,48,27046599,99.992273193,_100,2,>10
10099,47,47,27046646,99.9924469537,_100,2,>10
10100,46,46,27046692,99.9926170174,_100,2,>10
10101,45,45,27046737,99.9927833841,_100,2,>10
10102,44,44,27046781,99.9929460537,_100,2,>10
10103,43,43,27046824,99.9931050263,_100,2,>10
10104,42,42,27046866,99.9932603018,_100,2,>10
10105,41,41,27046907,99.9934118803,_100,2,>10
10106,40th,40,27046947,99.9935597618,_100,4,>10
10107,40,40,27046987,99.9937076433,_100,2,>10
10108,39,39,27047026,99.9938518277,_100,2,>10
10109,38,38,27047064,99.9939923151,_100,2,>10
10110,37,37,27047101,99.9941291055,_100,2,>10
10111,36,36,27047137,99.9942621988,_100,2,>10
10112,35,35,27047172,99.9943915951,_100,2,>10
10113,34,34,27047206,99.9945172944,_100,2,>10
10114,33,33,27047239,99.9946392966,_100,2,>10
10115,32,32,27047271,99.9947576017,_100,2,>10
10116,31st,31,27047302,99.9948722099,_100,4,>10
10117,31,31,27047333,99.994986818,_100,2,>10
10118,30am,30,27047363,99.9950977291,_100,4,>10
10119,30pm,30,27047393,99.9952086402,_100,4,>10
10120,30th,30,27047423,99.9953195513,_100,4,>10
10121,30,30,27047453,99.9954304625,_100,2,>10
10122,30p,30,27047483,99.9955413736,_100,3,>10
10123,29,29,27047512,99.9956485876,_100,2,>10
10124,29th,29,27047541,99.9957558017,_100,4,>10
10125,28th,28,27047569,99.9958593187,_100,4,>10
10126,28,28,27047597,99.9959628358,_100,2,>10
10127,27,27,27047624,99.9960626558,_100,2,>10
10128,27th,27,27047651,99.9961624757,_100,4,>10
10129,26th,26,27047677,99.9962585987,_100,4,>10
10130,26,26,27047703,99.9963547217,_100,2,>10
10131,25th,25,27047728,99.9964471476,_100,4,>10
10132,25,25,27047753,99.9965395735,_100,2,>10
10133,24,24,27047777,99.9966283024,_100,2,>10
10134,24th,24,27047801,99.9967170313,_100,4,>10
10135,23rd,23,27047824,99.9968020631,_100,4,>10
10136,23,23,27047847,99.996887095,_100,2,>10
10137,22nd,22,27047869,99.9969684298,_100,4,>10
10138,22,22,27047891,99.9970497646,_100,2,>10
10139,21,21,27047912,99.9971274024,_100,2,>10
10140,21st,21,27047933,99.9972050401,_100,4,>10
10141,20th,20,27047953,99.9972789809,_100,4,>10
10142,20,20,27047973,99.9973529216,_100,2,>10
10143,19,19,27047992,99.9974231653,_100,2,>10
10144,19th,19,27048011,99.997493409,_100,4,>10
10145,18th,18,27048029,99.9975599557,_100,4,>10
10146,18,18,27048047,99.9976265023,_100,2,>10
10147,17th,17,27048064,99.997689352,_100,4,>10
10148,17,17,27048081,99.9977522016,_100,2,>10
10149,16th,16,27048097,99.9978113542,_100,4,>10
10150,16,16,27048113,99.9978705068,_100,2,>10
10151,15,15,27048128,99.9979259623,_100,2,>10
10152,15pm,15,27048143,99.9979814179,_100,4,>10
10153,15th,15,27048158,99.9980368734,_100,4,>10
10154,14th,14,27048172,99.9980886319,_100,4,>10
10155,14,14,27048186,99.9981403905,_100,2,>10
10156,13,13,27048199,99.9981884519,_100,2,>10
10157,13th,13,27048212,99.9982365134,_100,4,>10
10158,12,12,27048224,99.9982808779,_100,2,>10
10159,12pm,12,27048236,99.9983252423,_100,4,>10
10160,12th,12,27048248,99.9983696067,_100,4,>10
10161,11,11,27048259,99.9984102742,_100,2,>10
10162,11th,11,27048270,99.9984509416,_100,4,>10
10163,11pm,11,27048281,99.998491609,_100,4,>10
10164,11am,11,27048292,99.9985322764,_100,4,>10
10165,10k,10,27048302,99.9985692467,_100,3,>=1
10166,10pm,10,27048312,99.9986062171,_100,4,>=1
10167,10th,10,27048322,99.9986431875,_100,4,>=1
10168,10am,10,27048332,99.9986801578,_100,4,>=1
10169,10x,10,27048342,99.9987171282,_100,3,>=1
10170,10,10,27048352,99.9987540986,_100,2,>=1
10171,9th,9,27048361,99.9987873719,_100,3,>=1
10172,09,9,27048370,99.9988206452,_100,2,>=1
10173,9,9,27048379,99.9988539186,_100,1,>=1
10174,9am,9,27048388,99.9988871919,_100,3,>=1
10175,9pm,9,27048397,99.9989204652,_100,3,>=1
10176,08,8,27048405,99.9989500415,_100,2,>=1
10177,str8,8,27048413,99.9989796178,_100,4,>=1
10178,8,8,27048421,99.9990091941,_100,1,>=1
10179,8pm,8,27048429,99.9990387704,_100,3,>=1
10180,8th,8,27048437,99.9990683467,_100,3,>=1
10181,8am,8,27048445,99.999097923,_100,3,>=1
10182,gr8,8,27048453,99.9991274993,_100,3,>=1
10183,7,7,27048460,99.9991533786,_100,1,>=1
10184,7pm,7,27048467,99.9991792578,_100,3,>=1
10185,7am,7,27048474,99.9992051371,_100,3,>=1
10186,7th,7,27048481,99.9992310163,_100,3,>=1
10187,07,7,27048488,99.9992568956,_100,2,>=1
10188,6pm,6,27048494,99.9992790778,_100,3,>=1
10189,6,6,27048500,99.99930126,_100,1,>=1
10190,6am,6,27048506,99.9993234423,_100,3,>=1
10191,06,6,27048512,99.9993456245,_100,2,>=1
10192,6th,6,27048518,99.9993678067,_100,3,>=1
10193,html5,5,27048523,99.9993862919,_100,5,>=1
10194,5th,5,27048528,99.9994047771,_100,3,>=1
10195,5am,5,27048533,99.9994232623,_100,3,>=1
10196,a5,5,27048538,99.9994417474,_100,2,>=1
10197,05,5,27048543,99.9994602326,_100,2,>=1
10198,5k,5,27048548,99.9994787178,_100,2,>=1
10199,5pm,5,27048553,99.999497203,_100,3,>=1
10200,5,5,27048558,99.9995156882,_100,1,>=1
10201,q5,5,27048563,99.9995341734,_100,2,>=1
10202,4g,4,27048567,99.9995489615,_100,2,>=1
10203,a4,4,27048571,99.9995637497,_100,2,>=1
10204,q4,4,27048575,99.9995785378,_100,2,>=1
10205,4th,4,27048579,99.9995933259,_100,3,>=1
10206,4pm,4,27048583,99.9996081141,_100,3,>=1
10207,04,4,27048587,99.9996229022,_100,2,>=1
10208,4am,4,27048591,99.9996376904,_100,3,>=1
10209,b4,4,27048595,99.9996524785,_100,2,>=1
10210,4,4,27048599,99.9996672667,_100,1,>=1
10211,4s,4,27048603,99.9996820548,_100,2,>=1
10212,q3,3,27048606,99.9996931459,_100,2,>=1
10213,3x,3,27048609,99.9997042371,_100,2,>=1
10214,cp3,3,27048612,99.9997153282,_100,3,>=1
10215,3d,3,27048615,99.9997264193,_100,2,>=1
10216,3g,3,27048618,99.9997375104,_100,2,>=1
10217,d3,3,27048621,99.9997486015,_100,2,>=1
10218,rg3,3,27048624,99.9997596926,_100,3,>=1
10219,3rd,3,27048627,99.9997707837,_100,3,>=1
10220,3pm,3,27048630,99.9997818748,_100,3,>=1
10221,ps3,3,27048633,99.9997929659,_100,3,>=1
10222,3,3,27048636,99.999804057,_100,1,>=1
10223,3am,3,27048639,99.9998151482,_100,3,>=1
10224,mp3,3,27048642,99.9998262393,_100,3,>=1
10225,a3,3,27048645,99.9998373304,_100,2,>=1
10226,02,2,27048647,99.9998447245,_100,2,>=1
10227,q2,2,27048649,99.9998521185,_100,2,>=1
10228,2morrow,2,27048651,99.9998595126,_100,7,>=1
10229,2night,2,27048653,99.9998669067,_100,6,>=1
10230,b2b,2,27048655,99.9998743007,_100,3,>=1
10231,2am,2,27048657,99.9998816948,_100,3,>=1
10232,2nite,2,27048659,99.9998890889,_100,5,>=1
10233,2x,2,27048661,99.999896483,_100,2,>=1
10234,2b,2,27048663,99.999903877,_100,2,>=1
10235,2k,2,27048665,99.9999112711,_100,2,>=1
10236,2day,2,27048667,99.9999186652,_100,4,>=1
10237,2pm,2,27048669,99.9999260593,_100,3,>=1
10238,a2,2,27048671,99.9999334533,_100,2,>=1
10239,2,2,27048673,99.9999408474,_100,1,>=1
10240,u2,2,27048675,99.9999482415,_100,2,>=1
10241,2nd,2,27048677,99.9999556356,_100,3,>=1
10242,q1,1,27048678,99.9999593326,_100,2,>=1
10243,01,1,27048679,99.9999630296,_100,2,>=1
10244,1st,1,27048680,99.9999667267,_100,3,>=1
10245,a1,1,27048681,99.9999704237,_100,2,>=1
10246,1,1,27048682,99.9999741207,_100,1,>=1
10247,any1,1,27048683,99.9999778178,_100,4,>=1
10248,some1,1,27048684,99.9999815148,_100,5,>=1
10249,1k,1,27048685,99.9999852119,_100,2,>=1
10250,1d,1,27048686,99.9999889089,_100,2,>=1
10251,1pm,1,27048687,99.9999926059,_100,3,>=1
10252,1am,1,27048688,99.999996303,_100,3,>=1
10253,every1,1,27048689,100.0,_100,6,>=1
10254,00pm,0,27048689,100.0,_100,4,
10255,00am,0,27048689,100.0,_100,4,
10256,00,0,27048689,100.0,_100,2,
10257,000th,0,27048689,100.0,_100,5,
10258,000,0,27048689,100.0,_100,3,
10259,0,0,27048689,100.0,_100,1,
